Ubicación Origen,Ubicación Destino,Almacén,T. OP,Categoria,Codigo P.,Uni.,Producto,Fecha Alb.,Fecha,Periodo,Doc. Almacén,T. Doc.,Serie,Nro. Documento,Proveedor,Ingreso,Salida,Saldo F,C.A.,Debe,Haber,Saldo V.,CP,Cuenta factura,Cuenta producto,Cta. Analitica,LotePT,LoteMP,Pedido de Compra,Licitacion,Fecha Ingreso Lote,Plata
Partner Locations / Suppliers,Physical Locations / AQP M / Existencias,/ AQP M / Existencias,03,Mineral con Contenido Aurifero y Argentifero sin Procesar,M0001,t,MINERAL AURIFERO Y ARGENTIFERO SIN PROCESAR,2018-12-01,2018-12-01,12/2018,AQP M\IN\04514,01,E001,0000345,INVERSIONES VALEDANA E.I.R.L.,9.533000,0,9.533000,462.4095248085597399,4408.15,0,4408.15,462.4095248085597399,602101 - Mineral Aurifero sin Procesar,241101 - Mineral Aurifero sin Procesar,,"",13918,18PO06455,,2018-12-01,
,,/ AQP M / Existencias,"",Mineral con Contenido Aurifero y Argentifero sin Procesar,"","",MINERAL AURIFERO Y ARGENTIFERO SIN PROCESAR,,2018-12-07,12/2018,,08,E001,0000078,INVERSIONES VALEDANA E.I.R.L.,0,0,9.533000,610.8108675128500997,1414.71,0,5822.86,610.8108675128500997,602101,241101 - Mineral Aurifero sin Procesar,"",,13918,,,,f
Physical Locations / AQP M / Existencias,Ubicaciones virtuales / Produccion,/ AQP M / Existencias,07,Mineral con Contenido Aurifero y Argentifero sin Procesar,M0001,t,MINERAL AURIFERO Y ARGENTIFERO SIN PROCESAR,2018-12-31,2018-12-31,,MAMC-004223,,,MAMC-004223,,0,9.533000,0.000000,610.8108675128500997,0,5822.8600000000000004401000,-0.0000000000000004401000,0,"",241101 - Mineral Aurifero sin Procesar,,"",13918,,,,
Ubicaciones virtuales / Produccion,Physical Locations / AMCAQ / Existencias,/ AMCAQ / Existencias,08,Mineral con Contenido Aurifero y Argentifero sin Procesar,M0001,t,MINERAL AURIFERO Y ARGENTIFERO SIN PROCESAR,2018-12-31,2018-12-31,,PAMC004229,,,PAMC004229,,9.533000,0,9.533000,881.2311194639672716,8400.77626185,0,8400.77626185,881.2311194639672716,"",241101 - Mineral Aurifero sin Procesar,,"",13918,,,,
Partner Locations / Suppliers,Physical Locations / AQP M / Existencias,/ AQP M / Existencias,03,Mineral con Contenido Aurifero y Argentifero sin Procesar,M0001,t,MINERAL AURIFERO Y ARGENTIFERO SIN PROCESAR,2018-12-02,2018-12-02,12/2018,AQP M\IN\04505,01,E001,0000379,APMINAC PULPERA CAYLLOMA,33.799000,0,33.799000,838.3632651853605136,28335.84,0,28335.84,838.3632651853605136,602101 - Mineral Aurifero sin Procesar,241101 - Mineral Aurifero sin Procesar,,"",13919,18PO06426,,2018-12-02,
,,/ AQP M / Existencias,"",Mineral con Contenido Aurifero y Argentifero sin Procesar,"","",MINERAL AURIFERO Y ARGENTIFERO SIN PROCESAR,,2018-12-28,12/2018,,08,E001,0000128,APMINAC PULPERA CAYLLOMA,0,0,33.799000,947.8807065297789875,3701.58,0,32037.42,947.8807065297789875,602101,241101 - Mineral Aurifero sin Procesar,"",,13919,,,,f
Physical Locations / AQP M / Existencias,Ubicaciones virtuales / Produccion,/ AQP M / Existencias,07,Mineral con Contenido Aurifero y Argentifero sin Procesar,M0001,t,MINERAL AURIFERO Y ARGENTIFERO SIN PROCESAR,2018-12-31,2018-12-31,,MAMC-004223,,,MAMC-004223,,0,33.799000,0.000000,947.8807065297789875,0,32037.4199999999999985125000,0.0000000000000014875000,0,"",241101 - Mineral Aurifero sin Procesar,,"",13919,,,,
Ubicaciones virtuales / Produccion,Physical Locations / AMCAQ / Existencias,/ AMCAQ / Existencias,08,Mineral con Contenido Aurifero y Argentifero sin Procesar,M0001,t,MINERAL AURIFERO Y ARGENTIFERO SIN PROCESAR,2018-12-31,2018-12-31,,PAMC004229,,,PAMC004229,,33.799000,0,33.799000,1218.3008709337554366,41177.35113669,0,41177.35113669,1218.3008709337554366,"",241101 - Mineral Aurifero sin Procesar,,"",13919,,,,
Partner Locations / Suppliers,Physical Locations / AQP M / Existencias,/ AQP M / Existencias,03,Mineral con Contenido Aurifero y Argentifero sin Procesar,M0001,t,MINERAL AURIFERO Y ARGENTIFERO SIN PROCESAR,2018-12-02,2018-12-02,12/2018,AQP M\IN\04505,01,E001,0000379,APMINAC PULPERA CAYLLOMA,25.016000,0,25.016000,804.2756635753118004,20119.76,0,20119.76,804.2756635753118004,602101 - Mineral Aurifero sin Procesar,241101 - Mineral Aurifero sin Procesar,,"",13920,18PO06426,,2018-12-02,
,,/ AQP M / Existencias,"",Mineral con Contenido Aurifero y Argentifero sin Procesar,"","",MINERAL AURIFERO Y ARGENTIFERO SIN PROCESAR,,2018-12-28,12/2018,,08,E001,0000129,APMINAC PULPERA CAYLLOMA,0,0,25.016000,977.9704988807163415,4345.15,0,24464.91,977.9704988807163415,602101,241101 - Mineral Aurifero sin Procesar,"",,13920,,,,f
Physical Locations / AQP M / Existencias,Ubicaciones virtuales / Produccion,/ AQP M / Existencias,07,Mineral con Contenido Aurifero y Argentifero sin Procesar,M0001,t,MINERAL AURIFERO Y ARGENTIFERO SIN PROCESAR,2018-12-31,2018-12-31,,MAMC-004223,,,MAMC-004223,,0,25.016000,0.000000,977.9704988807163415,0,24464.9099999999999989640000,0.0000000000000010360000,0,"",241101 - Mineral Aurifero sin Procesar,,"",13920,,,,
Ubicaciones virtuales / Produccion,Physical Locations / AMCAQ / Existencias,/ AMCAQ / Existencias,08,Mineral con Contenido Aurifero y Argentifero sin Procesar,M0001,t,MINERAL AURIFERO Y ARGENTIFERO SIN PROCESAR,2018-12-31,2018-12-31,,PAMC004229,,,PAMC004229,,25.016000,0,25.016000,1248.3907359713783179,31229.74265106,0,31229.74265106,1248.3907359713783179,"",241101 - Mineral Aurifero sin Procesar,,"",13920,,,,
Virtual Locations / Compras sin factura,Physical Locations / AQP M / Existencias,/ AQP M / Existencias,03,Mineral con Contenido Aurifero y Argentifero sin Procesar,M0001,t,MINERAL AURIFERO Y ARGENTIFERO SIN PROCESAR,2018-12-02,2018-12-02,,AQP M\IN\04730,,,AQP M\IN\04730,ELIZBETH ROMERO NEYRA,6.756000,0,6.756000,2018.5923623445825933,13637.61,0,13637.61,2018.5923623445825933,"",241101 - Mineral Aurifero sin Procesar,,"",13921,,,2018-12-02,
Physical Locations / AQP M / Existencias,Ubicaciones virtuales / Produccion,/ AQP M / Existencias,07,Mineral con Contenido Aurifero y Argentifero sin Procesar,M0001,t,MINERAL AURIFERO Y ARGENTIFERO SIN PROCESAR,2018-12-31,2018-12-31,,MAMC-004223,,,MAMC-004223,,0,6.756000,0.000000,2018.5923623445825933,0,13637.6100000000000003348000,-0.0000000000000003348000,0,"",241101 - Mineral Aurifero sin Procesar,,"",13921,,,,
Ubicaciones virtuales / Produccion,Physical Locations / AMCAQ / Existencias,/ AMCAQ / Existencias,08,Mineral con Contenido Aurifero y Argentifero sin Procesar,M0001,t,MINERAL AURIFERO Y ARGENTIFERO SIN PROCESAR,2018-12-31,2018-12-31,,PAMC004229,,,PAMC004229,,6.756000,0,6.756000,2289.0125958777383067,15464.56909775,0,15464.56909775,2289.0125958777383067,"",241101 - Mineral Aurifero sin Procesar,,"",13921,,,,
Partner Locations / Suppliers,Physical Locations / AQP M / Existencias,/ AQP M / Existencias,03,Mineral con Contenido Aurifero y Argentifero sin Procesar,M0001,t,MINERAL AURIFERO Y ARGENTIFERO SIN PROCESAR,2018-12-02,2018-12-02,12/2018,AQP M\IN\04506,01,E001,0000102,SOCIEDAD MINERA DE RESPONSABILIDAD LIMITADA PULPERA I,33.882000,0,33.882000,628.0871849359541940,21280.85,0,21280.85,628.0871849359541940,602101 - Mineral Aurifero sin Procesar,241101 - Mineral Aurifero sin Procesar,,"",13922,18PO06427,,2018-12-02,
,,/ AQP M / Existencias,"",Mineral con Contenido Aurifero y Argentifero sin Procesar,"","",MINERAL AURIFERO Y ARGENTIFERO SIN PROCESAR,,2018-12-28,12/2018,,08,E001,0000036,SOCIEDAD MINERA DE RESPONSABILIDAD LIMITADA PULPERA I,0,0,33.882000,773.5924679770969836,4930.01,0,26210.86,773.5924679770969836,602101,241101 - Mineral Aurifero sin Procesar,"",,13922,,,,f
Physical Locations / AQP M / Existencias,Ubicaciones virtuales / Produccion,/ AQP M / Existencias,07,Mineral con Contenido Aurifero y Argentifero sin Procesar,M0001,t,MINERAL AURIFERO Y ARGENTIFERO SIN PROCESAR,2018-12-31,2018-12-31,,MAMC-004223,,,MAMC-004223,,0,33.882000,0.000000,773.5924679770969836,0,26210.8599999999999983352000,0.0000000000000016648000,0,"",241101 - Mineral Aurifero sin Procesar,,"",13922,,,,
Ubicaciones virtuales / Produccion,Physical Locations / AMCAQ / Existencias,/ AMCAQ / Existencias,08,Mineral con Contenido Aurifero y Argentifero sin Procesar,M0001,t,MINERAL AURIFERO Y ARGENTIFERO SIN PROCESAR,2018-12-31,2018-12-31,,PAMC004229,,,PAMC004229,,33.882000,0,33.882000,1044.0127180511776164,35373.23891301,0,35373.23891301,1044.0127180511776164,"",241101 - Mineral Aurifero sin Procesar,,"",13922,,,,
Ubicaciones virtuales / Transformacion Lote Trujillo,Physical Locations / AMCAQ / Existencias,/ AMCAQ / Existencias,06,Mineral con Contenido Aurifero y Argentifero sin Procesar,M0001,t,MINERAL AURIFERO Y ARGENTIFERO SIN PROCESAR,2018-12-03,2018-12-03,,ILT-000328,,,ILT-000328,MASIAS ROGELIO HUERTA  ALVARADO,17.682000,0,17.682000,2611.0441284622780228,46168.48227947,0,46168.48227947,2611.0441284622780228,"",241101 - Mineral Aurifero sin Procesar,,"",13923,,,2018-12-03,
Physical Locations / AMCTJ / Existencias,Ubicaciones virtuales / Transformacion Lote Trujillo,/ AMCTJ / Existencias,06,Mineral con Contenido Aurifero y Argentifero sin Procesar,M0001,t,MINERAL AURIFERO Y ARGENTIFERO SIN PROCESAR,2018-12-03,2018-12-03,,CLT-000313,,,CLT-000313,MASIAS ROGELIO HUERTA  ALVARADO,0,17.682000,-17.682000,0,0,0.000000,0.000000,0,"",241101 - Mineral Aurifero sin Procesar,0000 LOTES TRUJILLO,"",13923,,,2018-12-03,
Ubicaciones virtuales / Transformacion Lote Trujillo,Physical Locations / AMCAQ / Existencias,/ AMCAQ / Existencias,06,Mineral con Contenido Aurifero y Argentifero sin Procesar,M0001,t,MINERAL AURIFERO Y ARGENTIFERO SIN PROCESAR,2018-12-03,2018-12-03,,ILT-000329,,,ILT-000329,MASIAS ROGELIO HUERTA  ALVARADO,10.094000,0,10.094000,2592.0042699237170596,26163.69110061,0,26163.69110061,2592.0042699237170596,"",241101 - Mineral Aurifero sin Procesar,,"",13924,,,2018-12-03,
Physical Locations / AMCTJ / Existencias,Ubicaciones virtuales / Transformacion Lote Trujillo,/ AMCTJ / Existencias,06,Mineral con Contenido Aurifero y Argentifero sin Procesar,M0001,t,MINERAL AURIFERO Y ARGENTIFERO SIN PROCESAR,2018-12-03,2018-12-03,,CLT-000314,,,CLT-000314,MASIAS ROGELIO HUERTA  ALVARADO,0,10.094000,-10.094000,0,0,0.000000,0.000000,0,"",241101 - Mineral Aurifero sin Procesar,0000 LOTES TRUJILLO,"",13924,,,2018-12-03,
Ubicaciones virtuales / Transformacion Lote Trujillo,Physical Locations / AMCAQ / Existencias,/ AMCAQ / Existencias,06,Mineral con Contenido Aurifero y Argentifero sin Procesar,M0001,t,MINERAL AURIFERO Y ARGENTIFERO SIN PROCESAR,2018-12-03,2018-12-03,,ILT-000329,,,ILT-000329,MASIAS ROGELIO HUERTA  ALVARADO,26.654000,0,26.654000,2592.0042699242140017,69087.28181056,0,69087.28181056,2592.0042699242140017,"",241101 - Mineral Aurifero sin Procesar,,"",13925,,,2018-12-03,
Physical Locations / AMCTJ / Existencias,Ubicaciones virtuales / Transformacion Lote Trujillo,/ AMCTJ / Existencias,06,Mineral con Contenido Aurifero y Argentifero sin Procesar,M0001,t,MINERAL AURIFERO Y ARGENTIFERO SIN PROCESAR,2018-12-03,2018-12-03,,CLT-000314,,,CLT-000314,MASIAS ROGELIO HUERTA  ALVARADO,0,26.654000,-26.654000,0,0,0.000000,0.000000,0,"",241101 - Mineral Aurifero sin Procesar,0000 LOTES TRUJILLO,"",13925,,,2018-12-03,
Partner Locations / Suppliers,Physical Locations / AQP M / Existencias,/ AQP M / Existencias,03,Mineral con Contenido Aurifero y Argentifero sin Procesar,M0001,t,MINERAL AURIFERO Y ARGENTIFERO SIN PROCESAR,2018-12-03,2018-12-03,12/2018,AQP M\IN\04548,01,0003,0000006,LALO ZENON APAZA PFOCCORI,6.276000,0,6.276000,4202.5446144040790312,26375.17,0,26375.17,4202.5446144040790312,602101 - Mineral Aurifero sin Procesar,241101 - Mineral Aurifero sin Procesar,,"",13926,18PO06604,,2018-12-03,
,,/ AQP M / Existencias,"",Mineral con Contenido Aurifero y Argentifero sin Procesar,"","",MINERAL AURIFERO Y ARGENTIFERO SIN PROCESAR,,2018-12-13,12/2018,,01,0003,0000005,LALO ZENON APAZA PFOCCORI,0,0,6.276000,4293.5420650095602294,571.1,0,26946.27,4293.5420650095602294,609201,241101 - Mineral Aurifero sin Procesar,"",,13926,,,,t
,,/ AQP M / Existencias,"",Mineral con Contenido Aurifero y Argentifero sin Procesar,"","",MINERAL AURIFERO Y ARGENTIFERO SIN PROCESAR,,2018-12-28,12/2018,,08,0002,0000011,LALO ZENON APAZA PFOCCORI,0,0,6.276000,4438.3715742511153601,908.95,0,27855.22,4438.3715742511153601,602101,241101 - Mineral Aurifero sin Procesar,"",,13926,,,,f
Physical Locations / AQP M / Existencias,Ubicaciones virtuales / Produccion,/ AQP M / Existencias,07,Mineral con Contenido Aurifero y Argentifero sin Procesar,M0001,t,MINERAL AURIFERO Y ARGENTIFERO SIN PROCESAR,2018-12-31,2018-12-31,,MAMC-004223,,,MAMC-004223,,0,6.276000,0.000000,4438.3715742511153601,0,27855.2199999999999999876000,0.0000000000000000124000,0,"",241101 - Mineral Aurifero sin Procesar,,"",13926,,,,
Ubicaciones virtuales / Produccion,Physical Locations / AMCAQ / Existencias,/ AMCAQ / Existencias,08,Mineral con Contenido Aurifero y Argentifero sin Procesar,M0001,t,MINERAL AURIFERO Y ARGENTIFERO SIN PROCESAR,2018-12-31,2018-12-31,,PAMC004229,,,PAMC004229,,6.276000,0,6.276000,4708.7920072864882091,29552.37863773,0,29552.37863773,4708.7920072864882091,"",241101 - Mineral Aurifero sin Procesar,,"",13926,,,,
Partner Locations / Suppliers,Physical Locations / AQP M / Existencias,/ AQP M / Existencias,03,Mineral con Contenido Aurifero y Argentifero sin Procesar,M0001,t,MINERAL AURIFERO Y ARGENTIFERO SIN PROCESAR,2018-12-03,2018-12-03,12/2018,AQP M\IN\04548,01,0003,0000006,LALO ZENON APAZA PFOCCORI,4.367000,0,4.367000,2569.3473780627433020,11220.34,0,11220.34,2569.3473780627433020,602101 - Mineral Aurifero sin Procesar,241101 - Mineral Aurifero sin Procesar,,"",13927,18PO06604,,2018-12-03,
,,/ AQP M / Existencias,"",Mineral con Contenido Aurifero y Argentifero sin Procesar,"","",MINERAL AURIFERO Y ARGENTIFERO SIN PROCESAR,,2018-12-13,12/2018,,01,0003,0000005,LALO ZENON APAZA PFOCCORI,0,0,4.367000,2646.3040989237462789,336.07,0,11556.41,2646.3040989237462789,609201,241101 - Mineral Aurifero sin Procesar,"",,13927,,,,t
Physical Locations / AQP M / Existencias,Ubicaciones virtuales / Produccion,/ AQP M / Existencias,07,Mineral con Contenido Aurifero y Argentifero sin Procesar,M0001,t,MINERAL AURIFERO Y ARGENTIFERO SIN PROCESAR,2018-12-31,2018-12-31,,MAMC-004223,,,MAMC-004223,,0,4.367000,0.000000,2646.3040989237462789,0,11556.4099999999999999563000,0.0000000000000000437000,0,"",241101 - Mineral Aurifero sin Procesar,,"",13927,,,,
Ubicaciones virtuales / Produccion,Physical Locations / AMCAQ / Existencias,/ AMCAQ / Existencias,08,Mineral con Contenido Aurifero y Argentifero sin Procesar,M0001,t,MINERAL AURIFERO Y ARGENTIFERO SIN PROCESAR,2018-12-31,2018-12-31,,PAMC004229,,,PAMC004229,,4.367000,0,4.367000,2916.7242758873368445,12737.3349128,0,12737.3349128,2916.7242758873368445,"",241101 - Mineral Aurifero sin Procesar,,"",13927,,,,
Partner Locations / Suppliers,Physical Locations / AQP M / Existencias,/ AQP M / Existencias,03,Mineral con Contenido Aurifero y Argentifero sin Procesar,M0001,t,MINERAL AURIFERO Y ARGENTIFERO SIN PROCESAR,2018-12-03,2018-12-03,12/2018,AQP M\IN\04548,01,0003,0000006,LALO ZENON APAZA PFOCCORI,21.732000,0,21.732000,2879.6700717835450028,62580.99,0,62580.99,2879.6700717835450028,602101 - Mineral Aurifero sin Procesar,241101 - Mineral Aurifero sin Procesar,,"",13928,18PO06604,,2018-12-03,
,,/ AQP M / Existencias,"",Mineral con Contenido Aurifero y Argentifero sin Procesar,"","",MINERAL AURIFERO Y ARGENTIFERO SIN PROCESAR,,2018-12-13,12/2018,,01,0003,0000005,LALO ZENON APAZA PFOCCORI,0,0,21.732000,2947.9583103257868581,1484.04,0,64065.03,2947.9583103257868581,609201,241101 - Mineral Aurifero sin Procesar,"",,13928,,,,t
,,/ AQP M / Existencias,"",Mineral con Contenido Aurifero y Argentifero sin Procesar,"","",MINERAL AURIFERO Y ARGENTIFERO SIN PROCESAR,,2018-12-28,12/2018,,08,0002,0000011,LALO ZENON APAZA PFOCCORI,0,0,21.732000,3001.4347505981962084,1162.15,0,65227.18,3001.4347505981962084,602101,241101 - Mineral Aurifero sin Procesar,"",,13928,,,,f
Physical Locations / AQP M / Existencias,Ubicaciones virtuales / Produccion,/ AQP M / Existencias,07,Mineral con Contenido Aurifero y Argentifero sin Procesar,M0001,t,MINERAL AURIFERO Y ARGENTIFERO SIN PROCESAR,2018-12-31,2018-12-31,,MAMC-004223,,,MAMC-004223,,0,21.732000,0.000000,3001.4347505981962084,0,65227.1800000000000009488000,-0.0000000000000009488000,0,"",241101 - Mineral Aurifero sin Procesar,,"",13928,,,,
Ubicaciones virtuales / Produccion,Physical Locations / AMCAQ / Existencias,/ AMCAQ / Existencias,08,Mineral con Contenido Aurifero y Argentifero sin Procesar,M0001,t,MINERAL AURIFERO Y ARGENTIFERO SIN PROCESAR,2018-12-31,2018-12-31,,PAMC004229,,,PAMC004229,,21.732000,0,21.732000,3271.8549566284741395,71103.95191745,0,71103.95191745,3271.8549566284741395,"",241101 - Mineral Aurifero sin Procesar,,"",13928,,,,
Partner Locations / Suppliers,Physical Locations / AQP M / Existencias,/ AQP M / Existencias,03,Mineral con Contenido Aurifero y Argentifero sin Procesar,M0001,t,MINERAL AURIFERO Y ARGENTIFERO SIN PROCESAR,2018-12-03,2018-12-03,12/2018,AQP M\IN\04509,01,E001,0000380,APMINAC PULPERA CAYLLOMA,32.103000,0,32.103000,813.0629536180419275,26101.76,0,26101.76,813.0629536180419275,602101 - Mineral Aurifero sin Procesar,241101 - Mineral Aurifero sin Procesar,,"",13929,18PO06450,,2018-12-03,
Physical Locations / AQP M / Existencias,Ubicaciones virtuales / Produccion,/ AQP M / Existencias,07,Mineral con Contenido Aurifero y Argentifero sin Procesar,M0001,t,MINERAL AURIFERO Y ARGENTIFERO SIN PROCESAR,2018-12-31,2018-12-31,,MAMC-004223,,,MAMC-004223,,0,32.103000,0.000000,813.0629536180419275,0,26101.7599999999999985325000,0.0000000000000014675000,0,"",241101 - Mineral Aurifero sin Procesar,,"",13929,,,,
Ubicaciones virtuales / Produccion,Physical Locations / AMCAQ / Existencias,/ AMCAQ / Existencias,08,Mineral con Contenido Aurifero y Argentifero sin Procesar,M0001,t,MINERAL AURIFERO Y ARGENTIFERO SIN PROCESAR,2018-12-31,2018-12-31,,PAMC004229,,,PAMC004229,,32.103000,0,32.103000,1083.4831919172662991,34783.06091012,0,34783.06091012,1083.4831919172662991,"",241101 - Mineral Aurifero sin Procesar,,"",13929,,,,
Partner Locations / Suppliers,Physical Locations / AQP M / Existencias,/ AQP M / Existencias,03,Mineral con Contenido Aurifero y Argentifero sin Procesar,M0001,t,MINERAL AURIFERO Y ARGENTIFERO SIN PROCESAR,2018-12-03,2018-12-03,12/2018,AQP M\IN\04510,01,E001,0000103,SOCIEDAD MINERA DE RESPONSABILIDAD LIMITADA PULPERA I,30.137000,0,30.137000,745.8147791751003750,22476.62,0,22476.62,745.8147791751003750,602101 - Mineral Aurifero sin Procesar,241101 - Mineral Aurifero sin Procesar,,"",13930,18PO06451,,2018-12-03,
,,/ AQP M / Existencias,"",Mineral con Contenido Aurifero y Argentifero sin Procesar,"","",MINERAL AURIFERO Y ARGENTIFERO SIN PROCESAR,,2018-12-28,12/2018,,08,E001,0000037,SOCIEDAD MINERA DE RESPONSABILIDAD LIMITADA PULPERA I,0,0,30.137000,881.6982446826160534,4095.12,0,26571.74,881.6982446826160534,602101,241101 - Mineral Aurifero sin Procesar,"",,13930,,,,f
Physical Locations / AQP M / Existencias,Ubicaciones virtuales / Produccion,/ AQP M / Existencias,07,Mineral con Contenido Aurifero y Argentifero sin Procesar,M0001,t,MINERAL AURIFERO Y ARGENTIFERO SIN PROCESAR,2018-12-31,2018-12-31,,MAMC-004223,,,MAMC-004223,,0,30.137000,0.000000,881.6982446826160534,0,26571.7400000000000013158000,-0.0000000000000013158000,0,"",241101 - Mineral Aurifero sin Procesar,,"",13930,,,,
Ubicaciones virtuales / Produccion,Physical Locations / AMCAQ / Existencias,/ AMCAQ / Existencias,08,Mineral con Contenido Aurifero y Argentifero sin Procesar,M0001,t,MINERAL AURIFERO Y ARGENTIFERO SIN PROCESAR,2018-12-31,2018-12-31,,PAMC004229,,,PAMC004229,,30.137000,0,30.137000,1152.1184744649434250,34721.39446495,0,34721.39446495,1152.1184744649434250,"",241101 - Mineral Aurifero sin Procesar,,"",13930,,,,
Virtual Locations / Compras sin factura,Physical Locations / AQP M / Existencias,/ AQP M / Existencias,03,Mineral con Contenido Aurifero y Argentifero sin Procesar,M0002,t,LLAMPO,2018-12-03,2018-12-03,,AQP M\IN\04769,,,AQP M\IN\04769,EXPLORATION GOLDEN MINERALES EMPRESA INDIVIDUAL DE RESPONSABILIDAD LIMITADA - EXGOLMIN E.I.R.L.,5.492000,0,5.492000,18.1627822286962855,99.75,0,99.75,18.1627822286962855,"",241101 - Mineral Aurifero sin Procesar,,"",13931,,,2018-12-03,
Physical Locations / AQP M / Existencias,Ubicaciones virtuales / Produccion,/ AQP M / Existencias,07,Mineral con Contenido Aurifero y Argentifero sin Procesar,M0002,t,LLAMPO,2018-12-31,2018-12-31,,MAMC-004224,,,MAMC-004224,,0,5.492000,0.000000,18.1627822286962855,0,99.7499999999999999660000,0.0000000000000000340000,0,"",241101 - Mineral Aurifero sin Procesar,,"",13931,,,,
Ubicaciones virtuales / Produccion,Physical Locations / AMCAQ / Existencias,/ AMCAQ / Existencias,08,Mineral con Contenido Aurifero y Argentifero sin Procesar,M0002,t,LLAMPO,2018-12-31,2018-12-31,,PAMC004230,,,PAMC004230,,5.492000,0,5.492000,223.5273669264384559,1227.61229916,0,1227.61229916,223.5273669264384559,"",241101 - Mineral Aurifero sin Procesar,,"",13931,,,,
Partner Locations / Suppliers,Physical Locations / AQP M / Existencias,/ AQP M / Existencias,03,Mineral con Contenido Aurifero y Argentifero sin Procesar,M0002,t,LLAMPO,2018-12-03,2018-12-03,12/2018,AQP M\IN\04617,01,E001,0000042,EXPLORATION GOLDEN MINERALES EMPRESA INDIVIDUAL DE RESPONSABILIDAD LIMITADA - EXGOLMIN E.I.R.L.,25.786000,0,25.786000,164.3062126735437834,4236.8,0,4236.8,164.3062126735437834,602101 - Mineral Aurifero sin Procesar,241101 - Mineral Aurifero sin Procesar,,"",13932,18PO06746,,2018-12-03,
Physical Locations / AQP M / Existencias,Ubicaciones virtuales / Produccion,/ AQP M / Existencias,07,Mineral con Contenido Aurifero y Argentifero sin Procesar,M0002,t,LLAMPO,2018-12-31,2018-12-31,,MAMC-004224,,,MAMC-004224,,0,25.786000,0.000000,164.3062126735437834,0,4236.7999999999999987524000,0.0000000000000012476000,0,"",241101 - Mineral Aurifero sin Procesar,,"",13932,,,,
Ubicaciones virtuales / Produccion,Physical Locations / AMCAQ / Existencias,/ AMCAQ / Existencias,08,Mineral con Contenido Aurifero y Argentifero sin Procesar,M0002,t,LLAMPO,2018-12-31,2018-12-31,,PAMC004230,,,PAMC004230,,25.786000,0,25.786000,369.6711464639726984,9532.34018272,0,9532.34018272,369.6711464639726984,"",241101 - Mineral Aurifero sin Procesar,,"",13932,,,,
Partner Locations / Suppliers,Physical Locations / AQP M / Existencias,/ AQP M / Existencias,03,Mineral con Contenido Aurifero y Argentifero sin Procesar,M0001,t,MINERAL AURIFERO Y ARGENTIFERO SIN PROCESAR,2018-12-03,2018-12-03,12/2018,AQP M\IN\04515,01,0001,0001271,EDWIN CUNO QUIÑONES,1.678000,0,1.678000,2337.8665077473182360,3922.94,0,3922.94,2337.8665077473182360,602101 - Mineral Aurifero sin Procesar,241101 - Mineral Aurifero sin Procesar,,"",13933,18PO06457,,2018-12-03,
Physical Locations / AQP M / Existencias,Ubicaciones virtuales / Produccion,/ AQP M / Existencias,07,Mineral con Contenido Aurifero y Argentifero sin Procesar,M0001,t,MINERAL AURIFERO Y ARGENTIFERO SIN PROCESAR,2018-12-31,2018-12-31,,MAMC-004224,,,MAMC-004224,,0,1.678000,0.000000,2337.8665077473182360,0,3922.9400000000000000080000,-0.0000000000000000080000,0,"",241101 - Mineral Aurifero sin Procesar,,"",13933,,,,
Ubicaciones virtuales / Produccion,Physical Locations / AMCAQ / Existencias,/ AMCAQ / Existencias,08,Mineral con Contenido Aurifero y Argentifero sin Procesar,M0001,t,MINERAL AURIFERO Y ARGENTIFERO SIN PROCESAR,2018-12-31,2018-12-31,,PAMC004230,,,PAMC004230,,1.678000,0,1.678000,2608.2859361978545888,4376.70380094,0,4376.70380094,2608.2859361978545888,"",241101 - Mineral Aurifero sin Procesar,,"",13933,,,,
Partner Locations / Suppliers,Physical Locations / AQP M / Existencias,/ AQP M / Existencias,03,Mineral con Contenido Aurifero y Argentifero sin Procesar,M0001,t,MINERAL AURIFERO Y ARGENTIFERO SIN PROCESAR,2018-12-03,2018-12-03,12/2018,AQP M\IN\04515,01,0001,0001271,EDWIN CUNO QUIÑONES,13.346000,0,13.346000,1124.2372246365952345,15004.07,0,15004.07,1124.2372246365952345,602101 - Mineral Aurifero sin Procesar,241101 - Mineral Aurifero sin Procesar,,"",13934,18PO06457,,2018-12-03,
Physical Locations / AQP M / Existencias,Ubicaciones virtuales / Produccion,/ AQP M / Existencias,07,Mineral con Contenido Aurifero y Argentifero sin Procesar,M0001,t,MINERAL AURIFERO Y ARGENTIFERO SIN PROCESAR,2018-12-31,2018-12-31,,MAMC-004224,,,MAMC-004224,,0,13.346000,0.000000,1124.2372246365952345,0,15004.0699999999999996370000,0.0000000000000003630000,0,"",241101 - Mineral Aurifero sin Procesar,,"",13934,,,,
Ubicaciones virtuales / Produccion,Physical Locations / AMCAQ / Existencias,/ AMCAQ / Existencias,08,Mineral con Contenido Aurifero y Argentifero sin Procesar,M0001,t,MINERAL AURIFERO Y ARGENTIFERO SIN PROCESAR,2018-12-31,2018-12-31,,PAMC004230,,,PAMC004230,,13.346000,0,13.346000,1394.6573718267645737,18613.0972844,0,18613.0972844,1394.6573718267645737,"",241101 - Mineral Aurifero sin Procesar,,"",13934,,,,
Partner Locations / Suppliers,Physical Locations / AQP M / Existencias,/ AQP M / Existencias,03,Mineral con Contenido Aurifero y Argentifero sin Procesar,M0001,t,MINERAL AURIFERO Y ARGENTIFERO SIN PROCESAR,2018-12-03,2018-12-03,12/2018,AQP M\IN\04515,01,0001,0001271,EDWIN CUNO QUIÑONES,6.372000,0,6.372000,1112.6412429378531073,7089.75,0,7089.75,1112.6412429378531073,602101 - Mineral Aurifero sin Procesar,241101 - Mineral Aurifero sin Procesar,,"",13935,18PO06457,,2018-12-03,
Physical Locations / AQP M / Existencias,Ubicaciones virtuales / Produccion,/ AQP M / Existencias,07,Mineral con Contenido Aurifero y Argentifero sin Procesar,M0001,t,MINERAL AURIFERO Y ARGENTIFERO SIN PROCESAR,2018-12-31,2018-12-31,,MAMC-004224,,,MAMC-004224,,0,6.372000,0.000000,1112.6412429378531073,0,7089.7499999999999997156000,0.0000000000000002844000,0,"",241101 - Mineral Aurifero sin Procesar,,"",13935,,,,
Ubicaciones virtuales / Produccion,Physical Locations / AMCAQ / Existencias,/ AMCAQ / Existencias,08,Mineral con Contenido Aurifero y Argentifero sin Procesar,M0001,t,MINERAL AURIFERO Y ARGENTIFERO SIN PROCESAR,2018-12-31,2018-12-31,,PAMC004230,,,PAMC004230,,6.372000,0,6.372000,1383.0612699890144382,8812.86641237,0,8812.86641237,1383.0612699890144382,"",241101 - Mineral Aurifero sin Procesar,,"",13935,,,,
Partner Locations / Suppliers,Physical Locations / AQP M / Existencias,/ AQP M / Existencias,03,Mineral con Contenido Aurifero y Argentifero sin Procesar,M0001,t,MINERAL AURIFERO Y ARGENTIFERO SIN PROCESAR,2018-12-03,2018-12-03,12/2018,AQP M\IN\04509,01,E001,0000380,APMINAC PULPERA CAYLLOMA,24.430000,0,24.430000,707.5755218993041343,17286.07,0,17286.07,707.5755218993041343,602101 - Mineral Aurifero sin Procesar,241101 - Mineral Aurifero sin Procesar,,"",13936,18PO06450,,2018-12-03,
,,/ AQP M / Existencias,"",Mineral con Contenido Aurifero y Argentifero sin Procesar,"","",MINERAL AURIFERO Y ARGENTIFERO SIN PROCESAR,,2018-12-28,12/2018,,08,E001,0000130,APMINAC PULPERA CAYLLOMA,0,0,24.430000,824.3507981989357348,2852.82,0,20138.89,824.3507981989357348,602101,241101 - Mineral Aurifero sin Procesar,"",,13936,,,,f
Physical Locations / AQP M / Existencias,Ubicaciones virtuales / Produccion,/ AQP M / Existencias,07,Mineral con Contenido Aurifero y Argentifero sin Procesar,M0001,t,MINERAL AURIFERO Y ARGENTIFERO SIN PROCESAR,2018-12-31,2018-12-31,,MAMC-004224,,,MAMC-004224,,0,24.430000,0.000000,824.3507981989357348,0,20138.8900000000000011640000,-0.0000000000000011640000,0,"",241101 - Mineral Aurifero sin Procesar,,"",13936,,,,
Ubicaciones virtuales / Produccion,Physical Locations / AMCAQ / Existencias,/ AMCAQ / Existencias,08,Mineral con Contenido Aurifero y Argentifero sin Procesar,M0001,t,MINERAL AURIFERO Y ARGENTIFERO SIN PROCESAR,2018-12-31,2018-12-31,,PAMC004230,,,PAMC004230,,24.430000,0,24.430000,1094.7709812374130168,26745.25507163,0,26745.25507163,1094.7709812374130168,"",241101 - Mineral Aurifero sin Procesar,,"",13936,,,,
Partner Locations / Suppliers,Physical Locations / AQP M / Existencias,/ AQP M / Existencias,03,Mineral con Contenido Aurifero y Argentifero sin Procesar,M0001,t,MINERAL AURIFERO Y ARGENTIFERO SIN PROCESAR,2018-12-03,2018-12-03,12/2018,AQP M\IN\04515,01,0001,0001271,EDWIN CUNO QUIÑONES,0.936000,0,0.936000,2094.1987179487179487,1960.17,0,1960.17,2094.1987179487179487,602101 - Mineral Aurifero sin Procesar,241101 - Mineral Aurifero sin Procesar,,"",13937,18PO06457,,2018-12-03,
Physical Locations / AQP M / Existencias,Ubicaciones virtuales / Produccion,/ AQP M / Existencias,07,Mineral con Contenido Aurifero y Argentifero sin Procesar,M0001,t,MINERAL AURIFERO Y ARGENTIFERO SIN PROCESAR,2018-12-31,2018-12-31,,MAMC-004224,,,MAMC-004224,,0,0.936000,0.000000,2094.1987179487179487,0,1960.1699999999999999832000,0.0000000000000000168000,0,"",241101 - Mineral Aurifero sin Procesar,,"",13937,,,,
Ubicaciones virtuales / Produccion,Physical Locations / AMCAQ / Existencias,/ AMCAQ / Existencias,08,Mineral con Contenido Aurifero y Argentifero sin Procesar,M0001,t,MINERAL AURIFERO Y ARGENTIFERO SIN PROCESAR,2018-12-31,2018-12-31,,PAMC004230,,,PAMC004230,,0.936000,0,0.936000,2364.6203978846153846,2213.28469242,0,2213.28469242,2364.6203978846153846,"",241101 - Mineral Aurifero sin Procesar,,"",13937,,,,
Partner Locations / Suppliers,Physical Locations / AQP M / Existencias,/ AQP M / Existencias,03,Mineral con Contenido Aurifero y Argentifero sin Procesar,M0001,t,MINERAL AURIFERO Y ARGENTIFERO SIN PROCESAR,2018-12-03,2018-12-03,12/2018,AQP M\IN\04515,01,0001,0001271,EDWIN CUNO QUIÑONES,2.611000,0,2.611000,1927.8705476828801226,5033.67,0,5033.67,1927.8705476828801226,602101 - Mineral Aurifero sin Procesar,241101 - Mineral Aurifero sin Procesar,,"",13938,18PO06457,,2018-12-03,
Physical Locations / AQP M / Existencias,Ubicaciones virtuales / Produccion,/ AQP M / Existencias,07,Mineral con Contenido Aurifero y Argentifero sin Procesar,M0001,t,MINERAL AURIFERO Y ARGENTIFERO SIN PROCESAR,2018-12-31,2018-12-31,,MAMC-004224,,,MAMC-004224,,0,2.611000,0.000000,1927.8705476828801226,0,5033.6700000000000001086000,-0.0000000000000001086000,0,"",241101 - Mineral Aurifero sin Procesar,,"",13938,,,,
Ubicaciones virtuales / Produccion,Physical Locations / AMCAQ / Existencias,/ AMCAQ / Existencias,08,Mineral con Contenido Aurifero y Argentifero sin Procesar,M0001,t,MINERAL AURIFERO Y ARGENTIFERO SIN PROCESAR,2018-12-31,2018-12-31,,PAMC004230,,,PAMC004230,,2.611000,0,2.611000,2198.2904071198774416,5739.73625299,0,5739.73625299,2198.2904071198774416,"",241101 - Mineral Aurifero sin Procesar,,"",13938,,,,
Partner Locations / Suppliers,Physical Locations / AQP M / Existencias,/ AQP M / Existencias,03,Mineral con Contenido Aurifero y Argentifero sin Procesar,M0002,t,LLAMPO,2018-12-04,2018-12-04,12/2018,AQP M\IN\04537,01,E001,0000008,ROLANDO SONCCO MOLINA,6.740000,0,6.740000,805.4465875370919881,5428.71,0,5428.71,805.4465875370919881,602101 - Mineral Aurifero sin Procesar,241101 - Mineral Aurifero sin Procesar,,"",13939,18PO06565,,2018-12-04,
Physical Locations / AQP M / Existencias,Ubicaciones virtuales / Produccion,/ AQP M / Existencias,07,Mineral con Contenido Aurifero y Argentifero sin Procesar,M0002,t,LLAMPO,2018-12-31,2018-12-31,,MAMC-004224,,,MAMC-004224,,0,6.740000,0.000000,805.4465875370919881,0,5428.7099999999999997940000,0.0000000000000002060000,0,"",241101 - Mineral Aurifero sin Procesar,,"",13939,,,,
Ubicaciones virtuales / Produccion,Physical Locations / AMCAQ / Existencias,/ AMCAQ / Existencias,08,Mineral con Contenido Aurifero y Argentifero sin Procesar,M0002,t,LLAMPO,2018-12-31,2018-12-31,,PAMC004230,,,PAMC004230,,6.740000,0,6.740000,1010.8116529154302671,6812.87054065,0,6812.87054065,1010.8116529154302671,"",241101 - Mineral Aurifero sin Procesar,,"",13939,,,,
Partner Locations / Suppliers,Physical Locations / AQP M / Existencias,/ AQP M / Existencias,03,Mineral con Contenido Aurifero y Argentifero sin Procesar,M0002,t,LLAMPO,2018-12-04,2018-12-04,12/2018,AQP M\IN\04537,01,E001,0000008,ROLANDO SONCCO MOLINA,6.834000,0,6.834000,724.3883523558677202,4950.47,0,4950.47,724.3883523558677202,602101 - Mineral Aurifero sin Procesar,241101 - Mineral Aurifero sin Procesar,,"",13940,18PO06565,,2018-12-04,
Physical Locations / AQP M / Existencias,Ubicaciones virtuales / Produccion,/ AQP M / Existencias,07,Mineral con Contenido Aurifero y Argentifero sin Procesar,M0002,t,LLAMPO,2018-12-31,2018-12-31,,MAMC-004224,,,MAMC-004224,,0,6.834000,0.000000,724.3883523558677202,0,4950.4699999999999998468000,0.0000000000000001532000,0,"",241101 - Mineral Aurifero sin Procesar,,"",13940,,,,
Ubicaciones virtuales / Produccion,Physical Locations / AMCAQ / Existencias,/ AMCAQ / Existencias,08,Mineral con Contenido Aurifero y Argentifero sin Procesar,M0002,t,LLAMPO,2018-12-31,2018-12-31,,PAMC004230,,,PAMC004230,,6.834000,0,6.834000,929.7534206306701785,6353.93487659,0,6353.93487659,929.7534206306701785,"",241101 - Mineral Aurifero sin Procesar,,"",13940,,,,
Partner Locations / Suppliers,Physical Locations / AQP M / Existencias,/ AQP M / Existencias,03,Mineral con Contenido Aurifero y Argentifero sin Procesar,M0002,t,LLAMPO,2018-12-04,2018-12-04,12/2018,AQP M\IN\04537,01,E001,0000008,ROLANDO SONCCO MOLINA,7.566000,0,7.566000,883.6003172085646312,6685.32,0,6685.32,883.6003172085646312,602101 - Mineral Aurifero sin Procesar,241101 - Mineral Aurifero sin Procesar,,"",13941,18PO06565,,2018-12-04,
Physical Locations / AQP M / Existencias,Ubicaciones virtuales / Produccion,/ AQP M / Existencias,07,Mineral con Contenido Aurifero y Argentifero sin Procesar,M0002,t,LLAMPO,2018-12-31,2018-12-31,,MAMC-004225,,,MAMC-004225,,0,7.566000,0.000000,883.6003172085646312,0,6685.3199999999999996592000,0.0000000000000003408000,0,"",241101 - Mineral Aurifero sin Procesar,,"",13941,,,,
Ubicaciones virtuales / Produccion,Physical Locations / AMCAQ / Existencias,/ AMCAQ / Existencias,08,Mineral con Contenido Aurifero y Argentifero sin Procesar,M0002,t,LLAMPO,2018-12-31,2018-12-31,,PAMC004231,,,PAMC004231,,7.566000,0,7.566000,1088.9653129592915675,8239.11155785,0,8239.11155785,1088.9653129592915675,"",241101 - Mineral Aurifero sin Procesar,,"",13941,,,,
Partner Locations / Suppliers,Physical Locations / AQP M / Existencias,/ AQP M / Existencias,03,Mineral con Contenido Aurifero y Argentifero sin Procesar,M0002,t,LLAMPO,2018-12-04,2018-12-04,12/2018,AQP M\IN\04537,01,E001,0000008,ROLANDO SONCCO MOLINA,7.467000,0,7.467000,895.1118253649390652,6683.8,0,6683.8,895.1118253649390652,602101 - Mineral Aurifero sin Procesar,241101 - Mineral Aurifero sin Procesar,,"",13942,18PO06565,,2018-12-04,
Physical Locations / AQP M / Existencias,Ubicaciones virtuales / Produccion,/ AQP M / Existencias,07,Mineral con Contenido Aurifero y Argentifero sin Procesar,M0002,t,LLAMPO,2018-12-31,2018-12-31,,MAMC-004225,,,MAMC-004225,,0,7.467000,0.000000,895.1118253649390652,0,6683.7999999999999998484000,0.0000000000000001516000,0,"",241101 - Mineral Aurifero sin Procesar,,"",13942,,,,
Ubicaciones virtuales / Produccion,Physical Locations / AMCAQ / Existencias,/ AMCAQ / Existencias,08,Mineral con Contenido Aurifero y Argentifero sin Procesar,M0002,t,LLAMPO,2018-12-31,2018-12-31,,PAMC004231,,,PAMC004231,,7.467000,0,7.467000,1100.4765971233427079,8217.25875072,0,8217.25875072,1100.4765971233427079,"",241101 - Mineral Aurifero sin Procesar,,"",13942,,,,
Partner Locations / Suppliers,Physical Locations / AQP M / Existencias,/ AQP M / Existencias,03,Mineral con Contenido Aurifero y Argentifero sin Procesar,M0002,t,LLAMPO,2018-12-05,2018-12-05,12/2018,AQP M\IN\04525,01,0002,0000124,LUIS GONZAGA VALDIVIA RANILLA,2.802000,0,2.802000,3235.9778729478943612,9067.21,0,9067.21,3235.9778729478943612,602101 - Mineral Aurifero sin Procesar,241101 - Mineral Aurifero sin Procesar,,"",13943,18PO06481,,2018-12-05,
Physical Locations / AQP M / Existencias,Ubicaciones virtuales / Produccion,/ AQP M / Existencias,07,Mineral con Contenido Aurifero y Argentifero sin Procesar,M0002,t,LLAMPO,2018-12-31,2018-12-31,,MAMC-004225,,,MAMC-004225,,0,2.802000,0.000000,3235.9778729478943612,0,9067.2100000000000000824000,-0.0000000000000000824000,0,"",241101 - Mineral Aurifero sin Procesar,,"",13943,,,,
Ubicaciones virtuales / Produccion,Physical Locations / AMCAQ / Existencias,/ AMCAQ / Existencias,08,Mineral con Contenido Aurifero y Argentifero sin Procesar,M0002,t,LLAMPO,2018-12-31,2018-12-31,,PAMC004231,,,PAMC004231,,2.802000,0,2.802000,3441.3432777837259101,9642.64386435,0,9642.64386435,3441.3432777837259101,"",241101 - Mineral Aurifero sin Procesar,,"",13943,,,,
Partner Locations / Suppliers,Physical Locations / AQP M / Existencias,/ AQP M / Existencias,03,Mineral con Contenido Aurifero y Argentifero sin Procesar,M0001,t,MINERAL AURIFERO Y ARGENTIFERO SIN PROCESAR,2018-12-05,2018-12-05,12/2018,AQP M\IN\04525,01,0002,0000124,LUIS GONZAGA VALDIVIA RANILLA,0.926000,0,0.926000,1793.5097192224622030,1660.79,0,1660.79,1793.5097192224622030,602101 - Mineral Aurifero sin Procesar,241101 - Mineral Aurifero sin Procesar,,"",13944,18PO06481,,2018-12-05,
,,/ AQP M / Existencias,"",Mineral con Contenido Aurifero y Argentifero sin Procesar,"","",MINERAL AURIFERO Y ARGENTIFERO SIN PROCESAR,,2018-12-14,12/2018,,01,0002,0000126,LUIS GONZAGA VALDIVIA RANILLA,0,0,0.926000,1896.3174946004319654,95.2,0,1755.99,1896.3174946004319654,609201,241101 - Mineral Aurifero sin Procesar,"",,13944,,,,t
Physical Locations / AQP M / Existencias,Ubicaciones virtuales / Produccion,/ AQP M / Existencias,07,Mineral con Contenido Aurifero y Argentifero sin Procesar,M0001,t,MINERAL AURIFERO Y ARGENTIFERO SIN PROCESAR,2018-12-31,2018-12-31,,MAMC-004225,,,MAMC-004225,,0,0.926000,0.000000,1896.3174946004319654,0,1755.9899999999999999604000,0.0000000000000000396000,0,"",241101 - Mineral Aurifero sin Procesar,,"",13944,,,,
Ubicaciones virtuales / Produccion,Physical Locations / AMCAQ / Existencias,/ AMCAQ / Existencias,08,Mineral con Contenido Aurifero y Argentifero sin Procesar,M0001,t,MINERAL AURIFERO Y ARGENTIFERO SIN PROCESAR,2018-12-31,2018-12-31,,PAMC004231,,,PAMC004231,,0.926000,0,0.926000,2166.7360844060475162,2006.39761416,0,2006.39761416,2166.7360844060475162,"",241101 - Mineral Aurifero sin Procesar,,"",13944,,,,
Partner Locations / Suppliers,Physical Locations / AQP M / Existencias,/ AQP M / Existencias,03,Mineral con Contenido Aurifero y Argentifero sin Procesar,M0001,t,MINERAL AURIFERO Y ARGENTIFERO SIN PROCESAR,2018-12-05,2018-12-05,12/2018,AQP M\IN\04525,01,0002,0000124,LUIS GONZAGA VALDIVIA RANILLA,5.393000,0,5.393000,1124.2944557760059336,6063.32,0,6063.32,1124.2944557760059336,602101 - Mineral Aurifero sin Procesar,241101 - Mineral Aurifero sin Procesar,,"",13945,18PO06481,,2018-12-05,
,,/ AQP M / Existencias,"",Mineral con Contenido Aurifero y Argentifero sin Procesar,"","",MINERAL AURIFERO Y ARGENTIFERO SIN PROCESAR,,2018-12-14,12/2018,,01,0002,0000126,LUIS GONZAGA VALDIVIA RANILLA,0,0,5.393000,1179.4140552568143890,297.26,0,6360.58,1179.4140552568143890,609201,241101 - Mineral Aurifero sin Procesar,"",,13945,,,,t
Physical Locations / AQP M / Existencias,Ubicaciones virtuales / Produccion,/ AQP M / Existencias,07,Mineral con Contenido Aurifero y Argentifero sin Procesar,M0001,t,MINERAL AURIFERO Y ARGENTIFERO SIN PROCESAR,2018-12-31,2018-12-31,,MAMC-004225,,,MAMC-004225,,0,5.393000,0.000000,1179.4140552568143890,0,6360.5799999999999998770000,0.0000000000000001230000,0,"",241101 - Mineral Aurifero sin Procesar,,"",13945,,,,
Ubicaciones virtuales / Produccion,Physical Locations / AMCAQ / Existencias,/ AMCAQ / Existencias,08,Mineral con Contenido Aurifero y Argentifero sin Procesar,M0001,t,MINERAL AURIFERO Y ARGENTIFERO SIN PROCESAR,2018-12-31,2018-12-31,,PAMC004231,,,PAMC004231,,5.393000,0,5.393000,1449.8342984924902652,7818.95637177,0,7818.95637177,1449.8342984924902652,"",241101 - Mineral Aurifero sin Procesar,,"",13945,,,,
Partner Locations / Suppliers,Physical Locations / AQP M / Existencias,/ AQP M / Existencias,03,Mineral con Contenido Aurifero y Argentifero sin Procesar,M0001,t,MINERAL AURIFERO Y ARGENTIFERO SIN PROCESAR,2018-12-05,2018-12-05,12/2018,AQP M\IN\04638,01,0002,0000082,ROLO OMAR SUNNY ANCCO,2.453000,0,2.453000,2047.4154097024052181,5022.31,0,5022.31,2047.4154097024052181,602101 - Mineral Aurifero sin Procesar,241101 - Mineral Aurifero sin Procesar,,"",13946,18PO06808,,2018-12-05,
Physical Locations / AQP M / Existencias,Ubicaciones virtuales / Produccion,/ AQP M / Existencias,07,Mineral con Contenido Aurifero y Argentifero sin Procesar,M0001,t,MINERAL AURIFERO Y ARGENTIFERO SIN PROCESAR,2018-12-31,2018-12-31,,MAMC-004225,,,MAMC-004225,,0,2.453000,0.000000,2047.4154097024052181,0,5022.3099999999999999993000,0.0000000000000000007000,0,"",241101 - Mineral Aurifero sin Procesar,,"",13946,,,,
Ubicaciones virtuales / Produccion,Physical Locations / AMCAQ / Existencias,/ AMCAQ / Existencias,08,Mineral con Contenido Aurifero y Argentifero sin Procesar,M0001,t,MINERAL AURIFERO Y ARGENTIFERO SIN PROCESAR,2018-12-31,2018-12-31,,PAMC004231,,,PAMC004231,,2.453000,0,2.453000,2317.8355226008968610,5685.65053694,0,5685.65053694,2317.8355226008968610,"",241101 - Mineral Aurifero sin Procesar,,"",13946,,,,
Partner Locations / Suppliers,Physical Locations / AQP M / Existencias,/ AQP M / Existencias,03,Mineral con Contenido Aurifero y Argentifero sin Procesar,M0001,t,MINERAL AURIFERO Y ARGENTIFERO SIN PROCESAR,2018-12-05,2018-12-05,12/2018,AQP M\IN\04638,01,0002,0000082,ROLO OMAR SUNNY ANCCO,4.560000,0,4.560000,1507.0065789473684211,6871.95,0,6871.95,1507.0065789473684211,602101 - Mineral Aurifero sin Procesar,241101 - Mineral Aurifero sin Procesar,,"",13947,18PO06808,,2018-12-05,
Physical Locations / AQP M / Existencias,Ubicaciones virtuales / Produccion,/ AQP M / Existencias,07,Mineral con Contenido Aurifero y Argentifero sin Procesar,M0001,t,MINERAL AURIFERO Y ARGENTIFERO SIN PROCESAR,2018-12-31,2018-12-31,,MAMC-004225,,,MAMC-004225,,0,4.560000,0.000000,1507.0065789473684211,0,6871.9500000000000002160000,-0.0000000000000002160000,0,"",241101 - Mineral Aurifero sin Procesar,,"",13947,,,,
Ubicaciones virtuales / Produccion,Physical Locations / AMCAQ / Existencias,/ AMCAQ / Existencias,08,Mineral con Contenido Aurifero y Argentifero sin Procesar,M0001,t,MINERAL AURIFERO Y ARGENTIFERO SIN PROCESAR,2018-12-31,2018-12-31,,PAMC004231,,,PAMC004231,,4.560000,0,4.560000,1777.4263797982456140,8105.06429188,0,8105.06429188,1777.4263797982456140,"",241101 - Mineral Aurifero sin Procesar,,"",13947,,,,
Partner Locations / Suppliers,Physical Locations / AQP M / Existencias,/ AQP M / Existencias,03,Mineral con Contenido Aurifero y Argentifero sin Procesar,M0001,t,MINERAL AURIFERO Y ARGENTIFERO SIN PROCESAR,2018-12-05,2018-12-05,12/2018,AQP M\IN\04525,01,0002,0000124,LUIS GONZAGA VALDIVIA RANILLA,0.746000,0,0.746000,577.4128686327077748,430.75,0,430.75,577.4128686327077748,602101 - Mineral Aurifero sin Procesar,241101 - Mineral Aurifero sin Procesar,,"",13948,18PO06481,,2018-12-05,
Physical Locations / AQP M / Existencias,Ubicaciones virtuales / Produccion,/ AQP M / Existencias,07,Mineral con Contenido Aurifero y Argentifero sin Procesar,M0001,t,MINERAL AURIFERO Y ARGENTIFERO SIN PROCESAR,2018-12-31,2018-12-31,,MAMC-004225,,,MAMC-004225,,0,0.746000,0.000000,577.4128686327077748,0,430.7500000000000000008000,-0.0000000000000000008000,0,"",241101 - Mineral Aurifero sin Procesar,,"",13948,,,,
Ubicaciones virtuales / Produccion,Physical Locations / AMCAQ / Existencias,/ AMCAQ / Existencias,08,Mineral con Contenido Aurifero y Argentifero sin Procesar,M0001,t,MINERAL AURIFERO Y ARGENTIFERO SIN PROCESAR,2018-12-31,2018-12-31,,PAMC004231,,,PAMC004231,,0.746000,0,0.746000,847.8323219436997319,632.48291217,0,632.48291217,847.8323219436997319,"",241101 - Mineral Aurifero sin Procesar,,"",13948,,,,
Partner Locations / Suppliers,Physical Locations / AQP M / Existencias,/ AQP M / Existencias,03,Mineral con Contenido Aurifero y Argentifero sin Procesar,M0001,t,MINERAL AURIFERO Y ARGENTIFERO SIN PROCESAR,2018-12-05,2018-12-05,12/2018,AQP M\IN\04638,01,0002,0000082,ROLO OMAR SUNNY ANCCO,17.575000,0,17.575000,285.9152204836415363,5024.96,0,5024.96,285.9152204836415363,602101 - Mineral Aurifero sin Procesar,241101 - Mineral Aurifero sin Procesar,,"",13949,18PO06808,,2018-12-05,
Physical Locations / AQP M / Existencias,Ubicaciones virtuales / Produccion,/ AQP M / Existencias,07,Mineral con Contenido Aurifero y Argentifero sin Procesar,M0001,t,MINERAL AURIFERO Y ARGENTIFERO SIN PROCESAR,2018-12-31,2018-12-31,,MAMC-004225,,,MAMC-004225,,0,17.575000,0.000000,285.9152204836415363,0,5024.9600000000000004725000,-0.0000000000000004725000,0,"",241101 - Mineral Aurifero sin Procesar,,"",13949,,,,
Ubicaciones virtuales / Produccion,Physical Locations / AMCAQ / Existencias,/ AMCAQ / Existencias,08,Mineral con Contenido Aurifero y Argentifero sin Procesar,M0001,t,MINERAL AURIFERO Y ARGENTIFERO SIN PROCESAR,2018-12-31,2018-12-31,,PAMC004231,,,PAMC004231,,17.575000,0,17.575000,556.3354741900426743,9777.59595889,0,9777.59595889,556.3354741900426743,"",241101 - Mineral Aurifero sin Procesar,,"",13949,,,,
Partner Locations / Suppliers,Physical Locations / AQP M / Existencias,/ AQP M / Existencias,03,Mineral con Contenido Aurifero y Argentifero sin Procesar,M0001,t,MINERAL AURIFERO Y ARGENTIFERO SIN PROCESAR,2018-12-05,2018-12-05,12/2018,AQP M\IN\04599,01,E001,0002295,COMUNIDAD CAMPESINA CHILLOROYA,0.755000,0,0.755000,287.2582781456953642,216.88,0,216.88,287.2582781456953642,602101 - Mineral Aurifero sin Procesar,241101 - Mineral Aurifero sin Procesar,,"",13950,18PO06698,,2018-12-05,
Physical Locations / AQP M / Existencias,Ubicaciones virtuales / Produccion,/ AQP M / Existencias,07,Mineral con Contenido Aurifero y Argentifero sin Procesar,M0001,t,MINERAL AURIFERO Y ARGENTIFERO SIN PROCESAR,2018-12-31,2018-12-31,,MAMC-004225,,,MAMC-004225,,0,0.755000,0.000000,287.2582781456953642,0,216.8799999999999999710000,0.0000000000000000290000,0,"",241101 - Mineral Aurifero sin Procesar,,"",13950,,,,
Ubicaciones virtuales / Produccion,Physical Locations / AMCAQ / Existencias,/ AMCAQ / Existencias,08,Mineral con Contenido Aurifero y Argentifero sin Procesar,M0001,t,MINERAL AURIFERO Y ARGENTIFERO SIN PROCESAR,2018-12-31,2018-12-31,,PAMC004231,,,PAMC004231,,0.755000,0,0.755000,557.6784877483443709,421.04725825,0,421.04725825,557.6784877483443709,"",241101 - Mineral Aurifero sin Procesar,,"",13950,,,,
Partner Locations / Suppliers,Physical Locations / AQP M / Existencias,/ AQP M / Existencias,03,Mineral con Contenido Aurifero y Argentifero sin Procesar,M0001,t,MINERAL AURIFERO Y ARGENTIFERO SIN PROCESAR,2018-12-05,2018-12-05,12/2018,AQP M\IN\04599,01,E001,0002295,COMUNIDAD CAMPESINA CHILLOROYA,0.707000,0,0.707000,0.0000000000000000,0,0,0,0.0000000000000000,,241101 - Mineral Aurifero sin Procesar,,"",13951,18PO06698,,2018-12-05,
Physical Locations / AQP M / Existencias,Ubicaciones virtuales / Produccion,/ AQP M / Existencias,07,Mineral con Contenido Aurifero y Argentifero sin Procesar,M0001,t,MINERAL AURIFERO Y ARGENTIFERO SIN PROCESAR,2018-12-31,2018-12-31,,MAMC-004226,,,MAMC-004226,,0,0.707000,0.000000,0.0000000000000000,0,0.0000000000000000000000,0.0000000000000000000000,0,"",241101 - Mineral Aurifero sin Procesar,,"",13951,,,,
Ubicaciones virtuales / Produccion,Physical Locations / AMCAQ / Existencias,/ AMCAQ / Existencias,08,Mineral con Contenido Aurifero y Argentifero sin Procesar,M0001,t,MINERAL AURIFERO Y ARGENTIFERO SIN PROCESAR,2018-12-31,2018-12-31,,PAMC004232,,,PAMC004232,,0.707000,0,0.707000,270.4228505940594059,191.18895537,0,191.18895537,270.4228505940594059,"",241101 - Mineral Aurifero sin Procesar,,"",13951,,,,
Partner Locations / Suppliers,Physical Locations / AQP M / Existencias,/ AQP M / Existencias,03,Mineral con Contenido Aurifero y Argentifero sin Procesar,M0001,t,MINERAL AURIFERO Y ARGENTIFERO SIN PROCESAR,2018-12-05,2018-12-05,12/2018,AQP M\IN\04599,01,E001,0002295,COMUNIDAD CAMPESINA CHILLOROYA,0.829000,0,0.829000,0.0000000000000000,0,0,0,0.0000000000000000,,241101 - Mineral Aurifero sin Procesar,,"",13952,18PO06698,,2018-12-05,
Physical Locations / AQP M / Existencias,Ubicaciones virtuales / Produccion,/ AQP M / Existencias,07,Mineral con Contenido Aurifero y Argentifero sin Procesar,M0001,t,MINERAL AURIFERO Y ARGENTIFERO SIN PROCESAR,2018-12-31,2018-12-31,,MAMC-004226,,,MAMC-004226,,0,0.829000,0.000000,0.0000000000000000,0,0.0000000000000000000000,0.0000000000000000000000,0,"",241101 - Mineral Aurifero sin Procesar,,"",13952,,,,
Ubicaciones virtuales / Produccion,Physical Locations / AMCAQ / Existencias,/ AMCAQ / Existencias,08,Mineral con Contenido Aurifero y Argentifero sin Procesar,M0001,t,MINERAL AURIFERO Y ARGENTIFERO SIN PROCESAR,2018-12-31,2018-12-31,,PAMC004232,,,PAMC004232,,0.829000,0,0.829000,270.4201610012062726,224.17831347,0,224.17831347,270.4201610012062726,"",241101 - Mineral Aurifero sin Procesar,,"",13952,,,,
Partner Locations / Suppliers,Physical Locations / AQP M / Existencias,/ AQP M / Existencias,03,Mineral con Contenido Aurifero y Argentifero sin Procesar,M0001,t,MINERAL AURIFERO Y ARGENTIFERO SIN PROCESAR,2018-12-05,2018-12-05,12/2018,AQP M\IN\04583,01,E001,0000078,SAUL JOSE GROVAS QUISPE,0.805000,0,0.805000,7452.2857142857142857,5999.09,0,5999.09,7452.2857142857142857,602101 - Mineral Aurifero sin Procesar,241101 - Mineral Aurifero sin Procesar,,"",13953,18PO06635,,2018-12-05,
Physical Locations / AQP M / Existencias,Ubicaciones virtuales / Produccion,/ AQP M / Existencias,07,Mineral con Contenido Aurifero y Argentifero sin Procesar,M0001,t,MINERAL AURIFERO Y ARGENTIFERO SIN PROCESAR,2018-12-31,2018-12-31,,MAMC-004226,,,MAMC-004226,,0,0.805000,0.000000,7452.2857142857142857,0,5999.0899999999999999885000,0.0000000000000000115000,0,"",241101 - Mineral Aurifero sin Procesar,,"",13953,,,,
Ubicaciones virtuales / Produccion,Physical Locations / AMCAQ / Existencias,/ AMCAQ / Existencias,08,Mineral con Contenido Aurifero y Argentifero sin Procesar,M0001,t,MINERAL AURIFERO Y ARGENTIFERO SIN PROCESAR,2018-12-31,2018-12-31,,PAMC004232,,,PAMC004232,,0.805000,0,0.805000,7722.7063518385093168,6216.77861323,0,6216.77861323,7722.7063518385093168,"",241101 - Mineral Aurifero sin Procesar,,"",13953,,,,
Partner Locations / Suppliers,Physical Locations / AQP M / Existencias,/ AQP M / Existencias,03,Mineral con Contenido Aurifero y Argentifero sin Procesar,M0001,t,MINERAL AURIFERO Y ARGENTIFERO SIN PROCESAR,2018-12-06,2018-12-06,12/2018,AQP M\IN\04597,01,E001,0002293,COMUNIDAD CAMPESINA CHILLOROYA,1.285000,0,1.285000,155.8988326848249027,200.33,0,200.33,155.8988326848249027,602101 - Mineral Aurifero sin Procesar,241101 - Mineral Aurifero sin Procesar,,"",13954,18PO06691,,2018-12-06,
Physical Locations / AQP M / Existencias,Ubicaciones virtuales / Produccion,/ AQP M / Existencias,07,Mineral con Contenido Aurifero y Argentifero sin Procesar,M0001,t,MINERAL AURIFERO Y ARGENTIFERO SIN PROCESAR,2018-12-31,2018-12-31,,MAMC-004226,,,MAMC-004226,,0,1.285000,0.000000,155.8988326848249027,0,200.3299999999999999695000,0.0000000000000000305000,0,"",241101 - Mineral Aurifero sin Procesar,,"",13954,,,,
Ubicaciones virtuales / Produccion,Physical Locations / AMCAQ / Existencias,/ AMCAQ / Existencias,08,Mineral con Contenido Aurifero y Argentifero sin Procesar,M0001,t,MINERAL AURIFERO Y ARGENTIFERO SIN PROCESAR,2018-12-31,2018-12-31,,PAMC004232,,,PAMC004232,,1.285000,0,1.285000,426.3183449260700389,547.81907323,0,547.81907323,426.3183449260700389,"",241101 - Mineral Aurifero sin Procesar,,"",13954,,,,
Partner Locations / Suppliers,Physical Locations / AQP M / Existencias,/ AQP M / Existencias,03,Mineral con Contenido Aurifero y Argentifero sin Procesar,M0001,t,MINERAL AURIFERO Y ARGENTIFERO SIN PROCESAR,2018-12-06,2018-12-06,12/2018,AQP M\IN\04597,01,E001,0002293,COMUNIDAD CAMPESINA CHILLOROYA,1.216000,0,1.216000,103.8980263157894737,126.34,0,126.34,103.8980263157894737,602101 - Mineral Aurifero sin Procesar,241101 - Mineral Aurifero sin Procesar,,"",13955,18PO06691,,2018-12-06,
Physical Locations / AQP M / Existencias,Ubicaciones virtuales / Produccion,/ AQP M / Existencias,07,Mineral con Contenido Aurifero y Argentifero sin Procesar,M0001,t,MINERAL AURIFERO Y ARGENTIFERO SIN PROCESAR,2018-12-31,2018-12-31,,MAMC-004226,,,MAMC-004226,,0,1.216000,0.000000,103.8980263157894737,0,126.3400000000000000192000,-0.0000000000000000192000,0,"",241101 - Mineral Aurifero sin Procesar,,"",13955,,,,
Ubicaciones virtuales / Produccion,Physical Locations / AMCAQ / Existencias,/ AMCAQ / Existencias,08,Mineral con Contenido Aurifero y Argentifero sin Procesar,M0001,t,MINERAL AURIFERO Y ARGENTIFERO SIN PROCESAR,2018-12-31,2018-12-31,,PAMC004232,,,PAMC004232,,1.216000,0,1.216000,374.3172422450657895,455.16976657,0,455.16976657,374.3172422450657895,"",241101 - Mineral Aurifero sin Procesar,,"",13955,,,,
Partner Locations / Suppliers,Physical Locations / AQP M / Existencias,/ AQP M / Existencias,03,Mineral con Contenido Aurifero y Argentifero sin Procesar,M0001,t,MINERAL AURIFERO Y ARGENTIFERO SIN PROCESAR,2018-12-06,2018-12-06,12/2018,AQP M\IN\04597,01,E001,0002293,COMUNIDAD CAMPESINA CHILLOROYA,1.624000,0,1.624000,287.3953201970443350,466.73,0,466.73,287.3953201970443350,602101 - Mineral Aurifero sin Procesar,241101 - Mineral Aurifero sin Procesar,,"",13956,18PO06691,,2018-12-06,
Physical Locations / AQP M / Existencias,Ubicaciones virtuales / Produccion,/ AQP M / Existencias,07,Mineral con Contenido Aurifero y Argentifero sin Procesar,M0001,t,MINERAL AURIFERO Y ARGENTIFERO SIN PROCESAR,2018-12-31,2018-12-31,,MAMC-004226,,,MAMC-004226,,0,1.624000,0.000000,287.3953201970443350,0,466.7300000000000000400000,-0.0000000000000000400000,0,"",241101 - Mineral Aurifero sin Procesar,,"",13956,,,,
Ubicaciones virtuales / Produccion,Physical Locations / AMCAQ / Existencias,/ AMCAQ / Existencias,08,Mineral con Contenido Aurifero y Argentifero sin Procesar,M0001,t,MINERAL AURIFERO Y ARGENTIFERO SIN PROCESAR,2018-12-31,2018-12-31,,PAMC004232,,,PAMC004232,,1.624000,0,1.624000,557.8146887746305419,905.89105457,0,905.89105457,557.8146887746305419,"",241101 - Mineral Aurifero sin Procesar,,"",13956,,,,
Partner Locations / Suppliers,Physical Locations / AQP M / Existencias,/ AQP M / Existencias,03,Mineral con Contenido Aurifero y Argentifero sin Procesar,M0001,t,MINERAL AURIFERO Y ARGENTIFERO SIN PROCESAR,2018-12-06,2018-12-06,12/2018,AQP M\IN\04597,01,E001,0002293,COMUNIDAD CAMPESINA CHILLOROYA,1.393000,0,1.393000,227.3295046661880833,316.67,0,316.67,227.3295046661880833,602101 - Mineral Aurifero sin Procesar,241101 - Mineral Aurifero sin Procesar,,"",13957,18PO06691,,2018-12-06,
Physical Locations / AQP M / Existencias,Ubicaciones virtuales / Produccion,/ AQP M / Existencias,07,Mineral con Contenido Aurifero y Argentifero sin Procesar,M0001,t,MINERAL AURIFERO Y ARGENTIFERO SIN PROCESAR,2018-12-31,2018-12-31,,MAMC-004226,,,MAMC-004226,,0,1.393000,0.000000,227.3295046661880833,0,316.6700000000000000369000,-0.0000000000000000369000,0,"",241101 - Mineral Aurifero sin Procesar,,"",13957,,,,
Ubicaciones virtuales / Produccion,Physical Locations / AMCAQ / Existencias,/ AMCAQ / Existencias,08,Mineral con Contenido Aurifero y Argentifero sin Procesar,M0001,t,MINERAL AURIFERO Y ARGENTIFERO SIN PROCESAR,2018-12-31,2018-12-31,,PAMC004232,,,PAMC004232,,1.393000,0,1.393000,497.7491767552045944,693.36460322,0,693.36460322,497.7491767552045944,"",241101 - Mineral Aurifero sin Procesar,,"",13957,,,,
,,/ AQP M / Existencias,"",Mineral con Contenido Aurifero y Argentifero sin Procesar,"","",MINERAL AURIFERO Y ARGENTIFERO SIN PROCESAR,,2018-12-17,12/2018,,08,0001,0000001,DERY RUSSELI LAGUNA VERA,0,0,0,0,244.45,0,244.45,0,602101,241101 - Mineral Aurifero sin Procesar,"",,13958,,,,f
Partner Locations / Suppliers,Physical Locations / AQP M / Existencias,/ AQP M / Existencias,03,Mineral con Contenido Aurifero y Argentifero sin Procesar,M0002,t,LLAMPO,2018-12-06,2018-12-06,12/2018,AQP M\IN\04521,01,0001,0000027,DERY RUSSELI LAGUNA VERA,1.618000,0,1.618000,2738.2632880098887515,4430.51,0,4674.96,2889.3448702101359703,602101 - Mineral Aurifero sin Procesar,241101 - Mineral Aurifero sin Procesar,,"",13958,18PO06477,,2018-12-06,
Physical Locations / AQP M / Existencias,Ubicaciones virtuales / Produccion,/ AQP M / Existencias,07,Mineral con Contenido Aurifero y Argentifero sin Procesar,M0002,t,LLAMPO,2018-12-31,2018-12-31,,MAMC-004226,,,MAMC-004226,,0,1.618000,0.000000,2889.3448702101359703,0,4674.9599999999999999454000,0.0000000000000000546000,0,"",241101 - Mineral Aurifero sin Procesar,,"",13958,,,,
Ubicaciones virtuales / Produccion,Physical Locations / AMCAQ / Existencias,/ AMCAQ / Existencias,08,Mineral con Contenido Aurifero y Argentifero sin Procesar,M0002,t,LLAMPO,2018-12-31,2018-12-31,,PAMC004232,,,PAMC004232,,1.618000,0,1.618000,3094.7107054573547590,5007.24192143,0,5007.24192143,3094.7107054573547590,"",241101 - Mineral Aurifero sin Procesar,,"",13958,,,,
Partner Locations / Suppliers,Physical Locations / AQP M / Existencias,/ AQP M / Existencias,03,Mineral con Contenido Aurifero y Argentifero sin Procesar,M0001,t,MINERAL AURIFERO Y ARGENTIFERO SIN PROCESAR,2018-12-06,2018-12-06,12/2018,AQP M\IN\04597,01,E001,0002293,COMUNIDAD CAMPESINA CHILLOROYA,1.001000,0,1.001000,294.6253746253746254,294.92,0,294.92,294.6253746253746254,602101 - Mineral Aurifero sin Procesar,241101 - Mineral Aurifero sin Procesar,,"",13959,18PO06691,,2018-12-06,
Physical Locations / AQP M / Existencias,Ubicaciones virtuales / Produccion,/ AQP M / Existencias,07,Mineral con Contenido Aurifero y Argentifero sin Procesar,M0001,t,MINERAL AURIFERO Y ARGENTIFERO SIN PROCESAR,2018-12-31,2018-12-31,,MAMC-004226,,,MAMC-004226,,0,1.001000,0.000000,294.6253746253746254,0,294.9200000000000000254000,-0.0000000000000000254000,0,"",241101 - Mineral Aurifero sin Procesar,,"",13959,,,,
Ubicaciones virtuales / Produccion,Physical Locations / AMCAQ / Existencias,/ AMCAQ / Existencias,08,Mineral con Contenido Aurifero y Argentifero sin Procesar,M0001,t,MINERAL AURIFERO Y ARGENTIFERO SIN PROCESAR,2018-12-31,2018-12-31,,PAMC004232,,,PAMC004232,,1.001000,0,1.001000,565.0451874725274725,565.61023266,0,565.61023266,565.0451874725274725,"",241101 - Mineral Aurifero sin Procesar,,"",13959,,,,
Partner Locations / Suppliers,Physical Locations / AQP M / Existencias,/ AQP M / Existencias,03,Mineral con Contenido Aurifero y Argentifero sin Procesar,M0001,t,MINERAL AURIFERO Y ARGENTIFERO SIN PROCESAR,2018-12-06,2018-12-06,12/2018,AQP M\IN\04597,01,E001,0002293,COMUNIDAD CAMPESINA CHILLOROYA,1.013000,0,1.013000,264.7384007897334650,268.18,0,268.18,264.7384007897334650,602101 - Mineral Aurifero sin Procesar,241101 - Mineral Aurifero sin Procesar,,"",13960,18PO06691,,2018-12-06,
Physical Locations / AQP M / Existencias,Ubicaciones virtuales / Produccion,/ AQP M / Existencias,07,Mineral con Contenido Aurifero y Argentifero sin Procesar,M0001,t,MINERAL AURIFERO Y ARGENTIFERO SIN PROCESAR,2018-12-31,2018-12-31,,MAMC-004226,,,MAMC-004226,,0,1.013000,0.000000,264.7384007897334650,0,268.1800000000000000450000,-0.0000000000000000450000,0,"",241101 - Mineral Aurifero sin Procesar,,"",13960,,,,
Ubicaciones virtuales / Produccion,Physical Locations / AMCAQ / Existencias,/ AMCAQ / Existencias,08,Mineral con Contenido Aurifero y Argentifero sin Procesar,M0001,t,MINERAL AURIFERO Y ARGENTIFERO SIN PROCESAR,2018-12-31,2018-12-31,,PAMC004232,,,PAMC004232,,1.013000,0,1.013000,535.1574682724580454,542.11451536,0,542.11451536,535.1574682724580454,"",241101 - Mineral Aurifero sin Procesar,,"",13960,,,,
Partner Locations / Suppliers,Physical Locations / AQP M / Existencias,/ AQP M / Existencias,03,Mineral con Contenido Aurifero y Argentifero sin Procesar,M0001,t,MINERAL AURIFERO Y ARGENTIFERO SIN PROCESAR,2018-12-06,2018-12-06,12/2018,AQP M\IN\04598,01,E001,0002292,COMUNIDAD CAMPESINA CHILLOROYA,4.398000,0,4.398000,129.9226921327876307,571.4,0,571.4,129.9226921327876307,602101 - Mineral Aurifero sin Procesar,241101 - Mineral Aurifero sin Procesar,,"",13961,18PO06695,,2018-12-06,
Physical Locations / AQP M / Existencias,Ubicaciones virtuales / Produccion,/ AQP M / Existencias,07,Mineral con Contenido Aurifero y Argentifero sin Procesar,M0001,t,MINERAL AURIFERO Y ARGENTIFERO SIN PROCESAR,2018-12-31,2018-12-31,,MAMC-004227,,,MAMC-004227,,0,4.398000,0.000000,129.9226921327876307,0,571.3999999999999998186000,0.0000000000000001814000,0,"",241101 - Mineral Aurifero sin Procesar,,"",13961,,,,
Ubicaciones virtuales / Produccion,Physical Locations / AMCAQ / Existencias,/ AMCAQ / Existencias,08,Mineral con Contenido Aurifero y Argentifero sin Procesar,M0001,t,MINERAL AURIFERO Y ARGENTIFERO SIN PROCESAR,2018-12-31,2018-12-31,,PAMC004233,,,PAMC004233,,4.398000,0,4.398000,400.3424234402000910,1760.70597829,0,1760.70597829,400.3424234402000910,"",241101 - Mineral Aurifero sin Procesar,,"",13961,,,,
Partner Locations / Suppliers,Physical Locations / AQP M / Existencias,/ AQP M / Existencias,03,Mineral con Contenido Aurifero y Argentifero sin Procesar,M0001,t,MINERAL AURIFERO Y ARGENTIFERO SIN PROCESAR,2018-12-06,2018-12-06,12/2018,AQP M\IN\04598,01,E001,0002292,COMUNIDAD CAMPESINA CHILLOROYA,3.117000,0,3.117000,0.00000000000000000000,0,0,0,0.00000000000000000000,,241101 - Mineral Aurifero sin Procesar,,"",13962,18PO06695,,2018-12-06,
Physical Locations / AQP M / Existencias,Ubicaciones virtuales / Produccion,/ AQP M / Existencias,07,Mineral con Contenido Aurifero y Argentifero sin Procesar,M0001,t,MINERAL AURIFERO Y ARGENTIFERO SIN PROCESAR,2018-12-31,2018-12-31,,MAMC-004227,,,MAMC-004227,,0,3.117000,0.000000,0.00000000000000000000,0,0.00000000000000000000000000,0.00000000000000000000000000,0,"",241101 - Mineral Aurifero sin Procesar,,"",13962,,,,
Ubicaciones virtuales / Produccion,Physical Locations / AMCAQ / Existencias,/ AMCAQ / Existencias,08,Mineral con Contenido Aurifero y Argentifero sin Procesar,M0001,t,MINERAL AURIFERO Y ARGENTIFERO SIN PROCESAR,2018-12-31,2018-12-31,,PAMC004233,,,PAMC004233,,3.117000,0,3.117000,270.4201163233878730,842.89950258,0,842.89950258,270.4201163233878730,"",241101 - Mineral Aurifero sin Procesar,,"",13962,,,,
Partner Locations / Suppliers,Physical Locations / AQP M / Existencias,/ AQP M / Existencias,03,Mineral con Contenido Aurifero y Argentifero sin Procesar,M0001,t,MINERAL AURIFERO Y ARGENTIFERO SIN PROCESAR,2018-12-06,2018-12-06,12/2018,AQP M\IN\04598,01,E001,0002292,COMUNIDAD CAMPESINA CHILLOROYA,2.893000,0,2.893000,459.4780504666436225,1329.27,0,1329.27,459.4780504666436225,602101 - Mineral Aurifero sin Procesar,241101 - Mineral Aurifero sin Procesar,,"",13963,18PO06695,,2018-12-06,
Physical Locations / AQP M / Existencias,Ubicaciones virtuales / Produccion,/ AQP M / Existencias,07,Mineral con Contenido Aurifero y Argentifero sin Procesar,M0001,t,MINERAL AURIFERO Y ARGENTIFERO SIN PROCESAR,2018-12-31,2018-12-31,,MAMC-004227,,,MAMC-004227,,0,2.893000,0.000000,459.4780504666436225,0,1329.2699999999999998925000,0.0000000000000001075000,0,"",241101 - Mineral Aurifero sin Procesar,,"",13963,,,,
Ubicaciones virtuales / Produccion,Physical Locations / AMCAQ / Existencias,/ AMCAQ / Existencias,08,Mineral con Contenido Aurifero y Argentifero sin Procesar,M0001,t,MINERAL AURIFERO Y ARGENTIFERO SIN PROCESAR,2018-12-31,2018-12-31,,PAMC004233,,,PAMC004233,,2.893000,0,2.893000,729.8990283857587280,2111.59788912,0,2111.59788912,729.8990283857587280,"",241101 - Mineral Aurifero sin Procesar,,"",13963,,,,
Partner Locations / Suppliers,Physical Locations / AQP M / Existencias,/ AQP M / Existencias,03,Mineral con Contenido Aurifero y Argentifero sin Procesar,M0001,t,MINERAL AURIFERO Y ARGENTIFERO SIN PROCESAR,2018-12-06,2018-12-06,12/2018,AQP M\IN\04598,01,E001,0002292,COMUNIDAD CAMPESINA CHILLOROYA,3.929000,0,3.929000,631.7281751081700178,2482.06,0,2482.06,631.7281751081700178,602101 - Mineral Aurifero sin Procesar,241101 - Mineral Aurifero sin Procesar,,"",13964,18PO06695,,2018-12-06,
Physical Locations / AQP M / Existencias,Ubicaciones virtuales / Produccion,/ AQP M / Existencias,07,Mineral con Contenido Aurifero y Argentifero sin Procesar,M0001,t,MINERAL AURIFERO Y ARGENTIFERO SIN PROCESAR,2018-12-31,2018-12-31,,MAMC-004227,,,MAMC-004227,,0,3.929000,0.000000,631.7281751081700178,0,2482.0599999999999999362000,0.0000000000000000638000,0,"",241101 - Mineral Aurifero sin Procesar,,"",13964,,,,
Ubicaciones virtuales / Produccion,Physical Locations / AMCAQ / Existencias,/ AMCAQ / Existencias,08,Mineral con Contenido Aurifero y Argentifero sin Procesar,M0001,t,MINERAL AURIFERO Y ARGENTIFERO SIN PROCESAR,2018-12-31,2018-12-31,,PAMC004233,,,PAMC004233,,3.929000,0,3.929000,902.1485740824637312,3544.54174757,0,3544.54174757,902.1485740824637312,"",241101 - Mineral Aurifero sin Procesar,,"",13964,,,,
Partner Locations / Suppliers,Physical Locations / AQP M / Existencias,/ AQP M / Existencias,03,Mineral con Contenido Aurifero y Argentifero sin Procesar,M0001,t,MINERAL AURIFERO Y ARGENTIFERO SIN PROCESAR,2018-12-06,2018-12-06,12/2018,AQP M\IN\04535,01,E001,0000902,COMUNIDAD CAMPESINA DE UNTUCA,3.082000,0,3.082000,164.0168721609344581,505.5,0,505.5,164.0168721609344581,602101 - Mineral Aurifero sin Procesar,241101 - Mineral Aurifero sin Procesar,,"",13965,18PO06554,,2018-12-06,
Physical Locations / AQP M / Existencias,Ubicaciones virtuales / Produccion,/ AQP M / Existencias,07,Mineral con Contenido Aurifero y Argentifero sin Procesar,M0001,t,MINERAL AURIFERO Y ARGENTIFERO SIN PROCESAR,2018-12-31,2018-12-31,,MAMC-004227,,,MAMC-004227,,0,3.082000,0.000000,164.0168721609344581,0,505.4999999999999998642000,0.0000000000000001358000,0,"",241101 - Mineral Aurifero sin Procesar,,"",13965,,,,
Ubicaciones virtuales / Produccion,Physical Locations / AMCAQ / Existencias,/ AMCAQ / Existencias,08,Mineral con Contenido Aurifero y Argentifero sin Procesar,M0001,t,MINERAL AURIFERO Y ARGENTIFERO SIN PROCESAR,2018-12-31,2018-12-31,,PAMC004233,,,PAMC004233,,3.082000,0,3.082000,434.4373262719013628,1338.93583957,0,1338.93583957,434.4373262719013628,"",241101 - Mineral Aurifero sin Procesar,,"",13965,,,,
Partner Locations / Suppliers,Physical Locations / AQP M / Existencias,/ AQP M / Existencias,03,Mineral con Contenido Aurifero y Argentifero sin Procesar,M0001,t,MINERAL AURIFERO Y ARGENTIFERO SIN PROCESAR,2018-12-06,2018-12-06,12/2018,AQP M\IN\04535,01,E001,0000902,COMUNIDAD CAMPESINA DE UNTUCA,2.714000,0,2.714000,210.5932203389830508,571.55,0,571.55,210.5932203389830508,602101 - Mineral Aurifero sin Procesar,241101 - Mineral Aurifero sin Procesar,,"",13966,18PO06554,,2018-12-06,
Physical Locations / AQP M / Existencias,Ubicaciones virtuales / Produccion,/ AQP M / Existencias,07,Mineral con Contenido Aurifero y Argentifero sin Procesar,M0001,t,MINERAL AURIFERO Y ARGENTIFERO SIN PROCESAR,2018-12-31,2018-12-31,,MAMC-004227,,,MAMC-004227,,0,2.714000,0.000000,210.5932203389830508,0,571.5499999999999998712000,0.0000000000000001288000,0,"",241101 - Mineral Aurifero sin Procesar,,"",13966,,,,
Ubicaciones virtuales / Produccion,Physical Locations / AMCAQ / Existencias,/ AMCAQ / Existencias,08,Mineral con Contenido Aurifero y Argentifero sin Procesar,M0001,t,MINERAL AURIFERO Y ARGENTIFERO SIN PROCESAR,2018-12-31,2018-12-31,,PAMC004233,,,PAMC004233,,2.714000,0,2.714000,481.0128465438467207,1305.46886552,0,1305.46886552,481.0128465438467207,"",241101 - Mineral Aurifero sin Procesar,,"",13966,,,,
Partner Locations / Suppliers,Physical Locations / AQP M / Existencias,/ AQP M / Existencias,03,Mineral con Contenido Aurifero y Argentifero sin Procesar,M0002,t,LLAMPO,2018-12-06,2018-12-06,12/2018,AQP M\IN\04535,01,E001,0000902,COMUNIDAD CAMPESINA DE UNTUCA,3.364000,0,3.364000,2705.4667063020214031,9101.19,0,9101.19,2705.4667063020214031,602101 - Mineral Aurifero sin Procesar,241101 - Mineral Aurifero sin Procesar,,"",13967,18PO06554,,2018-12-06,
Physical Locations / AQP M / Existencias,Ubicaciones virtuales / Produccion,/ AQP M / Existencias,07,Mineral con Contenido Aurifero y Argentifero sin Procesar,M0002,t,LLAMPO,2018-12-31,2018-12-31,,MAMC-004227,,,MAMC-004227,,0,3.364000,0.000000,2705.4667063020214031,0,9101.1900000000000000284000,-0.0000000000000000284000,0,"",241101 - Mineral Aurifero sin Procesar,,"",13967,,,,
Ubicaciones virtuales / Produccion,Physical Locations / AMCAQ / Existencias,/ AMCAQ / Existencias,08,Mineral con Contenido Aurifero y Argentifero sin Procesar,M0002,t,LLAMPO,2018-12-31,2018-12-31,,PAMC004233,,,PAMC004233,,3.364000,0,3.364000,2910.8314972978596908,9792.03715691,0,9792.03715691,2910.8314972978596908,"",241101 - Mineral Aurifero sin Procesar,,"",13967,,,,
Partner Locations / Suppliers,Physical Locations / AQP M / Existencias,/ AQP M / Existencias,03,Mineral con Contenido Aurifero y Argentifero sin Procesar,M0002,t,LLAMPO,2018-12-06,2018-12-06,12/2018,AQP M\IN\04535,01,E001,0000902,COMUNIDAD CAMPESINA DE UNTUCA,5.453000,0,5.453000,2225.9545204474601137,12138.13,0,12138.13,2225.9545204474601137,602101 - Mineral Aurifero sin Procesar,241101 - Mineral Aurifero sin Procesar,,"",13968,18PO06554,,2018-12-06,
Physical Locations / AQP M / Existencias,Ubicaciones virtuales / Produccion,/ AQP M / Existencias,07,Mineral con Contenido Aurifero y Argentifero sin Procesar,M0002,t,LLAMPO,2018-12-31,2018-12-31,,MAMC-004227,,,MAMC-004227,,0,5.453000,0.000000,2225.9545204474601137,0,12138.1300000000000000061000,-0.0000000000000000061000,0,"",241101 - Mineral Aurifero sin Procesar,,"",13968,,,,
Ubicaciones virtuales / Produccion,Physical Locations / AMCAQ / Existencias,/ AMCAQ / Existencias,08,Mineral con Contenido Aurifero y Argentifero sin Procesar,M0002,t,LLAMPO,2018-12-31,2018-12-31,,PAMC004233,,,PAMC004233,,5.453000,0,5.453000,2431.3196439996332294,13257.98601873,0,13257.98601873,2431.3196439996332294,"",241101 - Mineral Aurifero sin Procesar,,"",13968,,,,
Partner Locations / Suppliers,Physical Locations / AQP M / Existencias,/ AQP M / Existencias,03,Mineral con Contenido Aurifero y Argentifero sin Procesar,M0001,t,MINERAL AURIFERO Y ARGENTIFERO SIN PROCESAR,2018-12-06,2018-12-06,12/2018,AQP M\IN\04607,01,E001,0002272,COMUNIDAD CAMPESINA CHILLOROYA,4.172000,0,4.172000,298.4300095877277085,1245.05,0,1245.05,298.4300095877277085,602101 - Mineral Aurifero sin Procesar,241101 - Mineral Aurifero sin Procesar,,"",13969,18PO06724,,2018-12-06,
Physical Locations / AQP M / Existencias,Ubicaciones virtuales / Produccion,/ AQP M / Existencias,07,Mineral con Contenido Aurifero y Argentifero sin Procesar,M0001,t,MINERAL AURIFERO Y ARGENTIFERO SIN PROCESAR,2018-12-31,2018-12-31,,MAMC-004227,,,MAMC-004227,,0,4.172000,0.000000,298.4300095877277085,0,1245.0499999999999998620000,0.0000000000000001380000,0,"",241101 - Mineral Aurifero sin Procesar,,"",13969,,,,
Ubicaciones virtuales / Produccion,Physical Locations / AMCAQ / Existencias,/ AMCAQ / Existencias,08,Mineral con Contenido Aurifero y Argentifero sin Procesar,M0001,t,MINERAL AURIFERO Y ARGENTIFERO SIN PROCESAR,2018-12-31,2018-12-31,,PAMC004233,,,PAMC004233,,4.172000,0,4.172000,568.8500675023969319,2373.24248162,0,2373.24248162,568.8500675023969319,"",241101 - Mineral Aurifero sin Procesar,,"",13969,,,,
Partner Locations / Suppliers,Physical Locations / AQP M / Existencias,/ AQP M / Existencias,03,Mineral con Contenido Aurifero y Argentifero sin Procesar,M0002,t,LLAMPO,2018-12-06,2018-12-06,12/2018,AQP M\IN\04535,01,E001,0000902,COMUNIDAD CAMPESINA DE UNTUCA,1.528000,0,1.528000,5519.6989528795811518,8434.1,0,8434.1,5519.6989528795811518,602101 - Mineral Aurifero sin Procesar,241101 - Mineral Aurifero sin Procesar,,"",13970,18PO06554,,2018-12-06,
Physical Locations / AQP M / Existencias,Ubicaciones virtuales / Produccion,/ AQP M / Existencias,07,Mineral con Contenido Aurifero y Argentifero sin Procesar,M0002,t,LLAMPO,2018-12-31,2018-12-31,,MAMC-004227,,,MAMC-004227,,0,1.528000,0.000000,5519.6989528795811518,0,8434.0999999999999999504000,0.0000000000000000496000,0,"",241101 - Mineral Aurifero sin Procesar,,"",13970,,,,
Ubicaciones virtuales / Produccion,Physical Locations / AMCAQ / Existencias,/ AMCAQ / Existencias,08,Mineral con Contenido Aurifero y Argentifero sin Procesar,M0002,t,LLAMPO,2018-12-31,2018-12-31,,PAMC004233,,,PAMC004233,,1.528000,0,1.528000,5725.0644582460732984,8747.8984922,0,8747.8984922,5725.0644582460732984,"",241101 - Mineral Aurifero sin Procesar,,"",13970,,,,
Partner Locations / Suppliers,Physical Locations / AQP M / Existencias,/ AQP M / Existencias,03,Mineral con Contenido Aurifero y Argentifero sin Procesar,M0002,t,LLAMPO,2018-12-06,2018-12-06,12/2018,AQP M\IN\04540,01,0003,0000134,OSWALDO Y LOS MELLIZOS E.I.R.L.,2.090000,0,2.090000,2049.7799043062200957,4284.04,0,4284.04,2049.7799043062200957,602101 - Mineral Aurifero sin Procesar,241101 - Mineral Aurifero sin Procesar,,"",13971,18PO06585,,2018-12-06,
Physical Locations / AQP M / Existencias,Ubicaciones virtuales / Produccion,/ AQP M / Existencias,07,Mineral con Contenido Aurifero y Argentifero sin Procesar,M0002,t,LLAMPO,2018-12-31,2018-12-31,,MAMC-004228,,,MAMC-004228,,0,2.090000,0.000000,2049.7799043062200957,0,4284.0400000000000000130000,-0.0000000000000000130000,0,"",241101 - Mineral Aurifero sin Procesar,,"",13971,,,,
Ubicaciones virtuales / Produccion,Physical Locations / AMCAQ / Existencias,/ AMCAQ / Existencias,08,Mineral con Contenido Aurifero y Argentifero sin Procesar,M0002,t,LLAMPO,2018-12-31,2018-12-31,,PAMC004234,,,PAMC004234,,2.090000,0,2.090000,2255.1443946220095694,4713.25178476,0,4713.25178476,2255.1443946220095694,"",241101 - Mineral Aurifero sin Procesar,,"",13971,,,,
Partner Locations / Suppliers,Physical Locations / AQP M / Existencias,/ AQP M / Existencias,03,Mineral con Contenido Aurifero y Argentifero sin Procesar,M0001,t,MINERAL AURIFERO Y ARGENTIFERO SIN PROCESAR,2018-12-06,2018-12-06,12/2018,AQP M\IN\04608,01,E001,0002269,COMUNIDAD CAMPESINA CHILLOROYA,4.453000,0,4.453000,223.5414327419717045,995.43,0,995.43,223.5414327419717045,602101 - Mineral Aurifero sin Procesar,241101 - Mineral Aurifero sin Procesar,,"",13972,18PO06726,,2018-12-06,
Physical Locations / AQP M / Existencias,Ubicaciones virtuales / Produccion,/ AQP M / Existencias,07,Mineral con Contenido Aurifero y Argentifero sin Procesar,M0001,t,MINERAL AURIFERO Y ARGENTIFERO SIN PROCESAR,2018-12-31,2018-12-31,,MAMC-004228,,,MAMC-004228,,0,4.453000,0.000000,223.5414327419717045,0,995.4300000000000001385000,-0.0000000000000001385000,0,"",241101 - Mineral Aurifero sin Procesar,,"",13972,,,,
Ubicaciones virtuales / Produccion,Physical Locations / AMCAQ / Existencias,/ AMCAQ / Existencias,08,Mineral con Contenido Aurifero y Argentifero sin Procesar,M0001,t,MINERAL AURIFERO Y ARGENTIFERO SIN PROCESAR,2018-12-31,2018-12-31,,PAMC004234,,,PAMC004234,,4.453000,0,4.453000,493.9614390186391197,2199.61028795,0,2199.61028795,493.9614390186391197,"",241101 - Mineral Aurifero sin Procesar,,"",13972,,,,
,,/ AQP M / Existencias,"",Mineral con Contenido Aurifero y Argentifero sin Procesar,"","",MINERAL AURIFERO Y ARGENTIFERO SIN PROCESAR,,2018-12-11,12/2018,,01,0003,0000135,OSWALDO Y LOS MELLIZOS E.I.R.L.,0,0,0,0,230.51,0,230.51,0,609201,241101 - Mineral Aurifero sin Procesar,"",,13973,,,,t
Partner Locations / Suppliers,Physical Locations / AQP M / Existencias,/ AQP M / Existencias,03,Mineral con Contenido Aurifero y Argentifero sin Procesar,M0002,t,LLAMPO,2018-12-06,2018-12-06,12/2018,AQP M\IN\04540,01,0003,0000134,OSWALDO Y LOS MELLIZOS E.I.R.L.,3.669000,0,3.669000,6133.1207413464159171,22502.42,0,22732.93,6195.9471245571000273,602101 - Mineral Aurifero sin Procesar,241101 - Mineral Aurifero sin Procesar,,"",13973,18PO06585,,2018-12-06,
Physical Locations / AQP M / Existencias,Ubicaciones virtuales / Produccion,/ AQP M / Existencias,07,Mineral con Contenido Aurifero y Argentifero sin Procesar,M0002,t,LLAMPO,2018-12-31,2018-12-31,,MAMC-004228,,,MAMC-004228,,0,3.669000,0.000000,6195.9471245571000273,0,22732.9300000000000001637000,-0.0000000000000001637000,0,"",241101 - Mineral Aurifero sin Procesar,,"",13973,,,,
Ubicaciones virtuales / Produccion,Physical Locations / AMCAQ / Existencias,/ AMCAQ / Existencias,08,Mineral con Contenido Aurifero y Argentifero sin Procesar,M0002,t,LLAMPO,2018-12-31,2018-12-31,,PAMC004234,,,PAMC004234,,3.669000,0,3.669000,6401.3117427691469065,23486.41278422,0,23486.41278422,6401.3117427691469065,"",241101 - Mineral Aurifero sin Procesar,,"",13973,,,,
Partner Locations / Suppliers,Physical Locations / AQP M / Existencias,/ AQP M / Existencias,03,Mineral con Contenido Aurifero y Argentifero sin Procesar,M0001,t,MINERAL AURIFERO Y ARGENTIFERO SIN PROCESAR,2018-12-06,2018-12-06,12/2018,AQP M\IN\04608,01,E001,0002269,COMUNIDAD CAMPESINA CHILLOROYA,4.331000,0,4.331000,343.3687370122373586,1487.13,0,1487.13,343.3687370122373586,602101 - Mineral Aurifero sin Procesar,241101 - Mineral Aurifero sin Procesar,,"",13974,18PO06726,,2018-12-06,
Physical Locations / AQP M / Existencias,Ubicaciones virtuales / Produccion,/ AQP M / Existencias,07,Mineral con Contenido Aurifero y Argentifero sin Procesar,M0001,t,MINERAL AURIFERO Y ARGENTIFERO SIN PROCESAR,2018-12-31,2018-12-31,,MAMC-004228,,,MAMC-004228,,0,4.331000,0.000000,343.3687370122373586,0,1487.1300000000000000966000,-0.0000000000000000966000,0,"",241101 - Mineral Aurifero sin Procesar,,"",13974,,,,
Ubicaciones virtuales / Produccion,Physical Locations / AMCAQ / Existencias,/ AMCAQ / Existencias,08,Mineral con Contenido Aurifero y Argentifero sin Procesar,M0001,t,MINERAL AURIFERO Y ARGENTIFERO SIN PROCESAR,2018-12-31,2018-12-31,,PAMC004234,,,PAMC004234,,4.331000,0,4.331000,613.7886296074809513,2658.31855483,0,2658.31855483,613.7886296074809513,"",241101 - Mineral Aurifero sin Procesar,,"",13974,,,,
Partner Locations / Suppliers,Physical Locations / AQP M / Existencias,/ AQP M / Existencias,03,Mineral con Contenido Aurifero y Argentifero sin Procesar,M0002,t,LLAMPO,2018-12-06,2018-12-06,12/2018,AQP M\IN\04540,01,0003,0000134,OSWALDO Y LOS MELLIZOS E.I.R.L.,11.619000,0,11.619000,363.4564076082279026,4223,0,4223,363.4564076082279026,602101 - Mineral Aurifero sin Procesar,241101 - Mineral Aurifero sin Procesar,,"",13975,18PO06585,,2018-12-06,
Physical Locations / AQP M / Existencias,Ubicaciones virtuales / Produccion,/ AQP M / Existencias,07,Mineral con Contenido Aurifero y Argentifero sin Procesar,M0002,t,LLAMPO,2018-12-31,2018-12-31,,MAMC-004228,,,MAMC-004228,,0,11.619000,0.000000,363.4564076082279026,0,4223.0000000000000003094000,-0.0000000000000003094000,0,"",241101 - Mineral Aurifero sin Procesar,,"",13975,,,,
Ubicaciones virtuales / Produccion,Physical Locations / AMCAQ / Existencias,/ AMCAQ / Existencias,08,Mineral con Contenido Aurifero y Argentifero sin Procesar,M0002,t,LLAMPO,2018-12-31,2018-12-31,,PAMC004234,,,PAMC004234,,11.619000,0,11.619000,568.8212038333763663,6609.13356734,0,6609.13356734,568.8212038333763663,"",241101 - Mineral Aurifero sin Procesar,,"",13975,,,,
Partner Locations / Suppliers,Physical Locations / AQP M / Existencias,/ AQP M / Existencias,03,Mineral con Contenido Aurifero y Argentifero sin Procesar,M0001,t,MINERAL AURIFERO Y ARGENTIFERO SIN PROCESAR,2018-12-06,2018-12-06,12/2018,AQP M\IN\04608,01,E001,0002269,COMUNIDAD CAMPESINA CHILLOROYA,4.230000,0,4.230000,133.6737588652482270,565.44,0,565.44,133.6737588652482270,602101 - Mineral Aurifero sin Procesar,241101 - Mineral Aurifero sin Procesar,,"",13976,18PO06726,,2018-12-06,
Physical Locations / AQP M / Existencias,Ubicaciones virtuales / Produccion,/ AQP M / Existencias,07,Mineral con Contenido Aurifero y Argentifero sin Procesar,M0001,t,MINERAL AURIFERO Y ARGENTIFERO SIN PROCESAR,2018-12-31,2018-12-31,,MAMC-004228,,,MAMC-004228,,0,4.230000,0.000000,133.6737588652482270,0,565.4400000000000002100000,-0.0000000000000002100000,0,"",241101 - Mineral Aurifero sin Procesar,,"",13976,,,,
Ubicaciones virtuales / Produccion,Physical Locations / AMCAQ / Existencias,/ AMCAQ / Existencias,08,Mineral con Contenido Aurifero y Argentifero sin Procesar,M0001,t,MINERAL AURIFERO Y ARGENTIFERO SIN PROCESAR,2018-12-31,2018-12-31,,PAMC004234,,,PAMC004234,,4.230000,0,4.230000,404.0940485886524823,1709.31782553,0,1709.31782553,404.0940485886524823,"",241101 - Mineral Aurifero sin Procesar,,"",13976,,,,
Partner Locations / Suppliers,Physical Locations / AQP M / Existencias,/ AQP M / Existencias,03,Mineral con Contenido Aurifero y Argentifero sin Procesar,M0001,t,MINERAL AURIFERO Y ARGENTIFERO SIN PROCESAR,2018-12-06,2018-12-06,12/2018,AQP M\IN\04608,01,E001,0002269,COMUNIDAD CAMPESINA CHILLOROYA,4.370000,0,4.370000,178.6086956521739130,780.52,0,780.52,178.6086956521739130,602101 - Mineral Aurifero sin Procesar,241101 - Mineral Aurifero sin Procesar,,"",13977,18PO06726,,2018-12-06,
Physical Locations / AQP M / Existencias,Ubicaciones virtuales / Produccion,/ AQP M / Existencias,07,Mineral con Contenido Aurifero y Argentifero sin Procesar,M0001,t,MINERAL AURIFERO Y ARGENTIFERO SIN PROCESAR,2018-12-31,2018-12-31,,MAMC-004228,,,MAMC-004228,,0,4.370000,0.000000,178.6086956521739130,0,780.5199999999999998100000,0.0000000000000001900000,0,"",241101 - Mineral Aurifero sin Procesar,,"",13977,,,,
Ubicaciones virtuales / Produccion,Physical Locations / AMCAQ / Existencias,/ AMCAQ / Existencias,08,Mineral con Contenido Aurifero y Argentifero sin Procesar,M0001,t,MINERAL AURIFERO Y ARGENTIFERO SIN PROCESAR,2018-12-31,2018-12-31,,PAMC004234,,,PAMC004234,,4.370000,0,4.370000,449.0288293501144165,1962.25598426,0,1962.25598426,449.0288293501144165,"",241101 - Mineral Aurifero sin Procesar,,"",13977,,,,
Partner Locations / Suppliers,Physical Locations / AQP M / Existencias,/ AQP M / Existencias,03,Mineral con Contenido Aurifero y Argentifero sin Procesar,M0001,t,MINERAL AURIFERO Y ARGENTIFERO SIN PROCESAR,2018-12-06,2018-12-06,12/2018,AQP M\IN\04577,01,0001,0000037,JUSTINA HUACHACA PEREZ,3.492000,0,3.492000,9838.6053837342497136,34356.41,0,34356.41,9838.6053837342497136,602101 - Mineral Aurifero sin Procesar,241101 - Mineral Aurifero sin Procesar,,"",13978,18PO06623,,2018-12-06,
Physical Locations / AQP M / Existencias,Ubicaciones virtuales / Produccion,/ AQP M / Existencias,07,Mineral con Contenido Aurifero y Argentifero sin Procesar,M0001,t,MINERAL AURIFERO Y ARGENTIFERO SIN PROCESAR,2018-12-31,2018-12-31,,MAMC-004228,,,MAMC-004228,,0,3.492000,0.000000,9838.6053837342497136,0,34356.4099999999999998912000,0.0000000000000001088000,0,"",241101 - Mineral Aurifero sin Procesar,,"",13978,,,,
Ubicaciones virtuales / Produccion,Physical Locations / AMCAQ / Existencias,/ AMCAQ / Existencias,08,Mineral con Contenido Aurifero y Argentifero sin Procesar,M0001,t,MINERAL AURIFERO Y ARGENTIFERO SIN PROCESAR,2018-12-31,2018-12-31,,PAMC004234,,,PAMC004234,,3.492000,0,3.492000,10109.0253825171821306,35300.71663575,0,35300.71663575,10109.0253825171821306,"",241101 - Mineral Aurifero sin Procesar,,"",13978,,,,
Partner Locations / Suppliers,Physical Locations / AQP M / Existencias,/ AQP M / Existencias,03,Mineral con Contenido Aurifero y Argentifero sin Procesar,M0002,t,LLAMPO,2018-12-06,2018-12-06,12/2018,AQP M\IN\04540,01,0003,0000134,OSWALDO Y LOS MELLIZOS E.I.R.L.,8.213000,0,8.213000,1093.3300864483136491,8979.52,0,8979.52,1093.3300864483136491,602101 - Mineral Aurifero sin Procesar,241101 - Mineral Aurifero sin Procesar,,"",13979,18PO06585,,2018-12-06,
Physical Locations / AQP M / Existencias,Ubicaciones virtuales / Produccion,/ AQP M / Existencias,07,Mineral con Contenido Aurifero y Argentifero sin Procesar,M0002,t,LLAMPO,2018-12-31,2018-12-31,,MAMC-004228,,,MAMC-004228,,0,8.213000,0.000000,1093.3300864483136491,0,8979.5200000000000000583000,-0.0000000000000000583000,0,"",241101 - Mineral Aurifero sin Procesar,,"",13979,,,,
Ubicaciones virtuales / Produccion,Physical Locations / AMCAQ / Existencias,/ AMCAQ / Existencias,08,Mineral con Contenido Aurifero y Argentifero sin Procesar,M0002,t,LLAMPO,2018-12-31,2018-12-31,,PAMC004234,,,PAMC004234,,8.213000,0,8.213000,1298.6951517204431998,10666.18328108,0,10666.18328108,1298.6951517204431998,"",241101 - Mineral Aurifero sin Procesar,,"",13979,,,,
Partner Locations / Suppliers,Physical Locations / AQP M / Existencias,/ AQP M / Existencias,03,Mineral con Contenido Aurifero y Argentifero sin Procesar,M0001,t,MINERAL AURIFERO Y ARGENTIFERO SIN PROCESAR,2018-12-06,2018-12-06,12/2018,AQP M\IN\04600,01,0001,0000264,E&F INVERSIONES MINERAS E.I.R.L.,1.640000,0,1.640000,10723.3658536585365854,17586.32,0,17586.32,10723.3658536585365854,602101 - Mineral Aurifero sin Procesar,241101 - Mineral Aurifero sin Procesar,,"",13980,18PO06707,,2018-12-06,
Physical Locations / AQP M / Existencias,Ubicaciones virtuales / Produccion,/ AQP M / Existencias,07,Mineral con Contenido Aurifero y Argentifero sin Procesar,M0001,t,MINERAL AURIFERO Y ARGENTIFERO SIN PROCESAR,2018-12-31,2018-12-31,,MAMC-004228,,,MAMC-004228,,0,1.640000,0.000000,10723.3658536585365854,0,17586.3200000000000000560000,-0.0000000000000000560000,0,"",241101 - Mineral Aurifero sin Procesar,,"",13980,,,,
Ubicaciones virtuales / Produccion,Physical Locations / AMCAQ / Existencias,/ AMCAQ / Existencias,08,Mineral con Contenido Aurifero y Argentifero sin Procesar,M0001,t,MINERAL AURIFERO Y ARGENTIFERO SIN PROCESAR,2018-12-31,2018-12-31,,PAMC004234,,,PAMC004234,,1.640000,0,1.640000,10993.7853260853658537,18029.80793478,0,18029.80793478,10993.7853260853658537,"",241101 - Mineral Aurifero sin Procesar,,"",13980,,,,
Partner Locations / Suppliers,Physical Locations / AQP M / Existencias,/ AQP M / Existencias,03,Mineral con Contenido Aurifero y Argentifero sin Procesar,M0001,t,MINERAL AURIFERO Y ARGENTIFERO SIN PROCESAR,2018-12-06,2018-12-06,12/2018,AQP M\IN\04601,01,E001,0002283,COMUNIDAD CAMPESINA CHILLOROYA,3.622000,0,3.622000,152.5455549420209829,552.52,0,552.52,152.5455549420209829,602101 - Mineral Aurifero sin Procesar,241101 - Mineral Aurifero sin Procesar,,"",13981,18PO06712,,2018-12-06,
Physical Locations / AQP M / Existencias,Ubicaciones virtuales / Produccion,/ AQP M / Existencias,07,Mineral con Contenido Aurifero y Argentifero sin Procesar,M0001,t,MINERAL AURIFERO Y ARGENTIFERO SIN PROCESAR,2018-12-31,2018-12-31,,MAMC-004229,,,MAMC-004229,,0,3.622000,0.000000,152.5455549420209829,0,552.5200000000000000638000,-0.0000000000000000638000,0,"",241101 - Mineral Aurifero sin Procesar,,"",13981,,,,
Ubicaciones virtuales / Produccion,Physical Locations / AMCAQ / Existencias,/ AMCAQ / Existencias,08,Mineral con Contenido Aurifero y Argentifero sin Procesar,M0001,t,MINERAL AURIFERO Y ARGENTIFERO SIN PROCESAR,2018-12-31,2018-12-31,,PAMC004235,,,PAMC004235,,3.622000,0,3.622000,422.9658635560463832,1531.9823578,0,1531.9823578,422.9658635560463832,"",241101 - Mineral Aurifero sin Procesar,,"",13981,,,,
Partner Locations / Suppliers,Physical Locations / AQP M / Existencias,/ AQP M / Existencias,03,Mineral con Contenido Aurifero y Argentifero sin Procesar,M0001,t,MINERAL AURIFERO Y ARGENTIFERO SIN PROCESAR,2018-12-06,2018-12-06,12/2018,AQP M\IN\04601,01,E001,0002283,COMUNIDAD CAMPESINA CHILLOROYA,4.295000,0,4.295000,298.3282887077997672,1281.32,0,1281.32,298.3282887077997672,602101 - Mineral Aurifero sin Procesar,241101 - Mineral Aurifero sin Procesar,,"",13982,18PO06712,,2018-12-06,
Physical Locations / AQP M / Existencias,Ubicaciones virtuales / Produccion,/ AQP M / Existencias,07,Mineral con Contenido Aurifero y Argentifero sin Procesar,M0001,t,MINERAL AURIFERO Y ARGENTIFERO SIN PROCESAR,2018-12-31,2018-12-31,,MAMC-004229,,,MAMC-004229,,0,4.295000,0.000000,298.3282887077997672,0,1281.3200000000000001240000,-0.0000000000000001240000,0,"",241101 - Mineral Aurifero sin Procesar,,"",13982,,,,
Ubicaciones virtuales / Produccion,Physical Locations / AMCAQ / Existencias,/ AMCAQ / Existencias,08,Mineral con Contenido Aurifero y Argentifero sin Procesar,M0001,t,MINERAL AURIFERO Y ARGENTIFERO SIN PROCESAR,2018-12-31,2018-12-31,,PAMC004235,,,PAMC004235,,4.295000,0,4.295000,568.7481643236321304,2442.77336577,0,2442.77336577,568.7481643236321304,"",241101 - Mineral Aurifero sin Procesar,,"",13982,,,,
Partner Locations / Suppliers,Physical Locations / AQP M / Existencias,/ AQP M / Existencias,03,Mineral con Contenido Aurifero y Argentifero sin Procesar,M0001,t,MINERAL AURIFERO Y ARGENTIFERO SIN PROCESAR,2018-12-06,2018-12-06,12/2018,AQP M\IN\04601,01,E001,0002283,COMUNIDAD CAMPESINA CHILLOROYA,4.510000,0,4.510000,178.6075388026607539,805.52,0,805.52,178.6075388026607539,602101 - Mineral Aurifero sin Procesar,241101 - Mineral Aurifero sin Procesar,,"",13983,18PO06712,,2018-12-06,
Physical Locations / AQP M / Existencias,Ubicaciones virtuales / Produccion,/ AQP M / Existencias,07,Mineral con Contenido Aurifero y Argentifero sin Procesar,M0001,t,MINERAL AURIFERO Y ARGENTIFERO SIN PROCESAR,2018-12-31,2018-12-31,,MAMC-004229,,,MAMC-004229,,0,4.510000,0.000000,178.6075388026607539,0,805.5200000000000000890000,-0.0000000000000000890000,0,"",241101 - Mineral Aurifero sin Procesar,,"",13983,,,,
Ubicaciones virtuales / Produccion,Physical Locations / AMCAQ / Existencias,/ AMCAQ / Existencias,08,Mineral con Contenido Aurifero y Argentifero sin Procesar,M0001,t,MINERAL AURIFERO Y ARGENTIFERO SIN PROCESAR,2018-12-31,2018-12-31,,PAMC004235,,,PAMC004235,,4.510000,0,4.510000,449.0275179135254989,2025.11410579,0,2025.11410579,449.0275179135254989,"",241101 - Mineral Aurifero sin Procesar,,"",13983,,,,
Partner Locations / Suppliers,Physical Locations / AQP M / Existencias,/ AQP M / Existencias,03,Mineral con Contenido Aurifero y Argentifero sin Procesar,M0001,t,MINERAL AURIFERO Y ARGENTIFERO SIN PROCESAR,2018-12-06,2018-12-06,12/2018,AQP M\IN\04601,01,E001,0002283,COMUNIDAD CAMPESINA CHILLOROYA,4.619000,0,4.619000,249.9112361983113228,1154.34,0,1154.34,249.9112361983113228,602101 - Mineral Aurifero sin Procesar,241101 - Mineral Aurifero sin Procesar,,"",13984,18PO06712,,2018-12-06,
Physical Locations / AQP M / Existencias,Ubicaciones virtuales / Produccion,/ AQP M / Existencias,07,Mineral con Contenido Aurifero y Argentifero sin Procesar,M0001,t,MINERAL AURIFERO Y ARGENTIFERO SIN PROCESAR,2018-12-31,2018-12-31,,MAMC-004229,,,MAMC-004229,,0,4.619000,0.000000,249.9112361983113228,0,1154.3400000000000000132000,-0.0000000000000000132000,0,"",241101 - Mineral Aurifero sin Procesar,,"",13984,,,,
Ubicaciones virtuales / Produccion,Physical Locations / AMCAQ / Existencias,/ AMCAQ / Existencias,08,Mineral con Contenido Aurifero y Argentifero sin Procesar,M0001,t,MINERAL AURIFERO Y ARGENTIFERO SIN PROCESAR,2018-12-31,2018-12-31,,PAMC004235,,,PAMC004235,,4.619000,0,4.619000,520.3312389976185321,2403.40999293,0,2403.40999293,520.3312389976185321,"",241101 - Mineral Aurifero sin Procesar,,"",13984,,,,
Partner Locations / Suppliers,Physical Locations / AQP M / Existencias,/ AQP M / Existencias,03,Mineral con Contenido Aurifero y Argentifero sin Procesar,M0001,t,MINERAL AURIFERO Y ARGENTIFERO SIN PROCESAR,2018-12-06,2018-12-06,12/2018,AQP M\IN\04602,01,E001,0002297,COMUNIDAD CAMPESINA CHILLOROYA,4.764000,0,4.764000,268.8539042821158690,1280.82,0,1280.82,268.8539042821158690,602101 - Mineral Aurifero sin Procesar,241101 - Mineral Aurifero sin Procesar,,"",13985,18PO06715,,2018-12-06,
Physical Locations / AQP M / Existencias,Ubicaciones virtuales / Produccion,/ AQP M / Existencias,07,Mineral con Contenido Aurifero y Argentifero sin Procesar,M0001,t,MINERAL AURIFERO Y ARGENTIFERO SIN PROCESAR,2018-12-31,2018-12-31,,MAMC-004229,,,MAMC-004229,,0,4.764000,0.000000,268.8539042821158690,0,1280.8199999999999999160000,0.0000000000000000840000,0,"",241101 - Mineral Aurifero sin Procesar,,"",13985,,,,
Ubicaciones virtuales / Produccion,Physical Locations / AMCAQ / Existencias,/ AMCAQ / Existencias,08,Mineral con Contenido Aurifero y Argentifero sin Procesar,M0001,t,MINERAL AURIFERO Y ARGENTIFERO SIN PROCESAR,2018-12-31,2018-12-31,,PAMC004235,,,PAMC004235,,4.764000,0,4.764000,539.2739439819479429,2569.10106913,0,2569.10106913,539.2739439819479429,"",241101 - Mineral Aurifero sin Procesar,,"",13985,,,,
Partner Locations / Suppliers,Physical Locations / AQP M / Existencias,/ AQP M / Existencias,03,Mineral con Contenido Aurifero y Argentifero sin Procesar,M0001,t,MINERAL AURIFERO Y ARGENTIFERO SIN PROCESAR,2018-12-06,2018-12-06,12/2018,AQP M\IN\04602,01,E001,0002297,COMUNIDAD CAMPESINA CHILLOROYA,5.382000,0,5.382000,92.5845410628019324,498.29,0,498.29,92.5845410628019324,602101 - Mineral Aurifero sin Procesar,241101 - Mineral Aurifero sin Procesar,,"",13986,18PO06715,,2018-12-06,
Physical Locations / AQP M / Existencias,Ubicaciones virtuales / Produccion,/ AQP M / Existencias,07,Mineral con Contenido Aurifero y Argentifero sin Procesar,M0001,t,MINERAL AURIFERO Y ARGENTIFERO SIN PROCESAR,2018-12-31,2018-12-31,,MAMC-004229,,,MAMC-004229,,0,5.382000,0.000000,92.5845410628019324,0,498.2900000000000001768000,-0.0000000000000001768000,0,"",241101 - Mineral Aurifero sin Procesar,,"",13986,,,,
Ubicaciones virtuales / Produccion,Physical Locations / AMCAQ / Existencias,/ AMCAQ / Existencias,08,Mineral con Contenido Aurifero y Argentifero sin Procesar,M0001,t,MINERAL AURIFERO Y ARGENTIFERO SIN PROCESAR,2018-12-31,2018-12-31,,PAMC004235,,,PAMC004235,,5.382000,0,5.382000,363.0051310144927536,1953.69361512,0,1953.69361512,363.0051310144927536,"",241101 - Mineral Aurifero sin Procesar,,"",13986,,,,
Partner Locations / Suppliers,Physical Locations / AQP M / Existencias,/ AQP M / Existencias,03,Mineral con Contenido Aurifero y Argentifero sin Procesar,M0001,t,MINERAL AURIFERO Y ARGENTIFERO SIN PROCESAR,2018-12-06,2018-12-06,12/2018,AQP M\IN\04593,01,E001,0002266,COMUNIDAD CAMPESINA CHILLOROYA,3.819000,0,3.819000,762.5530243519245876,2912.19,0,2912.19,762.5530243519245876,602101 - Mineral Aurifero sin Procesar,241101 - Mineral Aurifero sin Procesar,,"",13987,18PO06678,,2018-12-06,
Physical Locations / AQP M / Existencias,Ubicaciones virtuales / Produccion,/ AQP M / Existencias,07,Mineral con Contenido Aurifero y Argentifero sin Procesar,M0001,t,MINERAL AURIFERO Y ARGENTIFERO SIN PROCESAR,2018-12-31,2018-12-31,,MAMC-004229,,,MAMC-004229,,0,3.819000,0.000000,762.5530243519245876,0,2912.1900000000000000444000,-0.0000000000000000444000,0,"",241101 - Mineral Aurifero sin Procesar,,"",13987,,,,
Ubicaciones virtuales / Produccion,Physical Locations / AMCAQ / Existencias,/ AMCAQ / Existencias,08,Mineral con Contenido Aurifero y Argentifero sin Procesar,M0001,t,MINERAL AURIFERO Y ARGENTIFERO SIN PROCESAR,2018-12-31,2018-12-31,,PAMC004235,,,PAMC004235,,3.819000,0,3.819000,1032.9734232207384132,3944.92550328,0,3944.92550328,1032.9734232207384132,"",241101 - Mineral Aurifero sin Procesar,,"",13987,,,,
Partner Locations / Suppliers,Physical Locations / AQP M / Existencias,/ AQP M / Existencias,03,Mineral con Contenido Aurifero y Argentifero sin Procesar,M0001,t,MINERAL AURIFERO Y ARGENTIFERO SIN PROCESAR,2018-12-06,2018-12-06,12/2018,AQP M\IN\04593,01,E001,0002266,COMUNIDAD CAMPESINA CHILLOROYA,3.578000,0,3.578000,635.5449972051425377,2273.98,0,2273.98,635.5449972051425377,602101 - Mineral Aurifero sin Procesar,241101 - Mineral Aurifero sin Procesar,,"",13988,18PO06678,,2018-12-06,
Physical Locations / AQP M / Existencias,Ubicaciones virtuales / Produccion,/ AQP M / Existencias,07,Mineral con Contenido Aurifero y Argentifero sin Procesar,M0001,t,MINERAL AURIFERO Y ARGENTIFERO SIN PROCESAR,2018-12-31,2018-12-31,,MAMC-004229,,,MAMC-004229,,0,3.578000,0.000000,635.5449972051425377,0,2273.9799999999999998906000,0.0000000000000001094000,0,"",241101 - Mineral Aurifero sin Procesar,,"",13988,,,,
Ubicaciones virtuales / Produccion,Physical Locations / AMCAQ / Existencias,/ AMCAQ / Existencias,08,Mineral con Contenido Aurifero y Argentifero sin Procesar,M0001,t,MINERAL AURIFERO Y ARGENTIFERO SIN PROCESAR,2018-12-31,2018-12-31,,PAMC004235,,,PAMC004235,,3.578000,0,3.578000,905.9647878423700391,3241.5420109,0,3241.5420109,905.9647878423700391,"",241101 - Mineral Aurifero sin Procesar,,"",13988,,,,
Partner Locations / Suppliers,Physical Locations / AQP M / Existencias,/ AQP M / Existencias,03,Mineral con Contenido Aurifero y Argentifero sin Procesar,M0001,t,MINERAL AURIFERO Y ARGENTIFERO SIN PROCESAR,2018-12-06,2018-12-06,12/2018,AQP M\IN\04593,01,E001,0002266,COMUNIDAD CAMPESINA CHILLOROYA,3.937000,0,3.937000,1639.3014986029972060,6453.93,0,6453.93,1639.3014986029972060,602101 - Mineral Aurifero sin Procesar,241101 - Mineral Aurifero sin Procesar,,"",13989,18PO06678,,2018-12-06,
Physical Locations / AQP M / Existencias,Ubicaciones virtuales / Produccion,/ AQP M / Existencias,07,Mineral con Contenido Aurifero y Argentifero sin Procesar,M0001,t,MINERAL AURIFERO Y ARGENTIFERO SIN PROCESAR,2018-12-31,2018-12-31,,MAMC-004229,,,MAMC-004229,,0,3.937000,0.000000,1639.3014986029972060,0,6453.9300000000000000220000,-0.0000000000000000220000,0,"",241101 - Mineral Aurifero sin Procesar,,"",13989,,,,
Ubicaciones virtuales / Produccion,Physical Locations / AMCAQ / Existencias,/ AMCAQ / Existencias,08,Mineral con Contenido Aurifero y Argentifero sin Procesar,M0001,t,MINERAL AURIFERO Y ARGENTIFERO SIN PROCESAR,2018-12-31,2018-12-31,,PAMC004235,,,PAMC004235,,3.937000,0,3.937000,1909.7214808153416307,7518.57346997,0,7518.57346997,1909.7214808153416307,"",241101 - Mineral Aurifero sin Procesar,,"",13989,,,,
Partner Locations / Suppliers,Physical Locations / AQP M / Existencias,/ AQP M / Existencias,03,Mineral con Contenido Aurifero y Argentifero sin Procesar,M0001,t,MINERAL AURIFERO Y ARGENTIFERO SIN PROCESAR,2018-12-06,2018-12-06,12/2018,AQP M\IN\04593,01,E001,0002266,COMUNIDAD CAMPESINA CHILLOROYA,3.770000,0,3.770000,231.0079575596816976,870.9,0,870.9,231.0079575596816976,602101 - Mineral Aurifero sin Procesar,241101 - Mineral Aurifero sin Procesar,,"",13990,18PO06678,,2018-12-06,
Physical Locations / AQP M / Existencias,Ubicaciones virtuales / Produccion,/ AQP M / Existencias,07,Mineral con Contenido Aurifero y Argentifero sin Procesar,M0001,t,MINERAL AURIFERO Y ARGENTIFERO SIN PROCESAR,2018-12-31,2018-12-31,,MAMC-004229,,,MAMC-004229,,0,3.770000,0.000000,231.0079575596816976,0,870.8999999999999999520000,0.0000000000000000480000,0,"",241101 - Mineral Aurifero sin Procesar,,"",13990,,,,
Ubicaciones virtuales / Produccion,Physical Locations / AMCAQ / Existencias,/ AMCAQ / Existencias,08,Mineral con Contenido Aurifero y Argentifero sin Procesar,M0001,t,MINERAL AURIFERO Y ARGENTIFERO SIN PROCESAR,2018-12-31,2018-12-31,,PAMC004235,,,PAMC004235,,3.770000,0,3.770000,501.4285608381962865,1890.38567436,0,1890.38567436,501.4285608381962865,"",241101 - Mineral Aurifero sin Procesar,,"",13990,,,,
Partner Locations / Suppliers,Physical Locations / AQP M / Existencias,/ AQP M / Existencias,03,Mineral con Contenido Aurifero y Argentifero sin Procesar,M0001,t,MINERAL AURIFERO Y ARGENTIFERO SIN PROCESAR,2018-12-06,2018-12-06,12/2018,AQP M\IN\04593,01,E001,0002266,COMUNIDAD CAMPESINA CHILLOROYA,3.403000,0,3.403000,395.7684396121069644,1346.8,0,1346.8,395.7684396121069644,602101 - Mineral Aurifero sin Procesar,241101 - Mineral Aurifero sin Procesar,,"",13991,18PO06678,,2018-12-06,
Physical Locations / AQP M / Existencias,Ubicaciones virtuales / Produccion,/ AQP M / Existencias,07,Mineral con Contenido Aurifero y Argentifero sin Procesar,M0001,t,MINERAL AURIFERO Y ARGENTIFERO SIN PROCESAR,2018-12-31,2018-12-31,,MAMC-004230,,,MAMC-004230,,0,3.403000,0.000000,395.7684396121069644,0,1346.7999999999999998532000,0.0000000000000001468000,0,"",241101 - Mineral Aurifero sin Procesar,,"",13991,,,,
Ubicaciones virtuales / Produccion,Physical Locations / AMCAQ / Existencias,/ AMCAQ / Existencias,08,Mineral con Contenido Aurifero y Argentifero sin Procesar,M0001,t,MINERAL AURIFERO Y ARGENTIFERO SIN PROCESAR,2018-12-31,2018-12-31,,PAMC004236,,,PAMC004236,,3.403000,0,3.403000,666.1887235850719953,2267.04022636,0,2267.04022636,666.1887235850719953,"",241101 - Mineral Aurifero sin Procesar,,"",13991,,,,
Partner Locations / Suppliers,Physical Locations / AQP M / Existencias,/ AQP M / Existencias,03,Mineral con Contenido Aurifero y Argentifero sin Procesar,M0001,t,MINERAL AURIFERO Y ARGENTIFERO SIN PROCESAR,2018-12-06,2018-12-06,12/2018,AQP M\IN\04578,01,0001,0000038,JUSTINA HUACHACA PEREZ,3.502000,0,3.502000,9838.7721302113078241,34455.38,0,34455.38,9838.7721302113078241,602101 - Mineral Aurifero sin Procesar,241101 - Mineral Aurifero sin Procesar,,"",13992,18PO06624,,2018-12-06,
Physical Locations / AQP M / Existencias,Ubicaciones virtuales / Produccion,/ AQP M / Existencias,07,Mineral con Contenido Aurifero y Argentifero sin Procesar,M0001,t,MINERAL AURIFERO Y ARGENTIFERO SIN PROCESAR,2018-12-31,2018-12-31,,MAMC-004230,,,MAMC-004230,,0,3.502000,0.000000,9838.7721302113078241,0,34455.3799999999999999982000,0.0000000000000000018000,0,"",241101 - Mineral Aurifero sin Procesar,,"",13992,,,,
Ubicaciones virtuales / Produccion,Physical Locations / AMCAQ / Existencias,/ AMCAQ / Existencias,08,Mineral con Contenido Aurifero y Argentifero sin Procesar,M0001,t,MINERAL AURIFERO Y ARGENTIFERO SIN PROCESAR,2018-12-31,2018-12-31,,PAMC004236,,,PAMC004236,,3.502000,0,3.502000,10109.1929508880639634,35402.39371401,0,35402.39371401,10109.1929508880639634,"",241101 - Mineral Aurifero sin Procesar,,"",13992,,,,
Ubicaciones virtuales / Transformacion Lote Trujillo,Physical Locations / AMCAQ / Existencias,/ AMCAQ / Existencias,06,Mineral con Contenido Aurifero y Argentifero sin Procesar,M0001,t,MINERAL AURIFERO Y ARGENTIFERO SIN PROCESAR,2018-12-07,2018-12-07,,ILT-000348,,,ILT-000348,NEGOCIOS ARGOS E.I.R.L.,3.215000,0,3.215000,5659.8436697853810264,18196.39739836,0,18196.39739836,5659.8436697853810264,"",241101 - Mineral Aurifero sin Procesar,,"",13993,,,2018-12-07,
Physical Locations / AMCTJ / Existencias,Ubicaciones virtuales / Transformacion Lote Trujillo,/ AMCTJ / Existencias,06,Mineral con Contenido Aurifero y Argentifero sin Procesar,M0001,t,MINERAL AURIFERO Y ARGENTIFERO SIN PROCESAR,2018-12-07,2018-12-07,,CLT-000333,,,CLT-000333,NEGOCIOS ARGOS E.I.R.L.,0,3.215000,-3.215000,0,0,0.000000,0.000000,0,"",241101 - Mineral Aurifero sin Procesar,0000 LOTES TRUJILLO,"",13993,,,2018-12-07,
Ubicaciones virtuales / Transformacion Lote Trujillo,Physical Locations / AMCAQ / Existencias,/ AMCAQ / Existencias,06,Mineral con Contenido Aurifero y Argentifero sin Procesar,M0001,t,MINERAL AURIFERO Y ARGENTIFERO SIN PROCESAR,2018-12-07,2018-12-07,,ILT-000337,,,ILT-000337,RAUL CELIN CASTILLO JARA,0.439000,0,0.439000,5118.0788926195899772,2246.83663386,0,2246.83663386,5118.0788926195899772,"",241101 - Mineral Aurifero sin Procesar,,"",13994,,,2018-12-07,
Physical Locations / AMCTJ / Existencias,Ubicaciones virtuales / Transformacion Lote Trujillo,/ AMCTJ / Existencias,06,Mineral con Contenido Aurifero y Argentifero sin Procesar,M0001,t,MINERAL AURIFERO Y ARGENTIFERO SIN PROCESAR,2018-12-07,2018-12-07,,CLT-000323,,,CLT-000323,RAUL CELIN CASTILLO JARA,0,0.439000,-0.439000,0,0,0.000000,0.000000,0,"",241101 - Mineral Aurifero sin Procesar,0000 LOTES TRUJILLO,"",13994,,,2018-12-07,
Ubicaciones virtuales / Transformacion Lote Trujillo,Physical Locations / AMCAQ / Existencias,/ AMCAQ / Existencias,06,Mineral con Contenido Aurifero y Argentifero sin Procesar,M0001,t,MINERAL AURIFERO Y ARGENTIFERO SIN PROCESAR,2018-12-07,2018-12-07,,ILT-000343,,,ILT-000343,NEGOCIOS ARGOS E.I.R.L.,31.431000,0,31.431000,4698.1673228236454456,147668.09712367,0,147668.09712367,4698.1673228236454456,"",241101 - Mineral Aurifero sin Procesar,,"",13995,,,2018-12-07,
Physical Locations / AMCTJ / Existencias,Ubicaciones virtuales / Transformacion Lote Trujillo,/ AMCTJ / Existencias,06,Mineral con Contenido Aurifero y Argentifero sin Procesar,M0001,t,MINERAL AURIFERO Y ARGENTIFERO SIN PROCESAR,2018-12-07,2018-12-07,,CLT-000328,,,CLT-000328,NEGOCIOS ARGOS E.I.R.L.,0,31.431000,-31.431000,0,0,0.000000,0.000000,0,"",241101 - Mineral Aurifero sin Procesar,0000 LOTES TRUJILLO,"",13995,,,2018-12-07,
Ubicaciones virtuales / Transformacion Lote Trujillo,Physical Locations / AMCAQ / Existencias,/ AMCAQ / Existencias,06,Mineral con Contenido Aurifero y Argentifero sin Procesar,M0001,t,MINERAL AURIFERO Y ARGENTIFERO SIN PROCESAR,2018-12-07,2018-12-07,,ILT-000344,,,ILT-000344,NEGOCIOS ARGOS E.I.R.L.,16.072000,0,16.072000,2614.5104867409158785,42020.4125429,0,42020.4125429,2614.5104867409158785,"",241101 - Mineral Aurifero sin Procesar,,"",13996,,,2018-12-07,
Physical Locations / AMCTJ / Existencias,Ubicaciones virtuales / Transformacion Lote Trujillo,/ AMCTJ / Existencias,06,Mineral con Contenido Aurifero y Argentifero sin Procesar,M0001,t,MINERAL AURIFERO Y ARGENTIFERO SIN PROCESAR,2018-12-07,2018-12-07,,CLT-000329,,,CLT-000329,NEGOCIOS ARGOS E.I.R.L.,0,16.072000,-16.072000,0,0,0.000000,0.000000,0,"",241101 - Mineral Aurifero sin Procesar,0000 LOTES TRUJILLO,"",13996,,,2018-12-07,
Ubicaciones virtuales / Transformacion Lote Trujillo,Physical Locations / AMCAQ / Existencias,/ AMCAQ / Existencias,06,Mineral con Contenido Aurifero y Argentifero sin Procesar,M0001,t,MINERAL AURIFERO Y ARGENTIFERO SIN PROCESAR,2018-12-07,2018-12-07,,ILT-000348,,,ILT-000348,NEGOCIOS ARGOS E.I.R.L.,16.501000,0,16.501000,5659.8436697866795952,93393.08039515,0,93393.08039515,5659.8436697866795952,"",241101 - Mineral Aurifero sin Procesar,,"",13997,,,2018-12-07,
Physical Locations / AMCTJ / Existencias,Ubicaciones virtuales / Transformacion Lote Trujillo,/ AMCTJ / Existencias,06,Mineral con Contenido Aurifero y Argentifero sin Procesar,M0001,t,MINERAL AURIFERO Y ARGENTIFERO SIN PROCESAR,2018-12-07,2018-12-07,,CLT-000333,,,CLT-000333,NEGOCIOS ARGOS E.I.R.L.,0,16.501000,-16.501000,0,0,0.000000,0.000000,0,"",241101 - Mineral Aurifero sin Procesar,0000 LOTES TRUJILLO,"",13997,,,2018-12-07,
Ubicaciones virtuales / Transformacion Lote Trujillo,Physical Locations / AMCAQ / Existencias,/ AMCAQ / Existencias,06,Mineral con Contenido Aurifero y Argentifero sin Procesar,M0001,t,MINERAL AURIFERO Y ARGENTIFERO SIN PROCESAR,2018-12-07,2018-12-07,,ILT-000337,,,ILT-000337,RAUL CELIN CASTILLO JARA,19.943000,0,19.943000,5118.0788926179611894,102069.84735548,0,102069.84735548,5118.0788926179611894,"",241101 - Mineral Aurifero sin Procesar,,"",13998,,,2018-12-07,
Physical Locations / AMCTJ / Existencias,Ubicaciones virtuales / Transformacion Lote Trujillo,/ AMCTJ / Existencias,06,Mineral con Contenido Aurifero y Argentifero sin Procesar,M0001,t,MINERAL AURIFERO Y ARGENTIFERO SIN PROCESAR,2018-12-07,2018-12-07,,CLT-000323,,,CLT-000323,RAUL CELIN CASTILLO JARA,0,19.943000,-19.943000,0,0,0.000000,0.000000,0,"",241101 - Mineral Aurifero sin Procesar,0000 LOTES TRUJILLO,"",13998,,,2018-12-07,
Ubicaciones virtuales / Transformacion Lote Trujillo,Physical Locations / AMCAQ / Existencias,/ AMCAQ / Existencias,06,Mineral con Contenido Aurifero y Argentifero sin Procesar,M0001,t,MINERAL AURIFERO Y ARGENTIFERO SIN PROCESAR,2018-12-07,2018-12-07,,ILT-000344,,,ILT-000344,NEGOCIOS ARGOS E.I.R.L.,11.247000,0,11.247000,2614.5104867413532498,29405.39944438,0,29405.39944438,2614.5104867413532498,"",241101 - Mineral Aurifero sin Procesar,,"",13999,,,2018-12-07,
Physical Locations / AMCTJ / Existencias,Ubicaciones virtuales / Transformacion Lote Trujillo,/ AMCTJ / Existencias,06,Mineral con Contenido Aurifero y Argentifero sin Procesar,M0001,t,MINERAL AURIFERO Y ARGENTIFERO SIN PROCESAR,2018-12-07,2018-12-07,,CLT-000329,,,CLT-000329,NEGOCIOS ARGOS E.I.R.L.,0,11.247000,-11.247000,0,0,0.000000,0.000000,0,"",241101 - Mineral Aurifero sin Procesar,0000 LOTES TRUJILLO,"",13999,,,2018-12-07,
Partner Locations / Suppliers,Physical Locations / AQP M / Existencias,/ AQP M / Existencias,03,Mineral con Contenido Aurifero y Argentifero sin Procesar,M0001,t,MINERAL AURIFERO Y ARGENTIFERO SIN PROCESAR,2018-12-07,2018-12-07,12/2018,AQP M\IN\04531,01,0002,0000007,VALENTIN PERLACIO  CALDERON,9.429000,0,9.429000,2679.2671545232792449,25262.81,0,25262.81,2679.2671545232792449,602101 - Mineral Aurifero sin Procesar,241101 - Mineral Aurifero sin Procesar,,"",14000,18PO06491,,2018-12-07,
Physical Locations / AQP M / Existencias,Ubicaciones virtuales / Produccion,/ AQP M / Existencias,07,Mineral con Contenido Aurifero y Argentifero sin Procesar,M0001,t,MINERAL AURIFERO Y ARGENTIFERO SIN PROCESAR,2018-12-31,2018-12-31,,MAMC-004230,,,MAMC-004230,,0,9.429000,0.000000,2679.2671545232792449,0,25262.8100000000000001621000,-0.0000000000000001621000,0,"",241101 - Mineral Aurifero sin Procesar,,"",14000,,,,
Ubicaciones virtuales / Produccion,Physical Locations / AMCAQ / Existencias,/ AMCAQ / Existencias,08,Mineral con Contenido Aurifero y Argentifero sin Procesar,M0001,t,MINERAL AURIFERO Y ARGENTIFERO SIN PROCESAR,2018-12-31,2018-12-31,,PAMC004236,,,PAMC004236,,9.429000,0,9.429000,2949.6876125018559762,27812.60449828,0,27812.60449828,2949.6876125018559762,"",241101 - Mineral Aurifero sin Procesar,,"",14000,,,,
Partner Locations / Suppliers,Physical Locations / AQP M / Existencias,/ AQP M / Existencias,03,Mineral con Contenido Aurifero y Argentifero sin Procesar,M0001,t,MINERAL AURIFERO Y ARGENTIFERO SIN PROCESAR,2018-12-07,2018-12-07,12/2018,AQP M\IN\04531,01,0002,0000007,VALENTIN PERLACIO  CALDERON,9.355000,0,9.355000,1985.8086584714056654,18577.24,0,18577.24,1985.8086584714056654,602101 - Mineral Aurifero sin Procesar,241101 - Mineral Aurifero sin Procesar,,"",14001,18PO06491,,2018-12-07,
Physical Locations / AQP M / Existencias,Ubicaciones virtuales / Produccion,/ AQP M / Existencias,07,Mineral con Contenido Aurifero y Argentifero sin Procesar,M0001,t,MINERAL AURIFERO Y ARGENTIFERO SIN PROCESAR,2018-12-31,2018-12-31,,MAMC-004230,,,MAMC-004230,,0,9.355000,0.000000,1985.8086584714056654,0,18577.2399999999999998170000,0.0000000000000001830000,0,"",241101 - Mineral Aurifero sin Procesar,,"",14001,,,,
Ubicaciones virtuales / Produccion,Physical Locations / AMCAQ / Existencias,/ AMCAQ / Existencias,08,Mineral con Contenido Aurifero y Argentifero sin Procesar,M0001,t,MINERAL AURIFERO Y ARGENTIFERO SIN PROCESAR,2018-12-31,2018-12-31,,PAMC004236,,,PAMC004236,,9.355000,0,9.355000,2256.2288688444681988,21107.02106804,0,21107.02106804,2256.2288688444681988,"",241101 - Mineral Aurifero sin Procesar,,"",14001,,,,
Partner Locations / Suppliers,Physical Locations / AQP M / Existencias,/ AQP M / Existencias,03,Mineral con Contenido Aurifero y Argentifero sin Procesar,M0001,t,MINERAL AURIFERO Y ARGENTIFERO SIN PROCESAR,2018-12-07,2018-12-07,12/2018,AQP M\IN\04531,01,0002,0000007,VALENTIN PERLACIO  CALDERON,9.659000,0,9.659000,2207.9262863650481416,21326.36,0,21326.36,2207.9262863650481416,602101 - Mineral Aurifero sin Procesar,241101 - Mineral Aurifero sin Procesar,,"",14002,18PO06491,,2018-12-07,
Physical Locations / AQP M / Existencias,Ubicaciones virtuales / Produccion,/ AQP M / Existencias,07,Mineral con Contenido Aurifero y Argentifero sin Procesar,M0001,t,MINERAL AURIFERO Y ARGENTIFERO SIN PROCESAR,2018-12-31,2018-12-31,,MAMC-004230,,,MAMC-004230,,0,9.659000,0.000000,2207.9262863650481416,0,21326.3599999999999997144000,0.0000000000000002856000,0,"",241101 - Mineral Aurifero sin Procesar,,"",14002,,,,
Ubicaciones virtuales / Produccion,Physical Locations / AMCAQ / Existencias,/ AMCAQ / Existencias,08,Mineral con Contenido Aurifero y Argentifero sin Procesar,M0001,t,MINERAL AURIFERO Y ARGENTIFERO SIN PROCESAR,2018-12-31,2018-12-31,,PAMC004236,,,PAMC004236,,9.659000,0,9.659000,2478.3465562025054353,23938.34938636,0,23938.34938636,2478.3465562025054353,"",241101 - Mineral Aurifero sin Procesar,,"",14002,,,,
,,/ AQP M / Existencias,"",Mineral con Contenido Aurifero y Argentifero sin Procesar,"","",MINERAL AURIFERO Y ARGENTIFERO SIN PROCESAR,,2018-12-27,12/2018,,08,0001,0000010,ROGER ARMANDO SEGURA SANES,0,0,0,0,639.07,0,639.07,0,602101,241101 - Mineral Aurifero sin Procesar,"",,14003,,,,f
Partner Locations / Suppliers,Physical Locations / AQP M / Existencias,/ AQP M / Existencias,03,Mineral con Contenido Aurifero y Argentifero sin Procesar,M0002,t,LLAMPO,2018-12-07,2018-12-07,12/2018,AQP M\IN\04543,01,0001,0000084,ROGER ARMANDO SEGURA SANES,10.658000,0,10.658000,684.7063238881591293,7297.6,0,7936.67,744.6678551322949897,602101 - Mineral Aurifero sin Procesar,241101 - Mineral Aurifero sin Procesar,,"",14003,18PO06595,,2018-12-07,
Physical Locations / AQP M / Existencias,Ubicaciones virtuales / Produccion,/ AQP M / Existencias,07,Mineral con Contenido Aurifero y Argentifero sin Procesar,M0002,t,LLAMPO,2018-12-31,2018-12-31,,MAMC-004230,,,MAMC-004230,,0,10.658000,0.000000,744.6678551322949897,0,7936.6700000000000002226000,-0.0000000000000002226000,0,"",241101 - Mineral Aurifero sin Procesar,,"",14003,,,,
Ubicaciones virtuales / Produccion,Physical Locations / AMCAQ / Existencias,/ AMCAQ / Existencias,08,Mineral con Contenido Aurifero y Argentifero sin Procesar,M0002,t,LLAMPO,2018-12-31,2018-12-31,,PAMC004236,,,PAMC004236,,10.658000,0,10.658000,950.0327587380371552,10125.44914263,0,10125.44914263,950.0327587380371552,"",241101 - Mineral Aurifero sin Procesar,,"",14003,,,,
,,/ AQP M / Existencias,"",Mineral con Contenido Aurifero y Argentifero sin Procesar,"","",MINERAL AURIFERO Y ARGENTIFERO SIN PROCESAR,,2018-12-21,12/2018,,08,0001,0000009,ROGER ARMANDO SEGURA SANES,0,0,0,0,1636.23,0,1636.23,0,602101,241101 - Mineral Aurifero sin Procesar,"",,14004,,,,f
Partner Locations / Suppliers,Physical Locations / AQP M / Existencias,/ AQP M / Existencias,03,Mineral con Contenido Aurifero y Argentifero sin Procesar,M0002,t,LLAMPO,2018-12-07,2018-12-07,12/2018,AQP M\IN\04543,01,0001,0000084,ROGER ARMANDO SEGURA SANES,11.227000,0,11.227000,782.2249933196757816,8782.04,0,10418.27,927.9656185980226240,602101 - Mineral Aurifero sin Procesar,241101 - Mineral Aurifero sin Procesar,,"",14004,18PO06595,,2018-12-07,
Physical Locations / AQP M / Existencias,Ubicaciones virtuales / Produccion,/ AQP M / Existencias,07,Mineral con Contenido Aurifero y Argentifero sin Procesar,M0002,t,LLAMPO,2018-12-31,2018-12-31,,MAMC-004230,,,MAMC-004230,,0,11.227000,0.000000,927.9656185980226240,0,10418.2699999999999996480000,0.0000000000000003520000,0,"",241101 - Mineral Aurifero sin Procesar,,"",14004,,,,
Ubicaciones virtuales / Produccion,Physical Locations / AMCAQ / Existencias,/ AMCAQ / Existencias,08,Mineral con Contenido Aurifero y Argentifero sin Procesar,M0002,t,LLAMPO,2018-12-31,2018-12-31,,PAMC004236,,,PAMC004236,,11.227000,0,11.227000,1133.3303812986550281,12723.90019084,0,12723.90019084,1133.3303812986550281,"",241101 - Mineral Aurifero sin Procesar,,"",14004,,,,
Partner Locations / Suppliers,Physical Locations / AQP M / Existencias,/ AQP M / Existencias,03,Mineral con Contenido Aurifero y Argentifero sin Procesar,M0001,t,MINERAL AURIFERO Y ARGENTIFERO SIN PROCESAR,2018-12-08,2018-12-08,12/2018,AQP M\IN\04534,01,E001,0000901,COMUNIDAD CAMPESINA DE UNTUCA,2.312000,0,2.312000,2449.9567474048442907,5664.3,0,5664.3,2449.9567474048442907,602101 - Mineral Aurifero sin Procesar,241101 - Mineral Aurifero sin Procesar,,"",14005,18PO06551,,2018-12-08,
Physical Locations / AQP M / Existencias,Ubicaciones virtuales / Produccion,/ AQP M / Existencias,07,Mineral con Contenido Aurifero y Argentifero sin Procesar,M0001,t,MINERAL AURIFERO Y ARGENTIFERO SIN PROCESAR,2018-12-31,2018-12-31,,MAMC-004230,,,MAMC-004230,,0,2.312000,0.000000,2449.9567474048442907,0,5664.3000000000000000984000,-0.0000000000000000984000,0,"",241101 - Mineral Aurifero sin Procesar,,"",14005,,,,
Ubicaciones virtuales / Produccion,Physical Locations / AMCAQ / Existencias,/ AMCAQ / Existencias,08,Mineral con Contenido Aurifero y Argentifero sin Procesar,M0001,t,MINERAL AURIFERO Y ARGENTIFERO SIN PROCESAR,2018-12-31,2018-12-31,,PAMC004236,,,PAMC004236,,2.312000,0,2.312000,2720.3771878243944637,6289.51205825,0,6289.51205825,2720.3771878243944637,"",241101 - Mineral Aurifero sin Procesar,,"",14005,,,,
Partner Locations / Suppliers,Physical Locations / AQP M / Existencias,/ AQP M / Existencias,03,Mineral con Contenido Aurifero y Argentifero sin Procesar,M0001,t,MINERAL AURIFERO Y ARGENTIFERO SIN PROCESAR,2018-12-08,2018-12-08,12/2018,AQP M\IN\04534,01,E001,0000901,COMUNIDAD CAMPESINA DE UNTUCA,11.799000,0,11.799000,384.7520976353928299,4539.69,0,4539.69,384.7520976353928299,602101 - Mineral Aurifero sin Procesar,241101 - Mineral Aurifero sin Procesar,,"",14006,18PO06551,,2018-12-08,
Physical Locations / AQP M / Existencias,Ubicaciones virtuales / Produccion,/ AQP M / Existencias,07,Mineral con Contenido Aurifero y Argentifero sin Procesar,M0001,t,MINERAL AURIFERO Y ARGENTIFERO SIN PROCESAR,2018-12-31,2018-12-31,,MAMC-004230,,,MAMC-004230,,0,11.799000,0.000000,384.7520976353928299,0,4539.6899999999999999901000,0.0000000000000000099000,0,"",241101 - Mineral Aurifero sin Procesar,,"",14006,,,,
Ubicaciones virtuales / Produccion,Physical Locations / AMCAQ / Existencias,/ AMCAQ / Existencias,08,Mineral con Contenido Aurifero y Argentifero sin Procesar,M0001,t,MINERAL AURIFERO Y ARGENTIFERO SIN PROCESAR,2018-12-31,2018-12-31,,PAMC004236,,,PAMC004236,,11.799000,0,11.799000,655.1722399271124672,7730.3772589,0,7730.3772589,655.1722399271124672,"",241101 - Mineral Aurifero sin Procesar,,"",14006,,,,
,,/ AQP M / Existencias,"",Mineral con Contenido Aurifero y Argentifero sin Procesar,"","",MINERAL AURIFERO Y ARGENTIFERO SIN PROCESAR,,2018-12-28,12/2018,,08,E001,0000001,ROLANDO SONCCO MOLINA,0,0,0,0,1417.31,0,1417.31,0,602101,241101 - Mineral Aurifero sin Procesar,"",,14007,,,,f
Partner Locations / Suppliers,Physical Locations / AQP M / Existencias,/ AQP M / Existencias,03,Mineral con Contenido Aurifero y Argentifero sin Procesar,M0002,t,LLAMPO,2018-12-08,2018-12-08,12/2018,AQP M\IN\04589,01,E001,0000009,ROLANDO SONCCO MOLINA,12.327000,0,12.327000,501.9080068143100511,6187.02,0,7604.33,616.8840756063924718,602101 - Mineral Aurifero sin Procesar,241101 - Mineral Aurifero sin Procesar,,"",14007,18PO06669,,2018-12-08,
Physical Locations / AQP M / Existencias,Ubicaciones virtuales / Produccion,/ AQP M / Existencias,07,Mineral con Contenido Aurifero y Argentifero sin Procesar,M0002,t,LLAMPO,2018-12-31,2018-12-31,,MAMC-004230,,,MAMC-004230,,0,12.327000,0.000000,616.8840756063924718,0,7604.3299999999999998786000,0.0000000000000001214000,0,"",241101 - Mineral Aurifero sin Procesar,,"",14007,,,,
Ubicaciones virtuales / Produccion,Physical Locations / AMCAQ / Existencias,/ AMCAQ / Existencias,08,Mineral con Contenido Aurifero y Argentifero sin Procesar,M0002,t,LLAMPO,2018-12-31,2018-12-31,,PAMC004236,,,PAMC004236,,12.327000,0,12.327000,822.2490120321246045,10135.86357132,0,10135.86357132,822.2490120321246045,"",241101 - Mineral Aurifero sin Procesar,,"",14007,,,,
Partner Locations / Suppliers,Physical Locations / AQP M / Existencias,/ AQP M / Existencias,03,Mineral con Contenido Aurifero y Argentifero sin Procesar,M0001,t,MINERAL AURIFERO Y ARGENTIFERO SIN PROCESAR,2018-12-08,2018-12-08,12/2018,AQP M\IN\04538,01,0001,0001689,MINERA OCHOCIENTOS QUINCE S.A.A.,8.546000,0,8.546000,1275.2562602387081676,10898.34,0,10898.34,1275.2562602387081676,602101 - Mineral Aurifero sin Procesar,241101 - Mineral Aurifero sin Procesar,,"",14008,18PO06566,,2018-12-08,
Physical Locations / AQP M / Existencias,Ubicaciones virtuales / Produccion,/ AQP M / Existencias,07,Mineral con Contenido Aurifero y Argentifero sin Procesar,M0001,t,MINERAL AURIFERO Y ARGENTIFERO SIN PROCESAR,2018-12-31,2018-12-31,,MAMC-004231,,,MAMC-004231,,0,8.546000,0.000000,1275.2562602387081676,0,10898.3400000000000003096000,-0.0000000000000003096000,0,"",241101 - Mineral Aurifero sin Procesar,,"",14008,,,,
Ubicaciones virtuales / Produccion,Physical Locations / AMCAQ / Existencias,/ AMCAQ / Existencias,08,Mineral con Contenido Aurifero y Argentifero sin Procesar,M0001,t,MINERAL AURIFERO Y ARGENTIFERO SIN PROCESAR,2018-12-31,2018-12-31,,PAMC004237,,,PAMC004237,,8.546000,0,8.546000,1545.6766010203604025,13209.35223232,0,13209.35223232,1545.6766010203604025,"",241101 - Mineral Aurifero sin Procesar,,"",14008,,,,
Partner Locations / Suppliers,Physical Locations / AQP M / Existencias,/ AQP M / Existencias,03,Mineral con Contenido Aurifero y Argentifero sin Procesar,M0001,t,MINERAL AURIFERO Y ARGENTIFERO SIN PROCESAR,2018-12-08,2018-12-08,12/2018,AQP M\IN\04538,01,0001,0001689,MINERA OCHOCIENTOS QUINCE S.A.A.,8.277000,0,8.277000,1164.3941041440135315,9637.69,0,9637.69,1164.3941041440135315,602101 - Mineral Aurifero sin Procesar,241101 - Mineral Aurifero sin Procesar,,"",14009,18PO06566,,2018-12-08,
Physical Locations / AQP M / Existencias,Ubicaciones virtuales / Produccion,/ AQP M / Existencias,07,Mineral con Contenido Aurifero y Argentifero sin Procesar,M0001,t,MINERAL AURIFERO Y ARGENTIFERO SIN PROCESAR,2018-12-31,2018-12-31,,MAMC-004231,,,MAMC-004231,,0,8.277000,0.000000,1164.3941041440135315,0,9637.6900000000000002255000,-0.0000000000000002255000,0,"",241101 - Mineral Aurifero sin Procesar,,"",14009,,,,
Ubicaciones virtuales / Produccion,Physical Locations / AMCAQ / Existencias,/ AMCAQ / Existencias,08,Mineral con Contenido Aurifero y Argentifero sin Procesar,M0001,t,MINERAL AURIFERO Y ARGENTIFERO SIN PROCESAR,2018-12-31,2018-12-31,,PAMC004237,,,PAMC004237,,8.277000,0,8.277000,1434.8142490987072611,11875.95753979,0,11875.95753979,1434.8142490987072611,"",241101 - Mineral Aurifero sin Procesar,,"",14009,,,,
Partner Locations / Suppliers,Physical Locations / AQP M / Existencias,/ AQP M / Existencias,03,Mineral con Contenido Aurifero y Argentifero sin Procesar,M0001,t,MINERAL AURIFERO Y ARGENTIFERO SIN PROCESAR,2018-12-08,2018-12-08,12/2018,AQP M\IN\04538,01,0001,0001689,MINERA OCHOCIENTOS QUINCE S.A.A.,7.882000,0,7.882000,1661.1976655671149454,13093.56,0,13093.56,1661.1976655671149454,602101 - Mineral Aurifero sin Procesar,241101 - Mineral Aurifero sin Procesar,,"",14010,18PO06566,,2018-12-08,
Physical Locations / AQP M / Existencias,Ubicaciones virtuales / Produccion,/ AQP M / Existencias,07,Mineral con Contenido Aurifero y Argentifero sin Procesar,M0001,t,MINERAL AURIFERO Y ARGENTIFERO SIN PROCESAR,2018-12-31,2018-12-31,,MAMC-004231,,,MAMC-004231,,0,7.882000,0.000000,1661.1976655671149454,0,13093.5599999999999996428000,0.0000000000000003572000,0,"",241101 - Mineral Aurifero sin Procesar,,"",14010,,,,
Ubicaciones virtuales / Produccion,Physical Locations / AMCAQ / Existencias,/ AMCAQ / Existencias,08,Mineral con Contenido Aurifero y Argentifero sin Procesar,M0001,t,MINERAL AURIFERO Y ARGENTIFERO SIN PROCESAR,2018-12-31,2018-12-31,,PAMC004237,,,PAMC004237,,7.882000,0,7.882000,1931.6178758906368942,15225.01209777,0,15225.01209777,1931.6178758906368942,"",241101 - Mineral Aurifero sin Procesar,,"",14010,,,,
Virtual Locations / Compras sin factura,Physical Locations / AQP M / Existencias,/ AQP M / Existencias,03,Mineral con Contenido Aurifero y Argentifero sin Procesar,M0002,t,LLAMPO,2018-12-30,2018-12-30,,AQP M\IN\04743,,,AQP M\IN\04743,VALENTIN CHOQQUE MAQUI,19.617000,0,19.617000,805.9688025692001835,15810.69,0,15810.69,805.9688025692001835,"",241101 - Mineral Aurifero sin Procesar,,"",14011,,,2018-12-30,
Physical Locations / AQP M / Existencias,Ubicaciones virtuales / Produccion,/ AQP M / Existencias,07,Mineral con Contenido Aurifero y Argentifero sin Procesar,M0002,t,LLAMPO,2018-12-31,2018-12-31,,MAMC-004231,,,MAMC-004231,,0,19.617000,0.000000,805.9688025692001835,0,15810.6899999999999997195000,0.0000000000000002805000,0,"",241101 - Mineral Aurifero sin Procesar,,"",14011,,,,
Ubicaciones virtuales / Produccion,Physical Locations / AMCAQ / Existencias,/ AMCAQ / Existencias,08,Mineral con Contenido Aurifero y Argentifero sin Procesar,M0002,t,LLAMPO,2018-12-31,2018-12-31,,PAMC004237,,,PAMC004237,,19.617000,0,19.617000,1011.3337147081612887,19839.33348143,0,19839.33348143,1011.3337147081612887,"",241101 - Mineral Aurifero sin Procesar,,"",14011,,,,
Partner Locations / Suppliers,Physical Locations / AQP M / Existencias,/ AQP M / Existencias,03,Mineral con Contenido Aurifero y Argentifero sin Procesar,M0002,t,LLAMPO,2018-12-08,2018-12-08,12/2018,AQP M\IN\04528,01,0001,0000262,E&F INVERSIONES MINERAS E.I.R.L.,4.309000,0,4.309000,1562.4576467857971687,6732.63,0,6732.63,1562.4576467857971687,602101 - Mineral Aurifero sin Procesar,241101 - Mineral Aurifero sin Procesar,,"",14012,18PO06484,,2018-12-08,
Physical Locations / AQP M / Existencias,Ubicaciones virtuales / Produccion,/ AQP M / Existencias,07,Mineral con Contenido Aurifero y Argentifero sin Procesar,M0002,t,LLAMPO,2018-12-31,2018-12-31,,MAMC-004231,,,MAMC-004231,,0,4.309000,0.000000,1562.4576467857971687,0,6732.6299999999999999283000,0.0000000000000000717000,0,"",241101 - Mineral Aurifero sin Procesar,,"",14012,,,,
Ubicaciones virtuales / Produccion,Physical Locations / AMCAQ / Existencias,/ AMCAQ / Existencias,08,Mineral con Contenido Aurifero y Argentifero sin Procesar,M0002,t,LLAMPO,2018-12-31,2018-12-31,,PAMC004237,,,PAMC004237,,4.309000,0,4.309000,1767.8221357391506150,7617.5455829,0,7617.5455829,1767.8221357391506150,"",241101 - Mineral Aurifero sin Procesar,,"",14012,,,,
Partner Locations / Suppliers,Physical Locations / AQP M / Existencias,/ AQP M / Existencias,03,Mineral con Contenido Aurifero y Argentifero sin Procesar,M0001,t,MINERAL AURIFERO Y ARGENTIFERO SIN PROCESAR,2018-12-09,2018-12-09,12/2018,AQP M\IN\04551,01,0004,0000157,AUGUSTO GERMAN DEL CARPIO  ALVARADO,14.472000,0,14.472000,554.8942786069651741,8030.43,0,8030.43,554.8942786069651741,602101 - Mineral Aurifero sin Procesar,241101 - Mineral Aurifero sin Procesar,,"",14013,18PO06620,,2018-12-09,
Physical Locations / AQP M / Existencias,Ubicaciones virtuales / Produccion,/ AQP M / Existencias,07,Mineral con Contenido Aurifero y Argentifero sin Procesar,M0001,t,MINERAL AURIFERO Y ARGENTIFERO SIN PROCESAR,2018-12-31,2018-12-31,,MAMC-004231,,,MAMC-004231,,0,14.472000,0.000000,554.8942786069651741,0,8030.4299999999999995752000,0.0000000000000004248000,0,"",241101 - Mineral Aurifero sin Procesar,,"",14013,,,,
Ubicaciones virtuales / Produccion,Physical Locations / AMCAQ / Existencias,/ AMCAQ / Existencias,08,Mineral con Contenido Aurifero y Argentifero sin Procesar,M0001,t,MINERAL AURIFERO Y ARGENTIFERO SIN PROCESAR,2018-12-31,2018-12-31,,PAMC004237,,,PAMC004237,,14.472000,0,14.472000,825.3144198742399116,11943.95028442,0,11943.95028442,825.3144198742399116,"",241101 - Mineral Aurifero sin Procesar,,"",14013,,,,
,,/ AQP M / Existencias,"",Mineral con Contenido Aurifero y Argentifero sin Procesar,"","",MINERAL AURIFERO Y ARGENTIFERO SIN PROCESAR,,2018-12-27,12/2018,,08,0004,0000030,AUGUSTO GERMAN DEL CARPIO  ALVARADO,0,0,0,0,1259.26,0,1259.26,0,602101,241101 - Mineral Aurifero sin Procesar,"",,14014,,,,f
Partner Locations / Suppliers,Physical Locations / AQP M / Existencias,/ AQP M / Existencias,03,Mineral con Contenido Aurifero y Argentifero sin Procesar,M0002,t,LLAMPO,2018-12-09,2018-12-09,12/2018,AQP M\IN\04551,01,0004,0000157,AUGUSTO GERMAN DEL CARPIO  ALVARADO,14.220000,0,14.220000,423.9873417721518987,6029.1,0,7288.36,512.5428973277074543,602101 - Mineral Aurifero sin Procesar,241101 - Mineral Aurifero sin Procesar,,"",14014,18PO06620,,2018-12-09,
Physical Locations / AQP M / Existencias,Ubicaciones virtuales / Produccion,/ AQP M / Existencias,07,Mineral con Contenido Aurifero y Argentifero sin Procesar,M0002,t,LLAMPO,2018-12-31,2018-12-31,,MAMC-004231,,,MAMC-004231,,0,14.220000,0.000000,512.5428973277074543,0,7288.3600000000000001460000,-0.0000000000000001460000,0,"",241101 - Mineral Aurifero sin Procesar,,"",14014,,,,
Ubicaciones virtuales / Produccion,Physical Locations / AMCAQ / Existencias,/ AMCAQ / Existencias,08,Mineral con Contenido Aurifero y Argentifero sin Procesar,M0002,t,LLAMPO,2018-12-31,2018-12-31,,PAMC004237,,,PAMC004237,,14.220000,0,14.220000,717.9076844057665260,10208.64727225,0,10208.64727225,717.9076844057665260,"",241101 - Mineral Aurifero sin Procesar,,"",14014,,,,
Partner Locations / Suppliers,Physical Locations / AQP M / Existencias,/ AQP M / Existencias,03,Mineral con Contenido Aurifero y Argentifero sin Procesar,M0001,t,MINERAL AURIFERO Y ARGENTIFERO SIN PROCESAR,2018-12-10,2018-12-10,12/2018,AQP M\IN\04546,01,0002,0000021,MINERA ARTESANAL ALENAY S.A.C.,1.240000,0,1.240000,881.5241935483870968,1093.09,0,1093.09,881.5241935483870968,602101 - Mineral Aurifero sin Procesar,241101 - Mineral Aurifero sin Procesar,,"",14015,18PO06600,,2018-12-10,
Physical Locations / AQP M / Existencias,Ubicaciones virtuales / Produccion,/ AQP M / Existencias,07,Mineral con Contenido Aurifero y Argentifero sin Procesar,M0001,t,MINERAL AURIFERO Y ARGENTIFERO SIN PROCESAR,2018-12-31,2018-12-31,,MAMC-004231,,,MAMC-004231,,0,1.240000,0.000000,881.5241935483870968,0,1093.0900000000000000320000,-0.0000000000000000320000,0,"",241101 - Mineral Aurifero sin Procesar,,"",14015,,,,
Ubicaciones virtuales / Produccion,Physical Locations / AMCAQ / Existencias,/ AMCAQ / Existencias,08,Mineral con Contenido Aurifero y Argentifero sin Procesar,M0001,t,MINERAL AURIFERO Y ARGENTIFERO SIN PROCESAR,2018-12-31,2018-12-31,,PAMC004237,,,PAMC004237,,1.240000,0,1.240000,1151.9450337338709677,1428.41184183,0,1428.41184183,1151.9450337338709677,"",241101 - Mineral Aurifero sin Procesar,,"",14015,,,,
,,/ AQP M / Existencias,"",Mineral con Contenido Aurifero y Argentifero sin Procesar,"","",MINERAL AURIFERO Y ARGENTIFERO SIN PROCESAR,,2018-12-21,12/2018,,08,E001,0000003,URSULA LUZIER HUAMANI ROJAS,0,0,0,0,806.13,0,806.13,0,602101,241101 - Mineral Aurifero sin Procesar,"",,14016,,,,f
Partner Locations / Suppliers,Physical Locations / AQP M / Existencias,/ AQP M / Existencias,03,Mineral con Contenido Aurifero y Argentifero sin Procesar,M0002,t,LLAMPO,2018-12-11,2018-12-11,12/2018,AQP M\IN\04542,01,E001,0000047,URSULA LUZIER HUAMANI ROJAS,5.397000,0,5.397000,2061.8547341115434501,11127.83,0,11933.96,2211.2210487307763572,602101 - Mineral Aurifero sin Procesar,241101 - Mineral Aurifero sin Procesar,,"",14016,18PO06592,,2018-12-11,
Physical Locations / AQP M / Existencias,Ubicaciones virtuales / Produccion,/ AQP M / Existencias,07,Mineral con Contenido Aurifero y Argentifero sin Procesar,M0002,t,LLAMPO,2018-12-31,2018-12-31,,MAMC-004231,,,MAMC-004231,,0,5.397000,0.000000,2211.2210487307763572,0,11933.9599999999999998084000,0.0000000000000001916000,0,"",241101 - Mineral Aurifero sin Procesar,,"",14016,,,,
Ubicaciones virtuales / Produccion,Physical Locations / AMCAQ / Existencias,/ AMCAQ / Existencias,08,Mineral con Contenido Aurifero y Argentifero sin Procesar,M0002,t,LLAMPO,2018-12-31,2018-12-31,,PAMC004237,,,PAMC004237,,5.397000,0,5.397000,2416.5860737965536409,13042.31504028,0,13042.31504028,2416.5860737965536409,"",241101 - Mineral Aurifero sin Procesar,,"",14016,,,,
,,/ AQP M / Existencias,"",Mineral con Contenido Aurifero y Argentifero sin Procesar,"","",MINERAL AURIFERO Y ARGENTIFERO SIN PROCESAR,,2018-12-17,12/2018,,08,0002,0000056,LUIS GONZAGA VALDIVIA RANILLA,0,0,0,0,576.02,0,576.02,0,602101,241101 - Mineral Aurifero sin Procesar,"",,14017,,,,f
Partner Locations / Suppliers,Physical Locations / AQP M / Existencias,/ AQP M / Existencias,03,Mineral con Contenido Aurifero y Argentifero sin Procesar,M0002,t,LLAMPO,2018-12-11,2018-12-11,12/2018,AQP M\IN\04545,01,0002,0000125,LUIS GONZAGA VALDIVIA RANILLA,3.005000,0,3.005000,3223.2212978369384359,9685.78,0,10261.80,3414.9084858569051581,602101 - Mineral Aurifero sin Procesar,241101 - Mineral Aurifero sin Procesar,,"",14017,18PO06598,,2018-12-11,
Physical Locations / AQP M / Existencias,Ubicaciones virtuales / Produccion,/ AQP M / Existencias,07,Mineral con Contenido Aurifero y Argentifero sin Procesar,M0002,t,LLAMPO,2018-12-31,2018-12-31,,MAMC-004231,,,MAMC-004231,,0,3.005000,0.000000,3414.9084858569051581,0,10261.8000000000000000905000,-0.0000000000000000905000,0,"",241101 - Mineral Aurifero sin Procesar,,"",14017,,,,
Ubicaciones virtuales / Produccion,Physical Locations / AMCAQ / Existencias,/ AMCAQ / Existencias,08,Mineral con Contenido Aurifero y Argentifero sin Procesar,M0002,t,LLAMPO,2018-12-31,2018-12-31,,PAMC004237,,,PAMC004237,,3.005000,0,3.005000,3620.2732128119800333,10878.9210045,0,10878.9210045,3620.2732128119800333,"",241101 - Mineral Aurifero sin Procesar,,"",14017,,,,
Partner Locations / Suppliers,Physical Locations / AQP M / Existencias,/ AQP M / Existencias,03,Mineral con Contenido Aurifero y Argentifero sin Procesar,M0001,t,MINERAL AURIFERO Y ARGENTIFERO SIN PROCESAR,2018-12-11,2018-12-11,12/2018,AQP M\IN\04547,01,0001,0000021,CECILIA ETY VARGAS MONTALVO,0.808000,0,0.808000,872.0049504950495050,704.58,0,704.58,872.0049504950495050,602101 - Mineral Aurifero sin Procesar,241101 - Mineral Aurifero sin Procesar,,"",14018,18PO06603,,2018-12-11,
Physical Locations / AQP M / Existencias,Ubicaciones virtuales / Produccion,/ AQP M / Existencias,07,Mineral con Contenido Aurifero y Argentifero sin Procesar,M0001,t,MINERAL AURIFERO Y ARGENTIFERO SIN PROCESAR,2018-12-31,2018-12-31,,MAMC-004232,,,MAMC-004232,,0,0.808000,0.000000,872.0049504950495050,0,704.5800000000000000400000,-0.0000000000000000400000,0,"",241101 - Mineral Aurifero sin Procesar,,"",14018,,,,
Ubicaciones virtuales / Produccion,Physical Locations / AMCAQ / Existencias,/ AMCAQ / Existencias,08,Mineral con Contenido Aurifero y Argentifero sin Procesar,M0001,t,MINERAL AURIFERO Y ARGENTIFERO SIN PROCESAR,2018-12-31,2018-12-31,,PAMC004238,,,PAMC004238,,0.808000,0,0.808000,1142.4267989975247525,923.08085359,0,923.08085359,1142.4267989975247525,"",241101 - Mineral Aurifero sin Procesar,,"",14018,,,,
Partner Locations / Suppliers,Physical Locations / AQP M / Existencias,/ AQP M / Existencias,03,Mineral con Contenido Aurifero y Argentifero sin Procesar,M0001,t,MINERAL AURIFERO Y ARGENTIFERO SIN PROCESAR,2018-12-11,2018-12-11,12/2018,AQP M\IN\04582,01,0001,0000263,E&F INVERSIONES MINERAS E.I.R.L.,3.144000,0,3.144000,2789.9109414758269720,8771.48,0,8771.48,2789.9109414758269720,602101 - Mineral Aurifero sin Procesar,241101 - Mineral Aurifero sin Procesar,,"",14019,18PO06629,,2018-12-11,
Physical Locations / AQP M / Existencias,Ubicaciones virtuales / Produccion,/ AQP M / Existencias,07,Mineral con Contenido Aurifero y Argentifero sin Procesar,M0001,t,MINERAL AURIFERO Y ARGENTIFERO SIN PROCESAR,2018-12-31,2018-12-31,,MAMC-004232,,,MAMC-004232,,0,3.144000,0.000000,2789.9109414758269720,0,8771.4799999999999999680000,0.0000000000000000320000,0,"",241101 - Mineral Aurifero sin Procesar,,"",14019,,,,
Ubicaciones virtuales / Produccion,Physical Locations / AMCAQ / Existencias,/ AMCAQ / Existencias,08,Mineral con Contenido Aurifero y Argentifero sin Procesar,M0001,t,MINERAL AURIFERO Y ARGENTIFERO SIN PROCESAR,2018-12-31,2018-12-31,,PAMC004238,,,PAMC004238,,3.144000,0,3.144000,3060.3305150922391858,9621.67913945,0,9621.67913945,3060.3305150922391858,"",241101 - Mineral Aurifero sin Procesar,,"",14019,,,,
Partner Locations / Suppliers,Physical Locations / AQP M / Existencias,/ AQP M / Existencias,03,Mineral con Contenido Aurifero y Argentifero sin Procesar,M0001,t,MINERAL AURIFERO Y ARGENTIFERO SIN PROCESAR,2018-12-11,2018-12-11,12/2018,AQP M\IN\04582,01,0001,0000263,E&F INVERSIONES MINERAS E.I.R.L.,2.000000,0,2.000000,1264.3300000000000000,2528.66,0,2528.66,1264.3300000000000000,602101 - Mineral Aurifero sin Procesar,241101 - Mineral Aurifero sin Procesar,,"",14020,18PO06629,,2018-12-11,
Physical Locations / AQP M / Existencias,Ubicaciones virtuales / Produccion,/ AQP M / Existencias,07,Mineral con Contenido Aurifero y Argentifero sin Procesar,M0001,t,MINERAL AURIFERO Y ARGENTIFERO SIN PROCESAR,2018-12-31,2018-12-31,,MAMC-004232,,,MAMC-004232,,0,2.000000,0.000000,1264.3300000000000000,0,2528.6600000000000000000000,0.0000000000000000000000,0,"",241101 - Mineral Aurifero sin Procesar,,"",14020,,,,
Ubicaciones virtuales / Produccion,Physical Locations / AMCAQ / Existencias,/ AMCAQ / Existencias,08,Mineral con Contenido Aurifero y Argentifero sin Procesar,M0001,t,MINERAL AURIFERO Y ARGENTIFERO SIN PROCESAR,2018-12-31,2018-12-31,,PAMC004238,,,PAMC004238,,2.000000,0,2.000000,1534.7492724450000000,3069.49854489,0,3069.49854489,1534.7492724450000000,"",241101 - Mineral Aurifero sin Procesar,,"",14020,,,,
Virtual Locations / Compras sin factura,Physical Locations / AQP M / Existencias,/ AQP M / Existencias,03,Mineral con Contenido Aurifero y Argentifero sin Procesar,M0002,t,LLAMPO,2018-12-11,2018-12-11,,AQP M\IN\04741,,,AQP M\IN\04741,SANDRA SIDNEY BLAS CHANCAHUAÑA,7.990000,0,7.990000,221.3153942428035044,1768.31,0,1768.31,221.3153942428035044,"",241101 - Mineral Aurifero sin Procesar,,"",14021,,,2018-12-11,
Physical Locations / AQP M / Existencias,Ubicaciones virtuales / Produccion,/ AQP M / Existencias,07,Mineral con Contenido Aurifero y Argentifero sin Procesar,M0002,t,LLAMPO,2018-12-31,2018-12-31,,MAMC-004232,,,MAMC-004232,,0,7.990000,0.000000,221.3153942428035044,0,1768.3100000000000001560000,-0.0000000000000001560000,0,"",241101 - Mineral Aurifero sin Procesar,,"",14021,,,,
Ubicaciones virtuales / Produccion,Physical Locations / AMCAQ / Existencias,/ AMCAQ / Existencias,08,Mineral con Contenido Aurifero y Argentifero sin Procesar,M0002,t,LLAMPO,2018-12-31,2018-12-31,,PAMC004238,,,PAMC004238,,7.990000,0,7.990000,426.6803207596996245,3409.17576287,0,3409.17576287,426.6803207596996245,"",241101 - Mineral Aurifero sin Procesar,,"",14021,,,,
Partner Locations / Suppliers,Physical Locations / AQP M / Existencias,/ AQP M / Existencias,03,Mineral con Contenido Aurifero y Argentifero sin Procesar,M0001,t,MINERAL AURIFERO Y ARGENTIFERO SIN PROCESAR,2018-12-13,2018-12-13,12/2018,AQP M\IN\04580,01,E001,0000104,SOCIEDAD MINERA DE RESPONSABILIDAD LIMITADA PULPERA I,26.535000,0,26.535000,771.4934991520633126,20471.58,0,20471.58,771.4934991520633126,602101 - Mineral Aurifero sin Procesar,241101 - Mineral Aurifero sin Procesar,,"",14022,18PO06627,,2018-12-13,
,,/ AQP M / Existencias,"",Mineral con Contenido Aurifero y Argentifero sin Procesar,"","",MINERAL AURIFERO Y ARGENTIFERO SIN PROCESAR,,2018-12-28,12/2018,,08,E001,0000038,SOCIEDAD MINERA DE RESPONSABILIDAD LIMITADA PULPERA I,0,0,26.535000,965.0393819483700773,5135.74,0,25607.32,965.0393819483700773,602101,241101 - Mineral Aurifero sin Procesar,"",,14022,,,,f
Physical Locations / AQP M / Existencias,Ubicaciones virtuales / Produccion,/ AQP M / Existencias,07,Mineral con Contenido Aurifero y Argentifero sin Procesar,M0001,t,MINERAL AURIFERO Y ARGENTIFERO SIN PROCESAR,2018-12-31,2018-12-31,,MAMC-004232,,,MAMC-004232,,0,26.535000,0.000000,965.0393819483700773,0,25607.3200000000000011555000,-0.0000000000000011555000,0,"",241101 - Mineral Aurifero sin Procesar,,"",14022,,,,
Ubicaciones virtuales / Produccion,Physical Locations / AMCAQ / Existencias,/ AMCAQ / Existencias,08,Mineral con Contenido Aurifero y Argentifero sin Procesar,M0001,t,MINERAL AURIFERO Y ARGENTIFERO SIN PROCESAR,2018-12-31,2018-12-31,,PAMC004238,,,PAMC004238,,26.535000,0,26.535000,1235.4596414136046731,32782.92158491,0,32782.92158491,1235.4596414136046731,"",241101 - Mineral Aurifero sin Procesar,,"",14022,,,,
Partner Locations / Suppliers,Physical Locations / AQP M / Existencias,/ AQP M / Existencias,03,Mineral con Contenido Aurifero y Argentifero sin Procesar,M0002,t,LLAMPO,2018-12-13,2018-12-13,12/2018,AQP M\IN\04588,01,E001,0000010,ROLANDO SONCCO MOLINA,12.720000,0,12.720000,792.2838050314465409,10077.85,0,10077.85,792.2838050314465409,602101 - Mineral Aurifero sin Procesar,241101 - Mineral Aurifero sin Procesar,,"",14023,18PO06668,,2018-12-13,
Physical Locations / AQP M / Existencias,Ubicaciones virtuales / Produccion,/ AQP M / Existencias,07,Mineral con Contenido Aurifero y Argentifero sin Procesar,M0002,t,LLAMPO,2018-12-31,2018-12-31,,MAMC-004232,,,MAMC-004232,,0,12.720000,0.000000,792.2838050314465409,0,10077.8500000000000002480000,-0.0000000000000002480000,0,"",241101 - Mineral Aurifero sin Procesar,,"",14023,,,,
Ubicaciones virtuales / Produccion,Physical Locations / AMCAQ / Existencias,/ AMCAQ / Existencias,08,Mineral con Contenido Aurifero y Argentifero sin Procesar,M0002,t,LLAMPO,2018-12-31,2018-12-31,,PAMC004238,,,PAMC004238,,12.720000,0,12.720000,997.6486639614779874,12690.09100559,0,12690.09100559,997.6486639614779874,"",241101 - Mineral Aurifero sin Procesar,,"",14023,,,,
Partner Locations / Suppliers,Physical Locations / AQP M / Existencias,/ AQP M / Existencias,03,Mineral con Contenido Aurifero y Argentifero sin Procesar,M0001,t,MINERAL AURIFERO Y ARGENTIFERO SIN PROCESAR,2018-12-13,2018-12-13,12/2018,AQP M\IN\04579,01,E001,0000381,APMINAC PULPERA CAYLLOMA,34.138000,0,34.138000,824.4583748315659968,28145.36,0,28145.36,824.4583748315659968,602101 - Mineral Aurifero sin Procesar,241101 - Mineral Aurifero sin Procesar,,"",14024,18PO06626,,2018-12-13,
,,/ AQP M / Existencias,"",Mineral con Contenido Aurifero y Argentifero sin Procesar,"","",MINERAL AURIFERO Y ARGENTIFERO SIN PROCESAR,,2018-12-28,12/2018,,08,E001,0000131,APMINAC PULPERA CAYLLOMA,0,0,34.138000,959.8019801980198020,4620.36,0,32765.72,959.8019801980198020,602101,241101 - Mineral Aurifero sin Procesar,"",,14024,,,,f
Physical Locations / AQP M / Existencias,Ubicaciones virtuales / Produccion,/ AQP M / Existencias,07,Mineral con Contenido Aurifero y Argentifero sin Procesar,M0001,t,MINERAL AURIFERO Y ARGENTIFERO SIN PROCESAR,2018-12-31,2018-12-31,,MAMC-004232,,,MAMC-004232,,0,34.138000,0.000000,959.8019801980198020,0,32765.7200000000000006760000,-0.0000000000000006760000,0,"",241101 - Mineral Aurifero sin Procesar,,"",14024,,,,
Ubicaciones virtuales / Produccion,Physical Locations / AMCAQ / Existencias,/ AMCAQ / Existencias,08,Mineral con Contenido Aurifero y Argentifero sin Procesar,M0001,t,MINERAL AURIFERO Y ARGENTIFERO SIN PROCESAR,2018-12-31,2018-12-31,,PAMC004238,,,PAMC004238,,34.138000,0,34.138000,1230.2221655316655926,41997.32428692,0,41997.32428692,1230.2221655316655926,"",241101 - Mineral Aurifero sin Procesar,,"",14024,,,,
Partner Locations / Suppliers,Physical Locations / AQP M / Existencias,/ AQP M / Existencias,03,Mineral con Contenido Aurifero y Argentifero sin Procesar,M0001,t,MINERAL AURIFERO Y ARGENTIFERO SIN PROCESAR,2018-12-13,2018-12-13,12/2018,AQP M\IN\04579,01,E001,0000381,APMINAC PULPERA CAYLLOMA,34.516000,0,34.516000,920.8317881562174064,31783.43,0,31783.43,920.8317881562174064,602101 - Mineral Aurifero sin Procesar,241101 - Mineral Aurifero sin Procesar,,"",14025,18PO06626,,2018-12-13,
,,/ AQP M / Existencias,"",Mineral con Contenido Aurifero y Argentifero sin Procesar,"","",MINERAL AURIFERO Y ARGENTIFERO SIN PROCESAR,,2018-12-28,12/2018,,08,E001,0000132,APMINAC PULPERA CAYLLOMA,0,0,34.516000,1052.3270367365859312,4538.69,0,36322.12,1052.3270367365859312,602101,241101 - Mineral Aurifero sin Procesar,"",,14025,,,,f
Physical Locations / AQP M / Existencias,Ubicaciones virtuales / Produccion,/ AQP M / Existencias,07,Mineral con Contenido Aurifero y Argentifero sin Procesar,M0001,t,MINERAL AURIFERO Y ARGENTIFERO SIN PROCESAR,2018-12-31,2018-12-31,,MAMC-004232,,,MAMC-004232,,0,34.516000,0.000000,1052.3270367365859312,0,36322.1200000000000012992000,-0.0000000000000012992000,0,"",241101 - Mineral Aurifero sin Procesar,,"",14025,,,,
Ubicaciones virtuales / Produccion,Physical Locations / AMCAQ / Existencias,/ AMCAQ / Existencias,08,Mineral con Contenido Aurifero y Argentifero sin Procesar,M0001,t,MINERAL AURIFERO Y ARGENTIFERO SIN PROCESAR,2018-12-31,2018-12-31,,PAMC004238,,,PAMC004238,,34.516000,0,34.516000,1322.7472039506315911,45655.94249156,0,45655.94249156,1322.7472039506315911,"",241101 - Mineral Aurifero sin Procesar,,"",14025,,,,
Virtual Locations / Compras sin factura,Physical Locations / AQP M / Existencias,/ AQP M / Existencias,03,Mineral con Contenido Aurifero y Argentifero sin Procesar,M0002,t,LLAMPO,2018-12-13,2018-12-13,,AQP M\IN\04750,,,AQP M\IN\04750,CLARA ROSAURA GUTIERREZ MOTTA,3.870000,0,3.870000,728.6770025839793282,2819.98,0,2819.98,728.6770025839793282,"",241101 - Mineral Aurifero sin Procesar,,"",14026,,,2018-12-13,
Physical Locations / AQP M / Existencias,Ubicaciones virtuales / Produccion,/ AQP M / Existencias,07,Mineral con Contenido Aurifero y Argentifero sin Procesar,M0002,t,LLAMPO,2018-12-31,2018-12-31,,MAMC-004232,,,MAMC-004232,,0,3.870000,0.000000,728.6770025839793282,0,2819.9800000000000001340000,-0.0000000000000001340000,0,"",241101 - Mineral Aurifero sin Procesar,,"",14026,,,,
Ubicaciones virtuales / Produccion,Physical Locations / AMCAQ / Existencias,/ AMCAQ / Existencias,08,Mineral con Contenido Aurifero y Argentifero sin Procesar,M0002,t,LLAMPO,2018-12-31,2018-12-31,,PAMC004238,,,PAMC004238,,3.870000,0,3.870000,934.0418022635658915,3614.74177476,0,3614.74177476,934.0418022635658915,"",241101 - Mineral Aurifero sin Procesar,,"",14026,,,,
Partner Locations / Suppliers,Physical Locations / AQP M / Existencias,/ AQP M / Existencias,03,Mineral con Contenido Aurifero y Argentifero sin Procesar,M0001,t,MINERAL AURIFERO Y ARGENTIFERO SIN PROCESAR,2018-12-13,2018-12-13,12/2018,AQP M\IN\04587,01,0004,0000158,AUGUSTO GERMAN DEL CARPIO  ALVARADO,4.473000,0,4.473000,2468.9961994187346300,11043.82,0,11043.82,2468.9961994187346300,602101 - Mineral Aurifero sin Procesar,241101 - Mineral Aurifero sin Procesar,,"",14027,18PO06667,,2018-12-13,
Physical Locations / AQP M / Existencias,Ubicaciones virtuales / Produccion,/ AQP M / Existencias,07,Mineral con Contenido Aurifero y Argentifero sin Procesar,M0001,t,MINERAL AURIFERO Y ARGENTIFERO SIN PROCESAR,2018-12-31,2018-12-31,,MAMC-004232,,,MAMC-004232,,0,4.473000,0.000000,2468.9961994187346300,0,11043.8199999999999999900000,0.0000000000000000100000,0,"",241101 - Mineral Aurifero sin Procesar,,"",14027,,,,
Ubicaciones virtuales / Produccion,Physical Locations / AMCAQ / Existencias,/ AMCAQ / Existencias,08,Mineral con Contenido Aurifero y Argentifero sin Procesar,M0001,t,MINERAL AURIFERO Y ARGENTIFERO SIN PROCESAR,2018-12-31,2018-12-31,,PAMC004238,,,PAMC004238,,4.473000,0,4.473000,2739.4161769662418958,12253.40855957,0,12253.40855957,2739.4161769662418958,"",241101 - Mineral Aurifero sin Procesar,,"",14027,,,,
Partner Locations / Suppliers,Physical Locations / AQP M / Existencias,/ AQP M / Existencias,03,Mineral con Contenido Aurifero y Argentifero sin Procesar,M0001,t,MINERAL AURIFERO Y ARGENTIFERO SIN PROCESAR,2018-12-13,2018-12-13,12/2018,AQP M\IN\04587,01,0004,0000158,AUGUSTO GERMAN DEL CARPIO  ALVARADO,4.677000,0,4.677000,2437.1135343168697883,11398.38,0,11398.38,2437.1135343168697883,602101 - Mineral Aurifero sin Procesar,241101 - Mineral Aurifero sin Procesar,,"",14028,18PO06667,,2018-12-13,
,,/ AQP M / Existencias,"",Mineral con Contenido Aurifero y Argentifero sin Procesar,"","",MINERAL AURIFERO Y ARGENTIFERO SIN PROCESAR,,2018-12-27,12/2018,,08,0004,0000032,AUGUSTO GERMAN DEL CARPIO  ALVARADO,0,0,4.677000,2507.5197776352362626,329.29,0,11727.67,2507.5197776352362626,602101,241101 - Mineral Aurifero sin Procesar,"",,14028,,,,f
Physical Locations / AQP M / Existencias,Ubicaciones virtuales / Produccion,/ AQP M / Existencias,07,Mineral con Contenido Aurifero y Argentifero sin Procesar,M0001,t,MINERAL AURIFERO Y ARGENTIFERO SIN PROCESAR,2018-12-31,2018-12-31,,MAMC-004233,,,MAMC-004233,,0,4.677000,0.000000,2507.5197776352362626,0,11727.6700000000000001802000,-0.0000000000000001802000,0,"",241101 - Mineral Aurifero sin Procesar,,"",14028,,,,
Ubicaciones virtuales / Produccion,Physical Locations / AMCAQ / Existencias,/ AMCAQ / Existencias,08,Mineral con Contenido Aurifero y Argentifero sin Procesar,M0001,t,MINERAL AURIFERO Y ARGENTIFERO SIN PROCESAR,2018-12-31,2018-12-31,,PAMC004239,,,PAMC004239,,4.677000,0,4.677000,2777.9402486551208039,12992.42654296,0,12992.42654296,2777.9402486551208039,"",241101 - Mineral Aurifero sin Procesar,,"",14028,,,,
Partner Locations / Suppliers,Physical Locations / AQP M / Existencias,/ AQP M / Existencias,03,Mineral con Contenido Aurifero y Argentifero sin Procesar,M0001,t,MINERAL AURIFERO Y ARGENTIFERO SIN PROCESAR,2018-12-13,2018-12-13,12/2018,AQP M\IN\04587,01,0004,0000158,AUGUSTO GERMAN DEL CARPIO  ALVARADO,10.832000,0,10.832000,1317.2248892171344165,14268.18,0,14268.18,1317.2248892171344165,602101 - Mineral Aurifero sin Procesar,241101 - Mineral Aurifero sin Procesar,,"",14029,18PO06667,,2018-12-13,
,,/ AQP M / Existencias,"",Mineral con Contenido Aurifero y Argentifero sin Procesar,"","",MINERAL AURIFERO Y ARGENTIFERO SIN PROCESAR,,2018-12-27,12/2018,,08,0004,0000032,AUGUSTO GERMAN DEL CARPIO  ALVARADO,0,0,10.832000,1427.9117429837518464,1198.96,0,15467.14,1427.9117429837518464,602101,241101 - Mineral Aurifero sin Procesar,"",,14029,,,,f
Physical Locations / AQP M / Existencias,Ubicaciones virtuales / Produccion,/ AQP M / Existencias,07,Mineral con Contenido Aurifero y Argentifero sin Procesar,M0001,t,MINERAL AURIFERO Y ARGENTIFERO SIN PROCESAR,2018-12-31,2018-12-31,,MAMC-004233,,,MAMC-004233,,0,10.832000,0.000000,1427.9117429837518464,0,15467.1400000000000002048000,-0.0000000000000002048000,0,"",241101 - Mineral Aurifero sin Procesar,,"",14029,,,,
Ubicaciones virtuales / Produccion,Physical Locations / AMCAQ / Existencias,/ AMCAQ / Existencias,08,Mineral con Contenido Aurifero y Argentifero sin Procesar,M0001,t,MINERAL AURIFERO Y ARGENTIFERO SIN PROCESAR,2018-12-31,2018-12-31,,PAMC004239,,,PAMC004239,,10.832000,0,10.832000,1698.3318253406573117,18396.33033209,0,18396.33033209,1698.3318253406573117,"",241101 - Mineral Aurifero sin Procesar,,"",14029,,,,
Partner Locations / Suppliers,Physical Locations / AQP M / Existencias,/ AQP M / Existencias,03,Mineral con Contenido Aurifero y Argentifero sin Procesar,M0001,t,MINERAL AURIFERO Y ARGENTIFERO SIN PROCESAR,2018-12-13,2018-12-13,12/2018,AQP M\IN\04650,01,0003,0000016,LALO ZENON APAZA PFOCCORI,3.510000,0,3.510000,2552.3105413105413105,8958.61,0,8958.61,2552.3105413105413105,602101 - Mineral Aurifero sin Procesar,241101 - Mineral Aurifero sin Procesar,,"",14030,18PO06924,,2018-12-13,
,,/ AQP M / Existencias,"",Mineral con Contenido Aurifero y Argentifero sin Procesar,"","",MINERAL AURIFERO Y ARGENTIFERO SIN PROCESAR,,2018-12-27,12/2018,,01,0003,0000017,LALO ZENON APAZA PFOCCORI,0,0,3.510000,2603.0484330484330484,178.09,0,9136.70,2603.0484330484330484,609201,241101 - Mineral Aurifero sin Procesar,"",,14030,,,,t
Physical Locations / AQP M / Existencias,Ubicaciones virtuales / Produccion,/ AQP M / Existencias,07,Mineral con Contenido Aurifero y Argentifero sin Procesar,M0001,t,MINERAL AURIFERO Y ARGENTIFERO SIN PROCESAR,2018-12-31,2018-12-31,,MAMC-004233,,,MAMC-004233,,0,3.510000,0.000000,2603.0484330484330484,0,9136.6999999999999998840000,0.0000000000000001160000,0,"",241101 - Mineral Aurifero sin Procesar,,"",14030,,,,
Ubicaciones virtuales / Produccion,Physical Locations / AMCAQ / Existencias,/ AMCAQ / Existencias,08,Mineral con Contenido Aurifero y Argentifero sin Procesar,M0001,t,MINERAL AURIFERO Y ARGENTIFERO SIN PROCESAR,2018-12-31,2018-12-31,,PAMC004239,,,PAMC004239,,3.510000,0,3.510000,2873.4684416780626781,10085.87423029,0,10085.87423029,2873.4684416780626781,"",241101 - Mineral Aurifero sin Procesar,,"",14030,,,,
Partner Locations / Suppliers,Physical Locations / AQP M / Existencias,/ AQP M / Existencias,03,Mineral con Contenido Aurifero y Argentifero sin Procesar,M0001,t,MINERAL AURIFERO Y ARGENTIFERO SIN PROCESAR,2018-12-13,2018-12-13,12/2018,AQP M\IN\04650,01,0003,0000016,LALO ZENON APAZA PFOCCORI,4.236000,0,4.236000,2357.6251180358829084,9986.9,0,9986.9,2357.6251180358829084,602101 - Mineral Aurifero sin Procesar,241101 - Mineral Aurifero sin Procesar,,"",14031,18PO06924,,2018-12-13,
Physical Locations / AQP M / Existencias,Ubicaciones virtuales / Produccion,/ AQP M / Existencias,07,Mineral con Contenido Aurifero y Argentifero sin Procesar,M0001,t,MINERAL AURIFERO Y ARGENTIFERO SIN PROCESAR,2018-12-31,2018-12-31,,MAMC-004233,,,MAMC-004233,,0,4.236000,0.000000,2357.6251180358829084,0,9986.8999999999999999824000,0.0000000000000000176000,0,"",241101 - Mineral Aurifero sin Procesar,,"",14031,,,,
Ubicaciones virtuales / Produccion,Physical Locations / AMCAQ / Existencias,/ AMCAQ / Existencias,08,Mineral con Contenido Aurifero y Argentifero sin Procesar,M0001,t,MINERAL AURIFERO Y ARGENTIFERO SIN PROCESAR,2018-12-31,2018-12-31,,PAMC004239,,,PAMC004239,,4.236000,0,4.236000,2628.0455942776203966,11132.40113736,0,11132.40113736,2628.0455942776203966,"",241101 - Mineral Aurifero sin Procesar,,"",14031,,,,
Partner Locations / Suppliers,Physical Locations / AQP M / Existencias,/ AQP M / Existencias,03,Mineral con Contenido Aurifero y Argentifero sin Procesar,M0001,t,MINERAL AURIFERO Y ARGENTIFERO SIN PROCESAR,2018-12-14,2018-12-14,12/2018,AQP M\IN\04658,01,0003,0000012,LALO ZENON APAZA PFOCCORI,6.873000,0,6.873000,5319.6769969445656918,36562.14,0,36562.14,5319.6769969445656918,602101 - Mineral Aurifero sin Procesar,241101 - Mineral Aurifero sin Procesar,,"",14032,18PO06923,,2018-12-14,
,,/ AQP M / Existencias,"",Mineral con Contenido Aurifero y Argentifero sin Procesar,"","",MINERAL AURIFERO Y ARGENTIFERO SIN PROCESAR,,2018-12-27,12/2018,,01,0003,0000017,LALO ZENON APAZA PFOCCORI,0,0,6.873000,5413.0656190891895824,641.86,0,37204.00,5413.0656190891895824,609201,241101 - Mineral Aurifero sin Procesar,"",,14032,,,,t
Physical Locations / AQP M / Existencias,Ubicaciones virtuales / Produccion,/ AQP M / Existencias,07,Mineral con Contenido Aurifero y Argentifero sin Procesar,M0001,t,MINERAL AURIFERO Y ARGENTIFERO SIN PROCESAR,2018-12-31,2018-12-31,,MAMC-004233,,,MAMC-004233,,0,6.873000,0.000000,5413.0656190891895824,0,37203.9999999999999998352000,0.0000000000000001648000,0,"",241101 - Mineral Aurifero sin Procesar,,"",14032,,,,
Ubicaciones virtuales / Produccion,Physical Locations / AMCAQ / Existencias,/ AMCAQ / Existencias,08,Mineral con Contenido Aurifero y Argentifero sin Procesar,M0001,t,MINERAL AURIFERO Y ARGENTIFERO SIN PROCESAR,2018-12-31,2018-12-31,,PAMC004239,,,PAMC004239,,6.873000,0,6.873000,5683.4856259682816819,39062.59670728,0,39062.59670728,5683.4856259682816819,"",241101 - Mineral Aurifero sin Procesar,,"",14032,,,,
Partner Locations / Suppliers,Physical Locations / AQP M / Existencias,/ AQP M / Existencias,03,Mineral con Contenido Aurifero y Argentifero sin Procesar,M0001,t,MINERAL AURIFERO Y ARGENTIFERO SIN PROCESAR,2018-12-14,2018-12-14,12/2018,AQP M\IN\04651,01,0003,0000013,LALO ZENON APAZA PFOCCORI,9.522000,0,9.522000,11108.822726318000,105778.21,0,105778.21,11108.822726318000,602101 - Mineral Aurifero sin Procesar,241101 - Mineral Aurifero sin Procesar,,"",14033,18PO06925,,2018-12-14,
,,/ AQP M / Existencias,"",Mineral con Contenido Aurifero y Argentifero sin Procesar,"","",MINERAL AURIFERO Y ARGENTIFERO SIN PROCESAR,,2018-12-27,12/2018,,01,0003,0000017,LALO ZENON APAZA PFOCCORI,0,0,9.522000,11250.354967443814,1347.67,0,107125.88,11250.354967443814,609201,241101 - Mineral Aurifero sin Procesar,"",,14033,,,,t
Physical Locations / AQP M / Existencias,Ubicaciones virtuales / Produccion,/ AQP M / Existencias,07,Mineral con Contenido Aurifero y Argentifero sin Procesar,M0001,t,MINERAL AURIFERO Y ARGENTIFERO SIN PROCESAR,2018-12-31,2018-12-31,,MAMC-004233,,,MAMC-004233,,0,9.522000,0.000000,11250.354967443814,0,107125.879999999996908000,0.000000000003092000,0,"",241101 - Mineral Aurifero sin Procesar,,"",14033,,,,
Ubicaciones virtuales / Produccion,Physical Locations / AMCAQ / Existencias,/ AMCAQ / Existencias,08,Mineral con Contenido Aurifero y Argentifero sin Procesar,M0001,t,MINERAL AURIFERO Y ARGENTIFERO SIN PROCESAR,2018-12-31,2018-12-31,,PAMC004239,,,PAMC004239,,9.522000,0,9.522000,11520.775050678429,109700.82003256,0,109700.82003256,11520.775050678429,"",241101 - Mineral Aurifero sin Procesar,,"",14033,,,,
Partner Locations / Suppliers,Physical Locations / AQP M / Existencias,/ AQP M / Existencias,03,Mineral con Contenido Aurifero y Argentifero sin Procesar,M0002,t,LLAMPO,2018-12-14,2018-12-14,12/2018,AQP M\IN\04668,01,0001,0001695,MINERA OCHOCIENTOS QUINCE S.A.A.,7.371000,0,7.371000,297.9595712929046262,2196.26,0,2196.26,297.9595712929046262,602101 - Mineral Aurifero sin Procesar,241101 - Mineral Aurifero sin Procesar,,"",14034,19PO00008,,2018-12-14,
Physical Locations / AQP M / Existencias,Ubicaciones virtuales / Produccion,/ AQP M / Existencias,07,Mineral con Contenido Aurifero y Argentifero sin Procesar,M0002,t,LLAMPO,2018-12-31,2018-12-31,,MAMC-004233,,,MAMC-004233,,0,7.371000,0.000000,297.9595712929046262,0,2196.2599999999999997202000,0.0000000000000002798000,0,"",241101 - Mineral Aurifero sin Procesar,,"",14034,,,,
Ubicaciones virtuales / Produccion,Physical Locations / AMCAQ / Existencias,/ AMCAQ / Existencias,08,Mineral con Contenido Aurifero y Argentifero sin Procesar,M0002,t,LLAMPO,2018-12-31,2018-12-31,,PAMC004239,,,PAMC004239,,7.371000,0,7.371000,503.3246866341066341,3710.00626518,0,3710.00626518,503.3246866341066341,"",241101 - Mineral Aurifero sin Procesar,,"",14034,,,,
Partner Locations / Suppliers,Physical Locations / AQP M / Existencias,/ AQP M / Existencias,03,Mineral con Contenido Aurifero y Argentifero sin Procesar,M0002,t,LLAMPO,2018-12-14,2018-12-14,12/2018,AQP M\IN\04668,01,0001,0001695,MINERA OCHOCIENTOS QUINCE S.A.A.,7.183000,0,7.183000,290.1308645412780175,2084.01,0,2084.01,290.1308645412780175,602101 - Mineral Aurifero sin Procesar,241101 - Mineral Aurifero sin Procesar,,"",14035,19PO00008,,2018-12-14,
Physical Locations / AQP M / Existencias,Ubicaciones virtuales / Produccion,/ AQP M / Existencias,07,Mineral con Contenido Aurifero y Argentifero sin Procesar,M0002,t,LLAMPO,2018-12-31,2018-12-31,,MAMC-004233,,,MAMC-004233,,0,7.183000,0.000000,290.1308645412780175,0,2084.0099999999999997025000,0.0000000000000002975000,0,"",241101 - Mineral Aurifero sin Procesar,,"",14035,,,,
Ubicaciones virtuales / Produccion,Physical Locations / AMCAQ / Existencias,/ AMCAQ / Existencias,08,Mineral con Contenido Aurifero y Argentifero sin Procesar,M0002,t,LLAMPO,2018-12-31,2018-12-31,,PAMC004239,,,PAMC004239,,7.183000,0,7.183000,495.4956502171794515,3559.14525551,0,3559.14525551,495.4956502171794515,"",241101 - Mineral Aurifero sin Procesar,,"",14035,,,,
Partner Locations / Suppliers,Physical Locations / AQP M / Existencias,/ AQP M / Existencias,03,Mineral con Contenido Aurifero y Argentifero sin Procesar,M0002,t,LLAMPO,2018-12-14,2018-12-14,12/2018,AQP M\IN\04668,01,0001,0001695,MINERA OCHOCIENTOS QUINCE S.A.A.,6.959000,0,6.959000,416.2106624515016525,2896.41,0,2896.41,416.2106624515016525,602101 - Mineral Aurifero sin Procesar,241101 - Mineral Aurifero sin Procesar,,"",14036,19PO00008,,2018-12-14,
Physical Locations / AQP M / Existencias,Ubicaciones virtuales / Produccion,/ AQP M / Existencias,07,Mineral con Contenido Aurifero y Argentifero sin Procesar,M0002,t,LLAMPO,2018-12-31,2018-12-31,,MAMC-004233,,,MAMC-004233,,0,6.959000,0.000000,416.2106624515016525,0,2896.4099999999999997475000,0.0000000000000002525000,0,"",241101 - Mineral Aurifero sin Procesar,,"",14036,,,,
Ubicaciones virtuales / Produccion,Physical Locations / AMCAQ / Existencias,/ AMCAQ / Existencias,08,Mineral con Contenido Aurifero y Argentifero sin Procesar,M0002,t,LLAMPO,2018-12-31,2018-12-31,,PAMC004239,,,PAMC004239,,6.959000,0,6.959000,621.5757987153326627,4325.54598326,0,4325.54598326,621.5757987153326627,"",241101 - Mineral Aurifero sin Procesar,,"",14036,,,,
Partner Locations / Suppliers,Physical Locations / AQP M / Existencias,/ AQP M / Existencias,03,Mineral con Contenido Aurifero y Argentifero sin Procesar,M0002,t,LLAMPO,2018-12-14,2018-12-14,12/2018,AQP M\IN\04585,01,E001,0000048,URSULA LUZIER HUAMANI ROJAS,10.203000,0,10.203000,1410.2077820248946388,14388.35,0,14388.35,1410.2077820248946388,602101 - Mineral Aurifero sin Procesar,241101 - Mineral Aurifero sin Procesar,,"",14037,18PO06651,,2018-12-14,
Physical Locations / AQP M / Existencias,Ubicaciones virtuales / Produccion,/ AQP M / Existencias,07,Mineral con Contenido Aurifero y Argentifero sin Procesar,M0002,t,LLAMPO,2018-12-31,2018-12-31,,MAMC-004233,,,MAMC-004233,,0,10.203000,0.000000,1410.2077820248946388,0,14388.3499999999999996764000,0.0000000000000003236000,0,"",241101 - Mineral Aurifero sin Procesar,,"",14037,,,,
Ubicaciones virtuales / Produccion,Physical Locations / AMCAQ / Existencias,/ AMCAQ / Existencias,08,Mineral con Contenido Aurifero y Argentifero sin Procesar,M0002,t,LLAMPO,2018-12-31,2018-12-31,,PAMC004239,,,PAMC004239,,10.203000,0,10.203000,1615.5724652690385181,16483.68586314,0,16483.68586314,1615.5724652690385181,"",241101 - Mineral Aurifero sin Procesar,,"",14037,,,,
Virtual Locations / Compras sin factura,Physical Locations / AQP M / Existencias,/ AQP M / Existencias,03,Mineral con Contenido Aurifero y Argentifero sin Procesar,M0002,t,LLAMPO,2018-12-14,2018-12-14,,AQP M\IN\04770,,,AQP M\IN\04770,OSWALDO Y LOS MELLIZOS E.I.R.L.,20.332000,0,20.332000,0.00000000000000000000,0,0,0,0.00000000000000000000,"",241101 - Mineral Aurifero sin Procesar,,"",14038,,,2018-12-14,
Physical Locations / AQP M / Existencias,Ubicaciones virtuales / Produccion,/ AQP M / Existencias,07,Mineral con Contenido Aurifero y Argentifero sin Procesar,M0002,t,LLAMPO,2018-12-31,2018-12-31,,MAMC-004234,,,MAMC-004234,,0,20.332000,0.000000,0.00000000000000000000,0,0.00000000000000000000000000,0.00000000000000000000000000,0,"",241101 - Mineral Aurifero sin Procesar,,"",14038,,,,
Ubicaciones virtuales / Produccion,Physical Locations / AMCAQ / Existencias,/ AMCAQ / Existencias,08,Mineral con Contenido Aurifero y Argentifero sin Procesar,M0002,t,LLAMPO,2018-12-31,2018-12-31,,PAMC004240,,,PAMC004240,,20.332000,0,20.332000,205.3648896965374779,4175.47893731,0,4175.47893731,205.3648896965374779,"",241101 - Mineral Aurifero sin Procesar,,"",14038,,,,
Ubicaciones virtuales / Transformacion Lote Trujillo,Physical Locations / AMCAQ / Existencias,/ AMCAQ / Existencias,06,Mineral con Contenido Aurifero y Argentifero sin Procesar,M0001,t,MINERAL AURIFERO Y ARGENTIFERO SIN PROCESAR,2018-12-14,2018-12-14,,ILT-000345,,,ILT-000345,MASIAS ROGELIO HUERTA  ALVARADO,28.878000,0,28.878000,380.2600411268093358,10981.14946766,0,10981.14946766,380.2600411268093358,"",241101 - Mineral Aurifero sin Procesar,,"",14039,,,2018-12-14,
Physical Locations / AMCTJ / Existencias,Ubicaciones virtuales / Transformacion Lote Trujillo,/ AMCTJ / Existencias,06,Mineral con Contenido Aurifero y Argentifero sin Procesar,M0001,t,MINERAL AURIFERO Y ARGENTIFERO SIN PROCESAR,2018-12-14,2018-12-14,,CLT-000330,,,CLT-000330,MASIAS ROGELIO HUERTA  ALVARADO,0,28.878000,-28.878000,0,0,0.000000,0.000000,0,"",241101 - Mineral Aurifero sin Procesar,0000 LOTES TRUJILLO,"",14039,,,2018-12-14,
Virtual Locations / Compras sin factura,Physical Locations / AQP M / Existencias,/ AQP M / Existencias,03,Mineral con Contenido Aurifero y Argentifero sin Procesar,M0002,t,LLAMPO,2018-12-14,2018-12-14,,AQP M\IN\04771,,,AQP M\IN\04771,COMERCIALIZADORA DE MINERALES J.J.IBARRA S.R.L.,27.161000,0,27.161000,8135.0454696071573212,220955.97,0,220955.97,8135.0454696071573212,"",241101 - Mineral Aurifero sin Procesar,,"",14040,,,2018-12-14,
Physical Locations / AQP M / Existencias,Ubicaciones virtuales / Produccion,/ AQP M / Existencias,07,Mineral con Contenido Aurifero y Argentifero sin Procesar,M0002,t,LLAMPO,2018-12-31,2018-12-31,,MAMC-004234,,,MAMC-004234,,0,27.161000,0.000000,8135.0454696071573212,0,220955.9700000000000011132000,-0.0000000000000011132000,0,"",241101 - Mineral Aurifero sin Procesar,,"",14040,,,,
Ubicaciones virtuales / Produccion,Physical Locations / AMCAQ / Existencias,/ AMCAQ / Existencias,08,Mineral con Contenido Aurifero y Argentifero sin Procesar,M0002,t,LLAMPO,2018-12-31,2018-12-31,,PAMC004240,,,PAMC004240,,27.161000,0,27.161000,8340.4103866429807444,226533.88651161,0,226533.88651161,8340.4103866429807444,"",241101 - Mineral Aurifero sin Procesar,,"",14040,,,,
Ubicaciones virtuales / Transformacion Lote Trujillo,Physical Locations / AMCAQ / Existencias,/ AMCAQ / Existencias,06,Mineral con Contenido Aurifero y Argentifero sin Procesar,M0001,t,MINERAL AURIFERO Y ARGENTIFERO SIN PROCESAR,2018-12-07,2018-12-07,,ILT-000344,,,ILT-000344,NEGOCIOS ARGOS E.I.R.L.,4.474000,0,4.474000,2614.5104867411712114,11697.31991768,0,11697.31991768,2614.5104867411712114,"",241101 - Mineral Aurifero sin Procesar,,"",14041,,,2018-12-07,
Physical Locations / AMCTJ / Existencias,Ubicaciones virtuales / Transformacion Lote Trujillo,/ AMCTJ / Existencias,06,Mineral con Contenido Aurifero y Argentifero sin Procesar,M0001,t,MINERAL AURIFERO Y ARGENTIFERO SIN PROCESAR,2018-12-07,2018-12-07,,CLT-000329,,,CLT-000329,NEGOCIOS ARGOS E.I.R.L.,0,4.474000,-4.474000,0,0,0.000000,0.000000,0,"",241101 - Mineral Aurifero sin Procesar,0000 LOTES TRUJILLO,"",14041,,,2018-12-07,
Ubicaciones virtuales / Transformacion Lote Trujillo,Physical Locations / AMCAQ / Existencias,/ AMCAQ / Existencias,06,Mineral con Contenido Aurifero y Argentifero sin Procesar,M0001,t,MINERAL AURIFERO Y ARGENTIFERO SIN PROCESAR,2018-12-14,2018-12-14,,ILT-000346,,,ILT-000346,MASIAS ROGELIO HUERTA  ALVARADO,8.476000,0,8.476000,2043.0598588591316659,17316.97536369,0,17316.97536369,2043.0598588591316659,"",241101 - Mineral Aurifero sin Procesar,,"",14042,,,2018-12-14,
Physical Locations / AMCTJ / Existencias,Ubicaciones virtuales / Transformacion Lote Trujillo,/ AMCTJ / Existencias,06,Mineral con Contenido Aurifero y Argentifero sin Procesar,M0001,t,MINERAL AURIFERO Y ARGENTIFERO SIN PROCESAR,2018-12-14,2018-12-14,,CLT-000331,,,CLT-000331,MASIAS ROGELIO HUERTA  ALVARADO,0,8.476000,-8.476000,0,0,0.000000,0.000000,0,"",241101 - Mineral Aurifero sin Procesar,0000 LOTES TRUJILLO,"",14042,,,2018-12-14,
Ubicaciones virtuales / Transformacion Lote Trujillo,Physical Locations / AMCAQ / Existencias,/ AMCAQ / Existencias,06,Mineral con Contenido Aurifero y Argentifero sin Procesar,M0001,t,MINERAL AURIFERO Y ARGENTIFERO SIN PROCESAR,2018-12-14,2018-12-14,,ILT-000340,,,ILT-000340,NEGOCIOS ARGOS E.I.R.L.,21.479000,0,21.479000,4146.0871907840216025,89053.80677085,0,89053.80677085,4146.0871907840216025,"",241101 - Mineral Aurifero sin Procesar,,"",14043,,,2018-12-14,
Physical Locations / AMCTJ / Existencias,Ubicaciones virtuales / Transformacion Lote Trujillo,/ AMCTJ / Existencias,06,Mineral con Contenido Aurifero y Argentifero sin Procesar,M0001,t,MINERAL AURIFERO Y ARGENTIFERO SIN PROCESAR,2018-12-14,2018-12-14,,CLT-000325,,,CLT-000325,NEGOCIOS ARGOS E.I.R.L.,0,21.479000,-21.479000,0,0,0.000000,0.000000,0,"",241101 - Mineral Aurifero sin Procesar,0000 LOTES TRUJILLO,"",14043,,,2018-12-14,
Ubicaciones virtuales / Transformacion Lote Trujillo,Physical Locations / AMCAQ / Existencias,/ AMCAQ / Existencias,06,Mineral con Contenido Aurifero y Argentifero sin Procesar,M0001,t,MINERAL AURIFERO Y ARGENTIFERO SIN PROCESAR,2018-12-14,2018-12-14,,ILT-000345,,,ILT-000345,MASIAS ROGELIO HUERTA  ALVARADO,0.791000,0,0.791000,380.2600411251580278,300.78569253,0,300.78569253,380.2600411251580278,"",241101 - Mineral Aurifero sin Procesar,,"",14044,,,2018-12-14,
Physical Locations / AMCTJ / Existencias,Ubicaciones virtuales / Transformacion Lote Trujillo,/ AMCTJ / Existencias,06,Mineral con Contenido Aurifero y Argentifero sin Procesar,M0001,t,MINERAL AURIFERO Y ARGENTIFERO SIN PROCESAR,2018-12-14,2018-12-14,,CLT-000330,,,CLT-000330,MASIAS ROGELIO HUERTA  ALVARADO,0,0.791000,-0.791000,0,0,0.000000,0.000000,0,"",241101 - Mineral Aurifero sin Procesar,0000 LOTES TRUJILLO,"",14044,,,2018-12-14,
Partner Locations / Suppliers,Physical Locations / AQP M / Existencias,/ AQP M / Existencias,03,Mineral con Contenido Aurifero y Argentifero sin Procesar,M0002,t,LLAMPO,2018-12-14,2018-12-14,12/2018,AQP M\IN\04581,01,0002,0000127,LUIS GONZAGA VALDIVIA RANILLA,1.329000,0,1.329000,547.8856282919488337,728.14,0,728.14,547.8856282919488337,602101 - Mineral Aurifero sin Procesar,241101 - Mineral Aurifero sin Procesar,,"",14045,18PO06628,,2018-12-14,
Physical Locations / AQP M / Existencias,Ubicaciones virtuales / Produccion,/ AQP M / Existencias,07,Mineral con Contenido Aurifero y Argentifero sin Procesar,M0002,t,LLAMPO,2018-12-31,2018-12-31,,MAMC-004234,,,MAMC-004234,,0,1.329000,0.000000,547.8856282919488337,0,728.1399999999999999873000,0.0000000000000000127000,0,"",241101 - Mineral Aurifero sin Procesar,,"",14045,,,,
Ubicaciones virtuales / Produccion,Physical Locations / AMCAQ / Existencias,/ AMCAQ / Existencias,08,Mineral con Contenido Aurifero y Argentifero sin Procesar,M0002,t,LLAMPO,2018-12-31,2018-12-31,,PAMC004240,,,PAMC004240,,1.329000,0,1.329000,753.2514100150489090,1001.07112391,0,1001.07112391,753.2514100150489090,"",241101 - Mineral Aurifero sin Procesar,,"",14045,,,,
Partner Locations / Suppliers,Physical Locations / AQP M / Existencias,/ AQP M / Existencias,03,Mineral con Contenido Aurifero y Argentifero sin Procesar,M0001,t,MINERAL AURIFERO Y ARGENTIFERO SIN PROCESAR,2018-12-14,2018-12-14,12/2018,AQP M\IN\04581,01,0002,0000127,LUIS GONZAGA VALDIVIA RANILLA,7.169000,0,7.169000,192.6698284279536895,1381.25,0,1381.25,192.6698284279536895,602101 - Mineral Aurifero sin Procesar,241101 - Mineral Aurifero sin Procesar,,"",14046,18PO06628,,2018-12-14,
Physical Locations / AQP M / Existencias,Ubicaciones virtuales / Produccion,/ AQP M / Existencias,07,Mineral con Contenido Aurifero y Argentifero sin Procesar,M0001,t,MINERAL AURIFERO Y ARGENTIFERO SIN PROCESAR,2018-12-31,2018-12-31,,MAMC-004234,,,MAMC-004234,,0,7.169000,0.000000,192.6698284279536895,0,1381.2500000000000000255000,-0.0000000000000000255000,0,"",241101 - Mineral Aurifero sin Procesar,,"",14046,,,,
Ubicaciones virtuales / Produccion,Physical Locations / AMCAQ / Existencias,/ AMCAQ / Existencias,08,Mineral con Contenido Aurifero y Argentifero sin Procesar,M0001,t,MINERAL AURIFERO Y ARGENTIFERO SIN PROCESAR,2018-12-31,2018-12-31,,PAMC004240,,,PAMC004240,,7.169000,0,7.169000,463.0901524898870135,3319.8933032,0,3319.8933032,463.0901524898870135,"",241101 - Mineral Aurifero sin Procesar,,"",14046,,,,
Partner Locations / Suppliers,Physical Locations / AQP M / Existencias,/ AQP M / Existencias,03,Mineral con Contenido Aurifero y Argentifero sin Procesar,M0001,t,MINERAL AURIFERO Y ARGENTIFERO SIN PROCESAR,2018-12-14,2018-12-14,12/2018,AQP M\IN\04656,01,0001,0000040,JUSTINA HUACHACA PEREZ,3.286000,0,3.286000,5116.4576993304930006,16812.68,0,16812.68,5116.4576993304930006,602101 - Mineral Aurifero sin Procesar,241101 - Mineral Aurifero sin Procesar,,"",14047,18PO06932,,2018-12-14,
Physical Locations / AQP M / Existencias,Ubicaciones virtuales / Produccion,/ AQP M / Existencias,07,Mineral con Contenido Aurifero y Argentifero sin Procesar,M0001,t,MINERAL AURIFERO Y ARGENTIFERO SIN PROCESAR,2018-12-31,2018-12-31,,MAMC-004234,,,MAMC-004234,,0,3.286000,0.000000,5116.4576993304930006,0,16812.6799999999999999716000,0.0000000000000000284000,0,"",241101 - Mineral Aurifero sin Procesar,,"",14047,,,,
Ubicaciones virtuales / Produccion,Physical Locations / AMCAQ / Existencias,/ AMCAQ / Existencias,08,Mineral con Contenido Aurifero y Argentifero sin Procesar,M0001,t,MINERAL AURIFERO Y ARGENTIFERO SIN PROCESAR,2018-12-31,2018-12-31,,PAMC004240,,,PAMC004240,,3.286000,0,3.286000,5386.8781034449178332,17701.28144792,0,17701.28144792,5386.8781034449178332,"",241101 - Mineral Aurifero sin Procesar,,"",14047,,,,
Virtual Locations / Compras sin factura,Physical Locations / AQP M / Existencias,/ AQP M / Existencias,03,Mineral con Contenido Aurifero y Argentifero sin Procesar,M0001,t,MINERAL AURIFERO Y ARGENTIFERO SIN PROCESAR,2018-12-14,2018-12-14,,AQP M\IN\04772,,,AQP M\IN\04772,COMUNIDAD CAMPESINA CHILLOROYA,3.469000,0,3.469000,1558.1867973479388873,5405.35,0,5405.35,1558.1867973479388873,"",241101 - Mineral Aurifero sin Procesar,,"",14048,,,2018-12-14,
Physical Locations / AQP M / Existencias,Ubicaciones virtuales / Produccion,/ AQP M / Existencias,07,Mineral con Contenido Aurifero y Argentifero sin Procesar,M0001,t,MINERAL AURIFERO Y ARGENTIFERO SIN PROCESAR,2018-12-31,2018-12-31,,MAMC-004234,,,MAMC-004234,,0,3.469000,0.000000,1558.1867973479388873,0,5405.3500000000000000437000,-0.0000000000000000437000,0,"",241101 - Mineral Aurifero sin Procesar,,"",14048,,,,
Ubicaciones virtuales / Produccion,Physical Locations / AMCAQ / Existencias,/ AMCAQ / Existencias,08,Mineral con Contenido Aurifero y Argentifero sin Procesar,M0001,t,MINERAL AURIFERO Y ARGENTIFERO SIN PROCESAR,2018-12-31,2018-12-31,,PAMC004240,,,PAMC004240,,3.469000,0,3.469000,1828.6065505246468723,6343.43612377,0,6343.43612377,1828.6065505246468723,"",241101 - Mineral Aurifero sin Procesar,,"",14048,,,,
Virtual Locations / Compras sin factura,Physical Locations / AQP M / Existencias,/ AQP M / Existencias,03,Mineral con Contenido Aurifero y Argentifero sin Procesar,M0001,t,MINERAL AURIFERO Y ARGENTIFERO SIN PROCESAR,2018-12-14,2018-12-14,,AQP M\IN\04773,,,AQP M\IN\04773,COMUNIDAD CAMPESINA CHILLOROYA,3.977000,0,3.977000,2036.6607995976866985,8099.8,0,8099.8,2036.6607995976866985,"",241101 - Mineral Aurifero sin Procesar,,"",14049,,,2018-12-14,
Physical Locations / AQP M / Existencias,Ubicaciones virtuales / Produccion,/ AQP M / Existencias,07,Mineral con Contenido Aurifero y Argentifero sin Procesar,M0001,t,MINERAL AURIFERO Y ARGENTIFERO SIN PROCESAR,2018-12-31,2018-12-31,,MAMC-004234,,,MAMC-004234,,0,3.977000,0.000000,2036.6607995976866985,0,8099.7999999999999999345000,0.0000000000000000655000,0,"",241101 - Mineral Aurifero sin Procesar,,"",14049,,,,
Ubicaciones virtuales / Produccion,Physical Locations / AMCAQ / Existencias,/ AMCAQ / Existencias,08,Mineral con Contenido Aurifero y Argentifero sin Procesar,M0001,t,MINERAL AURIFERO Y ARGENTIFERO SIN PROCESAR,2018-12-31,2018-12-31,,PAMC004240,,,PAMC004240,,3.977000,0,3.977000,2307.0810207040482776,9175.26121934,0,9175.26121934,2307.0810207040482776,"",241101 - Mineral Aurifero sin Procesar,,"",14049,,,,
Virtual Locations / Compras sin factura,Physical Locations / AQP M / Existencias,/ AQP M / Existencias,03,Mineral con Contenido Aurifero y Argentifero sin Procesar,M0001,t,MINERAL AURIFERO Y ARGENTIFERO SIN PROCESAR,2018-12-14,2018-12-14,,AQP M\IN\04773,,,AQP M\IN\04773,COMUNIDAD CAMPESINA CHILLOROYA,4.172000,0,4.172000,1580.7981783317353787,6595.09,0,6595.09,1580.7981783317353787,"",241101 - Mineral Aurifero sin Procesar,,"",14050,,,2018-12-14,
Physical Locations / AQP M / Existencias,Ubicaciones virtuales / Produccion,/ AQP M / Existencias,07,Mineral con Contenido Aurifero y Argentifero sin Procesar,M0001,t,MINERAL AURIFERO Y ARGENTIFERO SIN PROCESAR,2018-12-31,2018-12-31,,MAMC-004234,,,MAMC-004234,,0,4.172000,0.000000,1580.7981783317353787,0,6595.0899999999999999364000,0.0000000000000000636000,0,"",241101 - Mineral Aurifero sin Procesar,,"",14050,,,,
Ubicaciones virtuales / Produccion,Physical Locations / AMCAQ / Existencias,/ AMCAQ / Existencias,08,Mineral con Contenido Aurifero y Argentifero sin Procesar,M0001,t,MINERAL AURIFERO Y ARGENTIFERO SIN PROCESAR,2018-12-31,2018-12-31,,PAMC004240,,,PAMC004240,,4.172000,0,4.172000,1851.2182362464046021,7723.28248162,0,7723.28248162,1851.2182362464046021,"",241101 - Mineral Aurifero sin Procesar,,"",14050,,,,
Virtual Locations / Compras sin factura,Physical Locations / AQP M / Existencias,/ AQP M / Existencias,03,Mineral con Contenido Aurifero y Argentifero sin Procesar,M0001,t,MINERAL AURIFERO Y ARGENTIFERO SIN PROCESAR,2018-12-14,2018-12-14,,AQP M\IN\04773,,,AQP M\IN\04773,COMUNIDAD CAMPESINA CHILLOROYA,4.216000,0,4.216000,103.8662239089184061,437.9,0,437.9,103.8662239089184061,"",241101 - Mineral Aurifero sin Procesar,,"",14051,,,2018-12-14,
Physical Locations / AQP M / Existencias,Ubicaciones virtuales / Produccion,/ AQP M / Existencias,07,Mineral con Contenido Aurifero y Argentifero sin Procesar,M0001,t,MINERAL AURIFERO Y ARGENTIFERO SIN PROCESAR,2018-12-31,2018-12-31,,MAMC-004234,,,MAMC-004234,,0,4.216000,0.000000,103.8662239089184061,0,437.9000000000000001176000,-0.0000000000000001176000,0,"",241101 - Mineral Aurifero sin Procesar,,"",14051,,,,
Ubicaciones virtuales / Produccion,Physical Locations / AMCAQ / Existencias,/ AMCAQ / Existencias,08,Mineral con Contenido Aurifero y Argentifero sin Procesar,M0001,t,MINERAL AURIFERO Y ARGENTIFERO SIN PROCESAR,2018-12-31,2018-12-31,,PAMC004240,,,PAMC004240,,4.216000,0,4.216000,374.2867240298861480,1577.99282851,0,1577.99282851,374.2867240298861480,"",241101 - Mineral Aurifero sin Procesar,,"",14051,,,,
Partner Locations / Suppliers,Physical Locations / AQP M / Existencias,/ AQP M / Existencias,03,Mineral con Contenido Aurifero y Argentifero sin Procesar,M0001,t,MINERAL AURIFERO Y ARGENTIFERO SIN PROCESAR,2018-12-14,2018-12-14,12/2018,AQP M\IN\04611,01,0001,0000039,JUSTINA HUACHACA PEREZ,3.430000,0,3.430000,6515.0379008746355685,22346.58,0,22346.58,6515.0379008746355685,602101 - Mineral Aurifero sin Procesar,241101 - Mineral Aurifero sin Procesar,,"",14052,18PO06733,,2018-12-14,
Physical Locations / AQP M / Existencias,Ubicaciones virtuales / Produccion,/ AQP M / Existencias,07,Mineral con Contenido Aurifero y Argentifero sin Procesar,M0001,t,MINERAL AURIFERO Y ARGENTIFERO SIN PROCESAR,2018-12-31,2018-12-31,,MAMC-004234,,,MAMC-004234,,0,3.430000,0.000000,6515.0379008746355685,0,22346.5799999999999999550000,0.0000000000000000450000,0,"",241101 - Mineral Aurifero sin Procesar,,"",14052,,,,
Ubicaciones virtuales / Produccion,Physical Locations / AMCAQ / Existencias,/ AMCAQ / Existencias,08,Mineral con Contenido Aurifero y Argentifero sin Procesar,M0001,t,MINERAL AURIFERO Y ARGENTIFERO SIN PROCESAR,2018-12-31,2018-12-31,,PAMC004240,,,PAMC004240,,3.430000,0,3.430000,6785.4583577201166181,23274.12216698,0,23274.12216698,6785.4583577201166181,"",241101 - Mineral Aurifero sin Procesar,,"",14052,,,,
Virtual Locations / Compras sin factura,Physical Locations / AQP M / Existencias,/ AQP M / Existencias,03,Mineral con Contenido Aurifero y Argentifero sin Procesar,M0001,t,MINERAL AURIFERO Y ARGENTIFERO SIN PROCESAR,2018-12-14,2018-12-14,,AQP M\IN\04773,,,AQP M\IN\04773,COMUNIDAD CAMPESINA CHILLOROYA,4.321000,0,4.321000,0.00000000000000000000,0,0,0,0.00000000000000000000,"",241101 - Mineral Aurifero sin Procesar,,"",14053,,,2018-12-14,
Physical Locations / AQP M / Existencias,Ubicaciones virtuales / Produccion,/ AQP M / Existencias,07,Mineral con Contenido Aurifero y Argentifero sin Procesar,M0001,t,MINERAL AURIFERO Y ARGENTIFERO SIN PROCESAR,2018-12-31,2018-12-31,,MAMC-004235,,,MAMC-004235,,0,4.321000,0.000000,0.00000000000000000000,0,0.00000000000000000000000000,0.00000000000000000000000000,0,"",241101 - Mineral Aurifero sin Procesar,,"",14053,,,,
Ubicaciones virtuales / Produccion,Physical Locations / AMCAQ / Existencias,/ AMCAQ / Existencias,08,Mineral con Contenido Aurifero y Argentifero sin Procesar,M0001,t,MINERAL AURIFERO Y ARGENTIFERO SIN PROCESAR,2018-12-31,2018-12-31,,PAMC004241,,,PAMC004241,,4.321000,0,4.321000,270.4203090349456144,1168.48615534,0,1168.48615534,270.4203090349456144,"",241101 - Mineral Aurifero sin Procesar,,"",14053,,,,
Virtual Locations / Compras sin factura,Physical Locations / AQP M / Existencias,/ AQP M / Existencias,03,Mineral con Contenido Aurifero y Argentifero sin Procesar,M0001,t,MINERAL AURIFERO Y ARGENTIFERO SIN PROCESAR,2018-12-14,2018-12-14,,AQP M\IN\04773,,,AQP M\IN\04773,COMUNIDAD CAMPESINA CHILLOROYA,3.027000,0,3.027000,804.6580773042616452,2435.7,0,2435.7,804.6580773042616452,"",241101 - Mineral Aurifero sin Procesar,,"",14054,,,2018-12-14,
Physical Locations / AQP M / Existencias,Ubicaciones virtuales / Produccion,/ AQP M / Existencias,07,Mineral con Contenido Aurifero y Argentifero sin Procesar,M0001,t,MINERAL AURIFERO Y ARGENTIFERO SIN PROCESAR,2018-12-31,2018-12-31,,MAMC-004235,,,MAMC-004235,,0,3.027000,0.000000,804.6580773042616452,0,2435.7000000000000000204000,-0.0000000000000000204000,0,"",241101 - Mineral Aurifero sin Procesar,,"",14054,,,,
Ubicaciones virtuales / Produccion,Physical Locations / AMCAQ / Existencias,/ AMCAQ / Existencias,08,Mineral con Contenido Aurifero y Argentifero sin Procesar,M0001,t,MINERAL AURIFERO Y ARGENTIFERO SIN PROCESAR,2018-12-31,2018-12-31,,PAMC004241,,,PAMC004241,,3.027000,0,3.027000,1075.0781400462504130,3254.26152992,0,3254.26152992,1075.0781400462504130,"",241101 - Mineral Aurifero sin Procesar,,"",14054,,,,
Virtual Locations / Compras sin factura,Physical Locations / AQP M / Existencias,/ AQP M / Existencias,03,Mineral con Contenido Aurifero y Argentifero sin Procesar,M0001,t,MINERAL AURIFERO Y ARGENTIFERO SIN PROCESAR,2018-12-15,2018-12-15,,AQP M\IN\04774,,,AQP M\IN\04774,COMUNIDAD CAMPESINA CHILLOROYA,3.531000,0,3.531000,1271.8663268195978476,4490.96,0,4490.96,1271.8663268195978476,"",241101 - Mineral Aurifero sin Procesar,,"",14055,,,2018-12-15,
Physical Locations / AQP M / Existencias,Ubicaciones virtuales / Produccion,/ AQP M / Existencias,07,Mineral con Contenido Aurifero y Argentifero sin Procesar,M0001,t,MINERAL AURIFERO Y ARGENTIFERO SIN PROCESAR,2018-12-31,2018-12-31,,MAMC-004235,,,MAMC-004235,,0,3.531000,0.000000,1271.8663268195978476,0,4490.9599999999999998756000,0.0000000000000001244000,0,"",241101 - Mineral Aurifero sin Procesar,,"",14055,,,,
Ubicaciones virtuales / Produccion,Physical Locations / AMCAQ / Existencias,/ AMCAQ / Existencias,08,Mineral con Contenido Aurifero y Argentifero sin Procesar,M0001,t,MINERAL AURIFERO Y ARGENTIFERO SIN PROCESAR,2018-12-31,2018-12-31,,PAMC004241,,,PAMC004241,,3.531000,0,3.531000,1542.2866228207306712,5445.81406518,0,5445.81406518,1542.2866228207306712,"",241101 - Mineral Aurifero sin Procesar,,"",14055,,,,
Virtual Locations / Compras sin factura,Physical Locations / AQP M / Existencias,/ AQP M / Existencias,03,Mineral con Contenido Aurifero y Argentifero sin Procesar,M0002,t,LLAMPO,2018-12-15,2018-12-15,,AQP M\IN\04751,,,AQP M\IN\04751,NOE MERMA PARI,2.868000,0,2.868000,1213.3647140864714086,3479.93,0,3479.93,1213.3647140864714086,"",241101 - Mineral Aurifero sin Procesar,,"",14056,,,2018-12-15,
Physical Locations / AQP M / Existencias,Ubicaciones virtuales / Produccion,/ AQP M / Existencias,07,Mineral con Contenido Aurifero y Argentifero sin Procesar,M0002,t,LLAMPO,2018-12-31,2018-12-31,,MAMC-004235,,,MAMC-004235,,0,2.868000,0.000000,1213.3647140864714086,0,3479.9299999999999998648000,0.0000000000000001352000,0,"",241101 - Mineral Aurifero sin Procesar,,"",14056,,,,
Ubicaciones virtuales / Produccion,Physical Locations / AMCAQ / Existencias,/ AMCAQ / Existencias,08,Mineral con Contenido Aurifero y Argentifero sin Procesar,M0002,t,LLAMPO,2018-12-31,2018-12-31,,PAMC004241,,,PAMC004241,,2.868000,0,2.868000,1418.7298269281729428,4068.91714363,0,4068.91714363,1418.7298269281729428,"",241101 - Mineral Aurifero sin Procesar,,"",14056,,,,
Virtual Locations / Compras sin factura,Physical Locations / AQP M / Existencias,/ AQP M / Existencias,03,Mineral con Contenido Aurifero y Argentifero sin Procesar,M0001,t,MINERAL AURIFERO Y ARGENTIFERO SIN PROCESAR,2018-12-15,2018-12-15,,AQP M\IN\04774,,,AQP M\IN\04774,COMUNIDAD CAMPESINA CHILLOROYA,3.427000,0,3.427000,1317.0644878902830464,4513.58,0,4513.58,1317.0644878902830464,"",241101 - Mineral Aurifero sin Procesar,,"",14057,,,2018-12-15,
Physical Locations / AQP M / Existencias,Ubicaciones virtuales / Produccion,/ AQP M / Existencias,07,Mineral con Contenido Aurifero y Argentifero sin Procesar,M0001,t,MINERAL AURIFERO Y ARGENTIFERO SIN PROCESAR,2018-12-31,2018-12-31,,MAMC-004235,,,MAMC-004235,,0,3.427000,0.000000,1317.0644878902830464,0,4513.5800000000000000128000,-0.0000000000000000128000,0,"",241101 - Mineral Aurifero sin Procesar,,"",14057,,,,
Ubicaciones virtuales / Produccion,Physical Locations / AMCAQ / Existencias,/ AMCAQ / Existencias,08,Mineral con Contenido Aurifero y Argentifero sin Procesar,M0001,t,MINERAL AURIFERO Y ARGENTIFERO SIN PROCESAR,2018-12-31,2018-12-31,,PAMC004241,,,PAMC004241,,3.427000,0,3.427000,1587.4850001517362124,5440.31109552,0,5440.31109552,1587.4850001517362124,"",241101 - Mineral Aurifero sin Procesar,,"",14057,,,,
Virtual Locations / Compras sin factura,Physical Locations / AQP M / Existencias,/ AQP M / Existencias,03,Mineral con Contenido Aurifero y Argentifero sin Procesar,M0002,t,LLAMPO,2018-12-15,2018-12-15,,AQP M\IN\04751,,,AQP M\IN\04751,NOE MERMA PARI,11.121000,0,11.121000,1848.6179300422623865,20558.48,0,20558.48,1848.6179300422623865,"",241101 - Mineral Aurifero sin Procesar,,"",14058,,,2018-12-15,
Physical Locations / AQP M / Existencias,Ubicaciones virtuales / Produccion,/ AQP M / Existencias,07,Mineral con Contenido Aurifero y Argentifero sin Procesar,M0002,t,LLAMPO,2018-12-31,2018-12-31,,MAMC-004235,,,MAMC-004235,,0,11.121000,0.000000,1848.6179300422623865,0,20558.4800000000000002665000,-0.0000000000000002665000,0,"",241101 - Mineral Aurifero sin Procesar,,"",14058,,,,
Ubicaciones virtuales / Produccion,Physical Locations / AMCAQ / Existencias,/ AMCAQ / Existencias,08,Mineral con Contenido Aurifero y Argentifero sin Procesar,M0002,t,LLAMPO,2018-12-31,2018-12-31,,PAMC004241,,,PAMC004241,,11.121000,0,11.121000,2053.9827292338818452,22842.34193181,0,22842.34193181,2053.9827292338818452,"",241101 - Mineral Aurifero sin Procesar,,"",14058,,,,
Virtual Locations / Compras sin factura,Physical Locations / AQP M / Existencias,/ AQP M / Existencias,03,Mineral con Contenido Aurifero y Argentifero sin Procesar,M0001,t,MINERAL AURIFERO Y ARGENTIFERO SIN PROCESAR,2018-12-15,2018-12-15,,AQP M\IN\04774,,,AQP M\IN\04774,COMUNIDAD CAMPESINA CHILLOROYA,4.306000,0,4.306000,1415.0325127728750581,6093.13,0,6093.13,1415.0325127728750581,"",241101 - Mineral Aurifero sin Procesar,,"",14059,,,2018-12-15,
Physical Locations / AQP M / Existencias,Ubicaciones virtuales / Produccion,/ AQP M / Existencias,07,Mineral con Contenido Aurifero y Argentifero sin Procesar,M0001,t,MINERAL AURIFERO Y ARGENTIFERO SIN PROCESAR,2018-12-31,2018-12-31,,MAMC-004235,,,MAMC-004235,,0,4.306000,0.000000,1415.0325127728750581,0,6093.1300000000000001786000,-0.0000000000000001786000,0,"",241101 - Mineral Aurifero sin Procesar,,"",14059,,,,
Ubicaciones virtuales / Produccion,Physical Locations / AMCAQ / Existencias,/ AMCAQ / Existencias,08,Mineral con Contenido Aurifero y Argentifero sin Procesar,M0001,t,MINERAL AURIFERO Y ARGENTIFERO SIN PROCESAR,2018-12-31,2018-12-31,,PAMC004241,,,PAMC004241,,4.306000,0,4.306000,1685.4530425406409661,7257.56080118,0,7257.56080118,1685.4530425406409661,"",241101 - Mineral Aurifero sin Procesar,,"",14059,,,,
Virtual Locations / Compras sin factura,Physical Locations / AQP M / Existencias,/ AQP M / Existencias,03,Mineral con Contenido Aurifero y Argentifero sin Procesar,M0002,t,LLAMPO,2018-12-15,2018-12-15,,AQP M\IN\04751,,,AQP M\IN\04751,NOE MERMA PARI,10.684000,0,10.684000,1421.5537251965555972,15187.88,0,15187.88,1421.5537251965555972,"",241101 - Mineral Aurifero sin Procesar,,"",14060,,,2018-12-15,
Physical Locations / AQP M / Existencias,Ubicaciones virtuales / Produccion,/ AQP M / Existencias,07,Mineral con Contenido Aurifero y Argentifero sin Procesar,M0002,t,LLAMPO,2018-12-31,2018-12-31,,MAMC-004235,,,MAMC-004235,,0,10.684000,0.000000,1421.5537251965555972,0,15187.8800000000000004848000,-0.0000000000000004848000,0,"",241101 - Mineral Aurifero sin Procesar,,"",14060,,,,
Ubicaciones virtuales / Produccion,Physical Locations / AMCAQ / Existencias,/ AMCAQ / Existencias,08,Mineral con Contenido Aurifero y Argentifero sin Procesar,M0002,t,LLAMPO,2018-12-31,2018-12-31,,PAMC004241,,,PAMC004241,,10.684000,0,10.684000,1626.9187332384874579,17381.99974592,0,17381.99974592,1626.9187332384874579,"",241101 - Mineral Aurifero sin Procesar,,"",14060,,,,
Virtual Locations / Compras sin factura,Physical Locations / AQP M / Existencias,/ AQP M / Existencias,03,Mineral con Contenido Aurifero y Argentifero sin Procesar,M0001,t,MINERAL AURIFERO Y ARGENTIFERO SIN PROCESAR,2018-12-15,2018-12-15,,AQP M\IN\04774,,,AQP M\IN\04774,COMUNIDAD CAMPESINA CHILLOROYA,3.536000,0,3.536000,1501.7081447963800905,5310.04,0,5310.04,1501.7081447963800905,"",241101 - Mineral Aurifero sin Procesar,,"",14061,,,2018-12-15,
Physical Locations / AQP M / Existencias,Ubicaciones virtuales / Produccion,/ AQP M / Existencias,07,Mineral con Contenido Aurifero y Argentifero sin Procesar,M0001,t,MINERAL AURIFERO Y ARGENTIFERO SIN PROCESAR,2018-12-31,2018-12-31,,MAMC-004235,,,MAMC-004235,,0,3.536000,0.000000,1501.7081447963800905,0,5310.0400000000000000080000,-0.0000000000000000080000,0,"",241101 - Mineral Aurifero sin Procesar,,"",14061,,,,
Ubicaciones virtuales / Produccion,Physical Locations / AMCAQ / Existencias,/ AMCAQ / Existencias,08,Mineral con Contenido Aurifero y Argentifero sin Procesar,M0001,t,MINERAL AURIFERO Y ARGENTIFERO SIN PROCESAR,2018-12-31,2018-12-31,,PAMC004241,,,PAMC004241,,3.536000,0,3.536000,1772.1286820899321267,6266.24701987,0,6266.24701987,1772.1286820899321267,"",241101 - Mineral Aurifero sin Procesar,,"",14061,,,,
Virtual Locations / Compras sin factura,Physical Locations / AQP M / Existencias,/ AQP M / Existencias,03,Mineral con Contenido Aurifero y Argentifero sin Procesar,M0001,t,MINERAL AURIFERO Y ARGENTIFERO SIN PROCESAR,2018-12-15,2018-12-15,,AQP M\IN\04774,,,AQP M\IN\04774,COMUNIDAD CAMPESINA CHILLOROYA,2.457000,0,2.457000,473.1176231176231176,1162.45,0,1162.45,473.1176231176231176,"",241101 - Mineral Aurifero sin Procesar,,"",14062,,,2018-12-15,
Physical Locations / AQP M / Existencias,Ubicaciones virtuales / Produccion,/ AQP M / Existencias,07,Mineral con Contenido Aurifero y Argentifero sin Procesar,M0001,t,MINERAL AURIFERO Y ARGENTIFERO SIN PROCESAR,2018-12-31,2018-12-31,,MAMC-004235,,,MAMC-004235,,0,2.457000,0.000000,473.1176231176231176,0,1162.4499999999999999432000,0.0000000000000000568000,0,"",241101 - Mineral Aurifero sin Procesar,,"",14062,,,,
Ubicaciones virtuales / Produccion,Physical Locations / AMCAQ / Existencias,/ AMCAQ / Existencias,08,Mineral con Contenido Aurifero y Argentifero sin Procesar,M0001,t,MINERAL AURIFERO Y ARGENTIFERO SIN PROCESAR,2018-12-31,2018-12-31,,PAMC004241,,,PAMC004241,,2.457000,0,2.457000,743.5381092592592593,1826.87313445,0,1826.87313445,743.5381092592592593,"",241101 - Mineral Aurifero sin Procesar,,"",14062,,,,
Virtual Locations / Compras sin factura,Physical Locations / AQP M / Existencias,/ AQP M / Existencias,03,Mineral con Contenido Aurifero y Argentifero sin Procesar,M0001,t,MINERAL AURIFERO Y ARGENTIFERO SIN PROCESAR,2018-12-15,2018-12-15,,AQP M\IN\04774,,,AQP M\IN\04774,COMUNIDAD CAMPESINA CHILLOROYA,2.236000,0,2.236000,341.2790697674418605,763.1,0,763.1,341.2790697674418605,"",241101 - Mineral Aurifero sin Procesar,,"",14063,,,2018-12-15,
Physical Locations / AQP M / Existencias,Ubicaciones virtuales / Produccion,/ AQP M / Existencias,07,Mineral con Contenido Aurifero y Argentifero sin Procesar,M0001,t,MINERAL AURIFERO Y ARGENTIFERO SIN PROCESAR,2018-12-31,2018-12-31,,MAMC-004236,,,MAMC-004236,,0,2.236000,0.000000,341.2790697674418605,0,763.1000000000000000780000,-0.0000000000000000780000,0,"",241101 - Mineral Aurifero sin Procesar,,"",14063,,,,
Ubicaciones virtuales / Produccion,Physical Locations / AMCAQ / Existencias,/ AMCAQ / Existencias,08,Mineral con Contenido Aurifero y Argentifero sin Procesar,M0001,t,MINERAL AURIFERO Y ARGENTIFERO SIN PROCESAR,2018-12-31,2018-12-31,,PAMC004242,,,PAMC004242,,2.236000,0,2.236000,611.6990696869409660,1367.75911982,0,1367.75911982,611.6990696869409660,"",241101 - Mineral Aurifero sin Procesar,,"",14063,,,,
Virtual Locations / Compras sin factura,Physical Locations / AQP M / Existencias,/ AQP M / Existencias,03,Mineral con Contenido Aurifero y Argentifero sin Procesar,M0001,t,MINERAL AURIFERO Y ARGENTIFERO SIN PROCESAR,2018-12-15,2018-12-15,,AQP M\IN\04774,,,AQP M\IN\04774,COMUNIDAD CAMPESINA CHILLOROYA,2.707000,0,2.707000,0.00000000000000000000,0,0,0,0.00000000000000000000,"",241101 - Mineral Aurifero sin Procesar,,"",14064,,,2018-12-15,
Physical Locations / AQP M / Existencias,Ubicaciones virtuales / Produccion,/ AQP M / Existencias,07,Mineral con Contenido Aurifero y Argentifero sin Procesar,M0001,t,MINERAL AURIFERO Y ARGENTIFERO SIN PROCESAR,2018-12-31,2018-12-31,,MAMC-004236,,,MAMC-004236,,0,2.707000,0.000000,0.00000000000000000000,0,0.00000000000000000000000000,0.00000000000000000000000000,0,"",241101 - Mineral Aurifero sin Procesar,,"",14064,,,,
Ubicaciones virtuales / Produccion,Physical Locations / AMCAQ / Existencias,/ AMCAQ / Existencias,08,Mineral con Contenido Aurifero y Argentifero sin Procesar,M0001,t,MINERAL AURIFERO Y ARGENTIFERO SIN PROCESAR,2018-12-31,2018-12-31,,PAMC004242,,,PAMC004242,,2.707000,0,2.707000,270.4202069745105283,732.02750028,0,732.02750028,270.4202069745105283,"",241101 - Mineral Aurifero sin Procesar,,"",14064,,,,
Virtual Locations / Compras sin factura,Physical Locations / AQP M / Existencias,/ AQP M / Existencias,03,Mineral con Contenido Aurifero y Argentifero sin Procesar,M0001,t,MINERAL AURIFERO Y ARGENTIFERO SIN PROCESAR,2018-12-15,2018-12-15,,AQP M\IN\04774,,,AQP M\IN\04774,COMUNIDAD CAMPESINA CHILLOROYA,2.268000,0,2.268000,0.00000000000000000000,0,0,0,0.00000000000000000000,"",241101 - Mineral Aurifero sin Procesar,,"",14065,,,2018-12-15,
Physical Locations / AQP M / Existencias,Ubicaciones virtuales / Produccion,/ AQP M / Existencias,07,Mineral con Contenido Aurifero y Argentifero sin Procesar,M0001,t,MINERAL AURIFERO Y ARGENTIFERO SIN PROCESAR,2018-12-31,2018-12-31,,MAMC-004236,,,MAMC-004236,,0,2.268000,0.000000,0.00000000000000000000,0,0.00000000000000000000000000,0.00000000000000000000000000,0,"",241101 - Mineral Aurifero sin Procesar,,"",14065,,,,
Ubicaciones virtuales / Produccion,Physical Locations / AMCAQ / Existencias,/ AMCAQ / Existencias,08,Mineral con Contenido Aurifero y Argentifero sin Procesar,M0001,t,MINERAL AURIFERO Y ARGENTIFERO SIN PROCESAR,2018-12-31,2018-12-31,,PAMC004242,,,PAMC004242,,2.268000,0,2.268000,270.4196258245149912,613.31171137,0,613.31171137,270.4196258245149912,"",241101 - Mineral Aurifero sin Procesar,,"",14065,,,,
Virtual Locations / Compras sin factura,Physical Locations / AQP M / Existencias,/ AQP M / Existencias,03,Mineral con Contenido Aurifero y Argentifero sin Procesar,M0001,t,MINERAL AURIFERO Y ARGENTIFERO SIN PROCESAR,2018-12-15,2018-12-15,,AQP M\IN\04774,,,AQP M\IN\04774,COMUNIDAD CAMPESINA CHILLOROYA,1.184000,0,1.184000,280.9881756756756757,332.69,0,332.69,280.9881756756756757,"",241101 - Mineral Aurifero sin Procesar,,"",14066,,,2018-12-15,
Physical Locations / AQP M / Existencias,Ubicaciones virtuales / Produccion,/ AQP M / Existencias,07,Mineral con Contenido Aurifero y Argentifero sin Procesar,M0001,t,MINERAL AURIFERO Y ARGENTIFERO SIN PROCESAR,2018-12-31,2018-12-31,,MAMC-004236,,,MAMC-004236,,0,1.184000,0.000000,280.9881756756756757,0,332.6900000000000000288000,-0.0000000000000000288000,0,"",241101 - Mineral Aurifero sin Procesar,,"",14066,,,,
Ubicaciones virtuales / Produccion,Physical Locations / AMCAQ / Existencias,/ AMCAQ / Existencias,08,Mineral con Contenido Aurifero y Argentifero sin Procesar,M0001,t,MINERAL AURIFERO Y ARGENTIFERO SIN PROCESAR,2018-12-31,2018-12-31,,PAMC004242,,,PAMC004242,,1.184000,0,1.184000,551.4080870101351351,652.86717502,0,652.86717502,551.4080870101351351,"",241101 - Mineral Aurifero sin Procesar,,"",14066,,,,
Virtual Locations / Compras sin factura,Physical Locations / AQP M / Existencias,/ AQP M / Existencias,03,Mineral con Contenido Aurifero y Argentifero sin Procesar,M0001,t,MINERAL AURIFERO Y ARGENTIFERO SIN PROCESAR,2018-12-15,2018-12-15,,AQP M\IN\04774,,,AQP M\IN\04774,COMUNIDAD CAMPESINA CHILLOROYA,1.904000,0,1.904000,650.1785714285714286,1237.94,0,1237.94,650.1785714285714286,"",241101 - Mineral Aurifero sin Procesar,,"",14067,,,2018-12-15,
Physical Locations / AQP M / Existencias,Ubicaciones virtuales / Produccion,/ AQP M / Existencias,07,Mineral con Contenido Aurifero y Argentifero sin Procesar,M0001,t,MINERAL AURIFERO Y ARGENTIFERO SIN PROCESAR,2018-12-31,2018-12-31,,MAMC-004236,,,MAMC-004236,,0,1.904000,0.000000,650.1785714285714286,0,1237.9400000000000000544000,-0.0000000000000000544000,0,"",241101 - Mineral Aurifero sin Procesar,,"",14067,,,,
Ubicaciones virtuales / Produccion,Physical Locations / AMCAQ / Existencias,/ AMCAQ / Existencias,08,Mineral con Contenido Aurifero y Argentifero sin Procesar,M0001,t,MINERAL AURIFERO Y ARGENTIFERO SIN PROCESAR,2018-12-31,2018-12-31,,PAMC004242,,,PAMC004242,,1.904000,0,1.904000,920.5991440441176471,1752.82077026,0,1752.82077026,920.5991440441176471,"",241101 - Mineral Aurifero sin Procesar,,"",14067,,,,
Virtual Locations / Compras sin factura,Physical Locations / AQP M / Existencias,/ AQP M / Existencias,03,Mineral con Contenido Aurifero y Argentifero sin Procesar,M0001,t,MINERAL AURIFERO Y ARGENTIFERO SIN PROCESAR,2018-12-15,2018-12-15,,AQP M\IN\04774,,,AQP M\IN\04774,COMUNIDAD CAMPESINA CHILLOROYA,0.855000,0,0.855000,601.2046783625730994,514.03,0,514.03,601.2046783625730994,"",241101 - Mineral Aurifero sin Procesar,,"",14068,,,2018-12-15,
Physical Locations / AQP M / Existencias,Ubicaciones virtuales / Produccion,/ AQP M / Existencias,07,Mineral con Contenido Aurifero y Argentifero sin Procesar,M0001,t,MINERAL AURIFERO Y ARGENTIFERO SIN PROCESAR,2018-12-31,2018-12-31,,MAMC-004236,,,MAMC-004236,,0,0.855000,0.000000,601.2046783625730994,0,514.0299999999999999870000,0.0000000000000000130000,0,"",241101 - Mineral Aurifero sin Procesar,,"",14068,,,,
Ubicaciones virtuales / Produccion,Physical Locations / AMCAQ / Existencias,/ AMCAQ / Existencias,08,Mineral con Contenido Aurifero y Argentifero sin Procesar,M0001,t,MINERAL AURIFERO Y ARGENTIFERO SIN PROCESAR,2018-12-31,2018-12-31,,PAMC004242,,,PAMC004242,,0.855000,0,0.855000,871.6243266666666667,745.2387993,0,745.2387993,871.6243266666666667,"",241101 - Mineral Aurifero sin Procesar,,"",14068,,,,
Virtual Locations / Compras sin factura,Physical Locations / AQP M / Existencias,/ AQP M / Existencias,03,Mineral con Contenido Aurifero y Argentifero sin Procesar,M0001,t,MINERAL AURIFERO Y ARGENTIFERO SIN PROCESAR,2018-12-15,2018-12-15,,AQP M\IN\04775,,,AQP M\IN\04775,COMUNIDAD CAMPESINA CHILLOROYA,4.601000,0,4.601000,322.4103455770484677,1483.41,0,1483.41,322.4103455770484677,"",241101 - Mineral Aurifero sin Procesar,,"",14069,,,2018-12-15,
Physical Locations / AQP M / Existencias,Ubicaciones virtuales / Produccion,/ AQP M / Existencias,07,Mineral con Contenido Aurifero y Argentifero sin Procesar,M0001,t,MINERAL AURIFERO Y ARGENTIFERO SIN PROCESAR,2018-12-31,2018-12-31,,MAMC-004236,,,MAMC-004236,,0,4.601000,0.000000,322.4103455770484677,0,1483.4099999999999998877000,0.0000000000000001123000,0,"",241101 - Mineral Aurifero sin Procesar,,"",14069,,,,
Ubicaciones virtuales / Produccion,Physical Locations / AMCAQ / Existencias,/ AMCAQ / Existencias,08,Mineral con Contenido Aurifero y Argentifero sin Procesar,M0001,t,MINERAL AURIFERO Y ARGENTIFERO SIN PROCESAR,2018-12-31,2018-12-31,,PAMC004242,,,PAMC004242,,4.601000,0,4.601000,592.8303408824168659,2727.6123984,0,2727.6123984,592.8303408824168659,"",241101 - Mineral Aurifero sin Procesar,,"",14069,,,,
Partner Locations / Suppliers,Physical Locations / AQP M / Existencias,/ AQP M / Existencias,03,Mineral con Contenido Aurifero y Argentifero sin Procesar,M0001,t,MINERAL AURIFERO Y ARGENTIFERO SIN PROCESAR,2018-12-15,2018-12-15,12/2018,AQP M\IN\04618,01,E001,0000087,SAUL JOSE GROVAS QUISPE,3.996000,0,3.996000,865.2652652652652653,3457.6,0,3457.6,865.2652652652652653,602101 - Mineral Aurifero sin Procesar,241101 - Mineral Aurifero sin Procesar,,"",14070,18PO06747,,2018-12-15,
Physical Locations / AQP M / Existencias,Ubicaciones virtuales / Produccion,/ AQP M / Existencias,07,Mineral con Contenido Aurifero y Argentifero sin Procesar,M0001,t,MINERAL AURIFERO Y ARGENTIFERO SIN PROCESAR,2018-12-31,2018-12-31,,MAMC-004236,,,MAMC-004236,,0,3.996000,0.000000,865.2652652652652653,0,3457.6000000000000001388000,-0.0000000000000001388000,0,"",241101 - Mineral Aurifero sin Procesar,,"",14070,,,,
Ubicaciones virtuales / Produccion,Physical Locations / AMCAQ / Existencias,/ AMCAQ / Existencias,08,Mineral con Contenido Aurifero y Argentifero sin Procesar,M0001,t,MINERAL AURIFERO Y ARGENTIFERO SIN PROCESAR,2018-12-31,2018-12-31,,PAMC004242,,,PAMC004242,,3.996000,0,3.996000,1135.6854782357357357,4538.19917103,0,4538.19917103,1135.6854782357357357,"",241101 - Mineral Aurifero sin Procesar,,"",14070,,,,
Ubicaciones virtuales / Transformacion Lote Trujillo,Physical Locations / AMCAQ / Existencias,/ AMCAQ / Existencias,06,Mineral con Contenido Aurifero y Argentifero sin Procesar,M0001,t,MINERAL AURIFERO Y ARGENTIFERO SIN PROCESAR,2018-12-15,2018-12-15,,ILT-000341,,,ILT-000341,NEGOCIOS ARGOS E.I.R.L.,21.819000,0,21.819000,2992.1367096044731656,65285.43086686,0,65285.43086686,2992.1367096044731656,"",241101 - Mineral Aurifero sin Procesar,,"",14071,,,2018-12-15,
Physical Locations / AMCTJ / Existencias,Ubicaciones virtuales / Transformacion Lote Trujillo,/ AMCTJ / Existencias,06,Mineral con Contenido Aurifero y Argentifero sin Procesar,M0001,t,MINERAL AURIFERO Y ARGENTIFERO SIN PROCESAR,2018-12-15,2018-12-15,,CLT-000326,,,CLT-000326,NEGOCIOS ARGOS E.I.R.L.,0,21.819000,-21.819000,0,0,0.000000,0.000000,0,"",241101 - Mineral Aurifero sin Procesar,0000 LOTES TRUJILLO,"",14071,,,2018-12-15,
Virtual Locations / Compras sin factura,Physical Locations / AQP M / Existencias,/ AQP M / Existencias,03,Mineral con Contenido Aurifero y Argentifero sin Procesar,M0001,t,MINERAL AURIFERO Y ARGENTIFERO SIN PROCESAR,2018-12-15,2018-12-15,,AQP M\IN\04775,,,AQP M\IN\04775,COMUNIDAD CAMPESINA CHILLOROYA,2.302000,0,2.302000,0.00000000000000000000,0,0,0,0.00000000000000000000,"",241101 - Mineral Aurifero sin Procesar,,"",14072,,,2018-12-15,
Physical Locations / AQP M / Existencias,Ubicaciones virtuales / Produccion,/ AQP M / Existencias,07,Mineral con Contenido Aurifero y Argentifero sin Procesar,M0001,t,MINERAL AURIFERO Y ARGENTIFERO SIN PROCESAR,2018-12-31,2018-12-31,,MAMC-004236,,,MAMC-004236,,0,2.302000,0.000000,0.00000000000000000000,0,0.00000000000000000000000000,0.00000000000000000000000000,0,"",241101 - Mineral Aurifero sin Procesar,,"",14072,,,,
Ubicaciones virtuales / Produccion,Physical Locations / AMCAQ / Existencias,/ AMCAQ / Existencias,08,Mineral con Contenido Aurifero y Argentifero sin Procesar,M0001,t,MINERAL AURIFERO Y ARGENTIFERO SIN PROCESAR,2018-12-31,2018-12-31,,PAMC004242,,,PAMC004242,,2.302000,0,2.302000,270.4197159513466551,622.50618612,0,622.50618612,270.4197159513466551,"",241101 - Mineral Aurifero sin Procesar,,"",14072,,,,
Ubicaciones virtuales / Transformacion Lote Trujillo,Physical Locations / AMCAQ / Existencias,/ AMCAQ / Existencias,06,Mineral con Contenido Aurifero y Argentifero sin Procesar,M0001,t,MINERAL AURIFERO Y ARGENTIFERO SIN PROCESAR,2018-12-14,2018-12-14,,ILT-000346,,,ILT-000346,MASIAS ROGELIO HUERTA  ALVARADO,11.736000,0,11.736000,2043.0598588590661213,23977.35050357,0,23977.35050357,2043.0598588590661213,"",241101 - Mineral Aurifero sin Procesar,,"",14073,,,2018-12-14,
Physical Locations / AMCTJ / Existencias,Ubicaciones virtuales / Transformacion Lote Trujillo,/ AMCTJ / Existencias,06,Mineral con Contenido Aurifero y Argentifero sin Procesar,M0001,t,MINERAL AURIFERO Y ARGENTIFERO SIN PROCESAR,2018-12-14,2018-12-14,,CLT-000331,,,CLT-000331,MASIAS ROGELIO HUERTA  ALVARADO,0,11.736000,-11.736000,0,0,0.000000,0.000000,0,"",241101 - Mineral Aurifero sin Procesar,0000 LOTES TRUJILLO,"",14073,,,2018-12-14,
Virtual Locations / Compras sin factura,Physical Locations / AQP M / Existencias,/ AQP M / Existencias,03,Mineral con Contenido Aurifero y Argentifero sin Procesar,M0001,t,MINERAL AURIFERO Y ARGENTIFERO SIN PROCESAR,2018-12-15,2018-12-15,,AQP M\IN\04775,,,AQP M\IN\04775,COMUNIDAD CAMPESINA CHILLOROYA,2.843000,0,2.843000,1053.3309883925430883,2994.62,0,2994.62,1053.3309883925430883,"",241101 - Mineral Aurifero sin Procesar,,"",14074,,,2018-12-15,
Physical Locations / AQP M / Existencias,Ubicaciones virtuales / Produccion,/ AQP M / Existencias,07,Mineral con Contenido Aurifero y Argentifero sin Procesar,M0001,t,MINERAL AURIFERO Y ARGENTIFERO SIN PROCESAR,2018-12-31,2018-12-31,,MAMC-004236,,,MAMC-004236,,0,2.843000,0.000000,1053.3309883925430883,0,2994.6200000000000000369000,-0.0000000000000000369000,0,"",241101 - Mineral Aurifero sin Procesar,,"",14074,,,,
Ubicaciones virtuales / Produccion,Physical Locations / AMCAQ / Existencias,/ AMCAQ / Existencias,08,Mineral con Contenido Aurifero y Argentifero sin Procesar,M0001,t,MINERAL AURIFERO Y ARGENTIFERO SIN PROCESAR,2018-12-31,2018-12-31,,PAMC004242,,,PAMC004242,,2.843000,0,2.843000,1323.7510483257122758,3763.42423039,0,3763.42423039,1323.7510483257122758,"",241101 - Mineral Aurifero sin Procesar,,"",14074,,,,
Ubicaciones virtuales / Transformacion Lote Trujillo,Physical Locations / AMCAQ / Existencias,/ AMCAQ / Existencias,06,Mineral con Contenido Aurifero y Argentifero sin Procesar,M0001,t,MINERAL AURIFERO Y ARGENTIFERO SIN PROCESAR,2018-12-15,2018-12-15,,ILT-000347,,,ILT-000347,MASIAS ROGELIO HUERTA  ALVARADO,33.360000,0,33.360000,2200.8177243893884892,73419.27928563,0,73419.27928563,2200.8177243893884892,"",241101 - Mineral Aurifero sin Procesar,,"",14075,,,2018-12-15,
Physical Locations / AMCTJ / Existencias,Ubicaciones virtuales / Transformacion Lote Trujillo,/ AMCTJ / Existencias,06,Mineral con Contenido Aurifero y Argentifero sin Procesar,M0001,t,MINERAL AURIFERO Y ARGENTIFERO SIN PROCESAR,2018-12-15,2018-12-15,,CLT-000332,,,CLT-000332,MASIAS ROGELIO HUERTA  ALVARADO,0,33.360000,-33.360000,0,0,0.000000,0.000000,0,"",241101 - Mineral Aurifero sin Procesar,0000 LOTES TRUJILLO,"",14075,,,2018-12-15,
Ubicaciones virtuales / Transformacion Lote Trujillo,Physical Locations / AMCAQ / Existencias,/ AMCAQ / Existencias,06,Mineral con Contenido Aurifero y Argentifero sin Procesar,M0001,t,MINERAL AURIFERO Y ARGENTIFERO SIN PROCESAR,2018-12-15,2018-12-15,,ILT-000347,,,ILT-000347,MASIAS ROGELIO HUERTA  ALVARADO,1.300000,0,1.300000,2200.8177243923076923,2861.06304171,0,2861.06304171,2200.8177243923076923,"",241101 - Mineral Aurifero sin Procesar,,"",14076,,,2018-12-15,
Physical Locations / AMCTJ / Existencias,Ubicaciones virtuales / Transformacion Lote Trujillo,/ AMCTJ / Existencias,06,Mineral con Contenido Aurifero y Argentifero sin Procesar,M0001,t,MINERAL AURIFERO Y ARGENTIFERO SIN PROCESAR,2018-12-15,2018-12-15,,CLT-000332,,,CLT-000332,MASIAS ROGELIO HUERTA  ALVARADO,0,1.300000,-1.300000,0,0,0.000000,0.000000,0,"",241101 - Mineral Aurifero sin Procesar,0000 LOTES TRUJILLO,"",14076,,,2018-12-15,
Ubicaciones virtuales / Transformacion Lote Trujillo,Physical Locations / AMCAQ / Existencias,/ AMCAQ / Existencias,06,Mineral con Contenido Aurifero y Argentifero sin Procesar,M0001,t,MINERAL AURIFERO Y ARGENTIFERO SIN PROCESAR,2018-12-15,2018-12-15,,ILT-000330,,,ILT-000330,NEGOCIOS ARGOS E.I.R.L.,26.070000,0,26.070000,2640.1119609133103184,68827.71882101,0,68827.71882101,2640.1119609133103184,"",241101 - Mineral Aurifero sin Procesar,,"",14077,,,2018-12-15,
Physical Locations / AMCTJ / Existencias,Ubicaciones virtuales / Transformacion Lote Trujillo,/ AMCTJ / Existencias,06,Mineral con Contenido Aurifero y Argentifero sin Procesar,M0001,t,MINERAL AURIFERO Y ARGENTIFERO SIN PROCESAR,2018-12-15,2018-12-15,,CLT-000315,,,CLT-000315,NEGOCIOS ARGOS E.I.R.L.,0,26.070000,-26.070000,0,0,0.000000,0.000000,0,"",241101 - Mineral Aurifero sin Procesar,0000 LOTES TRUJILLO,"",14077,,,2018-12-15,
Partner Locations / Suppliers,Physical Locations / AQP M / Existencias,/ AQP M / Existencias,03,Mineral con Contenido Aurifero y Argentifero sin Procesar,M0001,t,MINERAL AURIFERO Y ARGENTIFERO SIN PROCESAR,2018-12-15,2018-12-15,12/2018,AQP M\IN\04603,01,E001,0002284,COMUNIDAD CAMPESINA CHILLOROYA,0.750000,0,0.750000,791.4800000000000000,593.61,0,593.61,791.4800000000000000,602101 - Mineral Aurifero sin Procesar,241101 - Mineral Aurifero sin Procesar,,"",14078,18PO06716,,2018-12-15,
Physical Locations / AQP M / Existencias,Ubicaciones virtuales / Produccion,/ AQP M / Existencias,07,Mineral con Contenido Aurifero y Argentifero sin Procesar,M0001,t,MINERAL AURIFERO Y ARGENTIFERO SIN PROCESAR,2018-12-31,2018-12-31,,MAMC-004237,,,MAMC-004237,,0,0.750000,0.000000,791.4800000000000000,0,593.6100000000000000000000,0.0000000000000000000000,0,"",241101 - Mineral Aurifero sin Procesar,,"",14078,,,,
Ubicaciones virtuales / Produccion,Physical Locations / AMCAQ / Existencias,/ AMCAQ / Existencias,08,Mineral con Contenido Aurifero y Argentifero sin Procesar,M0001,t,MINERAL AURIFERO Y ARGENTIFERO SIN PROCESAR,2018-12-31,2018-12-31,,PAMC004243,,,PAMC004243,,0.750000,0,0.750000,1061.8990714133333333,796.42430356,0,796.42430356,1061.8990714133333333,"",241101 - Mineral Aurifero sin Procesar,,"",14078,,,,
Partner Locations / Suppliers,Physical Locations / AQP M / Existencias,/ AQP M / Existencias,03,Mineral con Contenido Aurifero y Argentifero sin Procesar,M0001,t,MINERAL AURIFERO Y ARGENTIFERO SIN PROCESAR,2018-12-15,2018-12-15,12/2018,AQP M\IN\04603,01,E001,0002284,COMUNIDAD CAMPESINA CHILLOROYA,1.380000,0,1.380000,1030.8623188405797101,1422.59,0,1422.59,1030.8623188405797101,602101 - Mineral Aurifero sin Procesar,241101 - Mineral Aurifero sin Procesar,,"",14079,18PO06716,,2018-12-15,
Physical Locations / AQP M / Existencias,Ubicaciones virtuales / Produccion,/ AQP M / Existencias,07,Mineral con Contenido Aurifero y Argentifero sin Procesar,M0001,t,MINERAL AURIFERO Y ARGENTIFERO SIN PROCESAR,2018-12-31,2018-12-31,,MAMC-004237,,,MAMC-004237,,0,1.380000,0.000000,1030.8623188405797101,0,1422.5899999999999999380000,0.0000000000000000620000,0,"",241101 - Mineral Aurifero sin Procesar,,"",14079,,,,
Ubicaciones virtuales / Produccion,Physical Locations / AMCAQ / Existencias,/ AMCAQ / Existencias,08,Mineral con Contenido Aurifero y Argentifero sin Procesar,M0001,t,MINERAL AURIFERO Y ARGENTIFERO SIN PROCESAR,2018-12-31,2018-12-31,,PAMC004243,,,PAMC004243,,1.380000,0,1.380000,1301.2825821376811594,1795.76996335,0,1795.76996335,1301.2825821376811594,"",241101 - Mineral Aurifero sin Procesar,,"",14079,,,,
Ubicaciones virtuales / Transformacion Lote Trujillo,Physical Locations / AMCAQ / Existencias,/ AMCAQ / Existencias,06,Mineral con Contenido Aurifero y Argentifero sin Procesar,M0001,t,MINERAL AURIFERO Y ARGENTIFERO SIN PROCESAR,2018-12-15,2018-12-15,,ILT-000341,,,ILT-000341,NEGOCIOS ARGOS E.I.R.L.,3.879000,0,3.879000,2992.1367096055684455,11606.49829656,0,11606.49829656,2992.1367096055684455,"",241101 - Mineral Aurifero sin Procesar,,"",14080,,,2018-12-15,
Physical Locations / AMCTJ / Existencias,Ubicaciones virtuales / Transformacion Lote Trujillo,/ AMCTJ / Existencias,06,Mineral con Contenido Aurifero y Argentifero sin Procesar,M0001,t,MINERAL AURIFERO Y ARGENTIFERO SIN PROCESAR,2018-12-15,2018-12-15,,CLT-000326,,,CLT-000326,NEGOCIOS ARGOS E.I.R.L.,0,3.879000,-3.879000,0,0,0.000000,0.000000,0,"",241101 - Mineral Aurifero sin Procesar,0000 LOTES TRUJILLO,"",14080,,,2018-12-15,
Partner Locations / Suppliers,Physical Locations / AQP M / Existencias,/ AQP M / Existencias,03,Mineral con Contenido Aurifero y Argentifero sin Procesar,M0001,t,MINERAL AURIFERO Y ARGENTIFERO SIN PROCESAR,2018-12-15,2018-12-15,12/2018,AQP M\IN\04603,01,E001,0002284,COMUNIDAD CAMPESINA CHILLOROYA,2.032000,0,2.032000,226.6289370078740157,460.51,0,460.51,226.6289370078740157,602101 - Mineral Aurifero sin Procesar,241101 - Mineral Aurifero sin Procesar,,"",14081,18PO06716,,2018-12-15,
Physical Locations / AQP M / Existencias,Ubicaciones virtuales / Produccion,/ AQP M / Existencias,07,Mineral con Contenido Aurifero y Argentifero sin Procesar,M0001,t,MINERAL AURIFERO Y ARGENTIFERO SIN PROCESAR,2018-12-31,2018-12-31,,MAMC-004237,,,MAMC-004237,,0,2.032000,0.000000,226.6289370078740157,0,460.5099999999999999024000,0.0000000000000000976000,0,"",241101 - Mineral Aurifero sin Procesar,,"",14081,,,,
Ubicaciones virtuales / Produccion,Physical Locations / AMCAQ / Existencias,/ AMCAQ / Existencias,08,Mineral con Contenido Aurifero y Argentifero sin Procesar,M0001,t,MINERAL AURIFERO Y ARGENTIFERO SIN PROCESAR,2018-12-31,2018-12-31,,PAMC004243,,,PAMC004243,,2.032000,0,2.032000,497.0495123425196850,1010.00460908,0,1010.00460908,497.0495123425196850,"",241101 - Mineral Aurifero sin Procesar,,"",14081,,,,
Partner Locations / Suppliers,Physical Locations / AQP M / Existencias,/ AQP M / Existencias,03,Mineral con Contenido Aurifero y Argentifero sin Procesar,M0001,t,MINERAL AURIFERO Y ARGENTIFERO SIN PROCESAR,2018-12-15,2018-12-15,12/2018,AQP M\IN\04603,01,E001,0002284,COMUNIDAD CAMPESINA CHILLOROYA,4.875000,0,4.875000,409.9220512820512821,1998.37,0,1998.37,409.9220512820512821,602101 - Mineral Aurifero sin Procesar,241101 - Mineral Aurifero sin Procesar,,"",14082,18PO06716,,2018-12-15,
Physical Locations / AQP M / Existencias,Ubicaciones virtuales / Produccion,/ AQP M / Existencias,07,Mineral con Contenido Aurifero y Argentifero sin Procesar,M0001,t,MINERAL AURIFERO Y ARGENTIFERO SIN PROCESAR,2018-12-31,2018-12-31,,MAMC-004237,,,MAMC-004237,,0,4.875000,0.000000,409.9220512820512821,0,1998.3700000000000002375000,-0.0000000000000002375000,0,"",241101 - Mineral Aurifero sin Procesar,,"",14082,,,,
Ubicaciones virtuales / Produccion,Physical Locations / AMCAQ / Existencias,/ AMCAQ / Existencias,08,Mineral con Contenido Aurifero y Argentifero sin Procesar,M0001,t,MINERAL AURIFERO Y ARGENTIFERO SIN PROCESAR,2018-12-31,2018-12-31,,PAMC004243,,,PAMC004243,,4.875000,0,4.875000,680.3423260492307692,3316.66883949,0,3316.66883949,680.3423260492307692,"",241101 - Mineral Aurifero sin Procesar,,"",14082,,,,
Partner Locations / Suppliers,Physical Locations / AQP M / Existencias,/ AQP M / Existencias,03,Mineral con Contenido Aurifero y Argentifero sin Procesar,M0001,t,MINERAL AURIFERO Y ARGENTIFERO SIN PROCESAR,2018-12-15,2018-12-15,12/2018,AQP M\IN\04603,01,E001,0002284,COMUNIDAD CAMPESINA CHILLOROYA,2.292000,0,2.292000,817.6657940663176265,1874.09,0,1874.09,817.6657940663176265,602101 - Mineral Aurifero sin Procesar,241101 - Mineral Aurifero sin Procesar,,"",14083,18PO06716,,2018-12-15,
Physical Locations / AQP M / Existencias,Ubicaciones virtuales / Produccion,/ AQP M / Existencias,07,Mineral con Contenido Aurifero y Argentifero sin Procesar,M0001,t,MINERAL AURIFERO Y ARGENTIFERO SIN PROCESAR,2018-12-31,2018-12-31,,MAMC-004237,,,MAMC-004237,,0,2.292000,0.000000,817.6657940663176265,0,1874.0899999999999999380000,0.0000000000000000620000,0,"",241101 - Mineral Aurifero sin Procesar,,"",14083,,,,
Ubicaciones virtuales / Produccion,Physical Locations / AMCAQ / Existencias,/ AMCAQ / Existencias,08,Mineral con Contenido Aurifero y Argentifero sin Procesar,M0001,t,MINERAL AURIFERO Y ARGENTIFERO SIN PROCESAR,2018-12-31,2018-12-31,,PAMC004243,,,PAMC004243,,2.292000,0,2.292000,1088.0857681108202443,2493.89258051,0,2493.89258051,1088.0857681108202443,"",241101 - Mineral Aurifero sin Procesar,,"",14083,,,,
Partner Locations / Suppliers,Physical Locations / AQP M / Existencias,/ AQP M / Existencias,03,Mineral con Contenido Aurifero y Argentifero sin Procesar,M0001,t,MINERAL AURIFERO Y ARGENTIFERO SIN PROCESAR,2018-12-15,2018-12-15,12/2018,AQP M\IN\04603,01,E001,0002284,COMUNIDAD CAMPESINA CHILLOROYA,1.940000,0,1.940000,544.5876288659793814,1056.5,0,1056.5,544.5876288659793814,602101 - Mineral Aurifero sin Procesar,241101 - Mineral Aurifero sin Procesar,,"",14084,18PO06716,,2018-12-15,
Physical Locations / AQP M / Existencias,Ubicaciones virtuales / Produccion,/ AQP M / Existencias,07,Mineral con Contenido Aurifero y Argentifero sin Procesar,M0001,t,MINERAL AURIFERO Y ARGENTIFERO SIN PROCESAR,2018-12-31,2018-12-31,,MAMC-004237,,,MAMC-004237,,0,1.940000,0.000000,544.5876288659793814,0,1056.4999999999999999160000,0.0000000000000000840000,0,"",241101 - Mineral Aurifero sin Procesar,,"",14084,,,,
Ubicaciones virtuales / Produccion,Physical Locations / AMCAQ / Existencias,/ AMCAQ / Existencias,08,Mineral con Contenido Aurifero y Argentifero sin Procesar,M0001,t,MINERAL AURIFERO Y ARGENTIFERO SIN PROCESAR,2018-12-31,2018-12-31,,PAMC004243,,,PAMC004243,,1.940000,0,1.940000,815.0082264536082474,1581.11595932,0,1581.11595932,815.0082264536082474,"",241101 - Mineral Aurifero sin Procesar,,"",14084,,,,
Partner Locations / Suppliers,Physical Locations / AQP M / Existencias,/ AQP M / Existencias,03,Mineral con Contenido Aurifero y Argentifero sin Procesar,M0001,t,MINERAL AURIFERO Y ARGENTIFERO SIN PROCESAR,2018-12-15,2018-12-15,12/2018,AQP M\IN\04603,01,E001,0002284,COMUNIDAD CAMPESINA CHILLOROYA,3.270000,0,3.270000,181.7186544342507645,594.22,0,594.22,181.7186544342507645,602101 - Mineral Aurifero sin Procesar,241101 - Mineral Aurifero sin Procesar,,"",14085,18PO06716,,2018-12-15,
,,/ AQP M / Existencias,"",Mineral con Contenido Aurifero y Argentifero sin Procesar,"","",MINERAL AURIFERO Y ARGENTIFERO SIN PROCESAR,,2018-12-19,12/2018,,01,E001,0002285,COMUNIDAD CAMPESINA CHILLOROYA,0,0,3.270000,230.0366972477064220,158,0,752.22,230.0366972477064220,609201,241101 - Mineral Aurifero sin Procesar,"",,14085,,,,t
Physical Locations / AQP M / Existencias,Ubicaciones virtuales / Produccion,/ AQP M / Existencias,07,Mineral con Contenido Aurifero y Argentifero sin Procesar,M0001,t,MINERAL AURIFERO Y ARGENTIFERO SIN PROCESAR,2018-12-31,2018-12-31,,MAMC-004237,,,MAMC-004237,,0,3.270000,0.000000,230.0366972477064220,0,752.2199999999999999400000,0.0000000000000000600000,0,"",241101 - Mineral Aurifero sin Procesar,,"",14085,,,,
Ubicaciones virtuales / Produccion,Physical Locations / AMCAQ / Existencias,/ AMCAQ / Existencias,08,Mineral con Contenido Aurifero y Argentifero sin Procesar,M0001,t,MINERAL AURIFERO Y ARGENTIFERO SIN PROCESAR,2018-12-31,2018-12-31,,PAMC004243,,,PAMC004243,,3.270000,0,3.270000,500.4563498348623853,1636.49226396,0,1636.49226396,500.4563498348623853,"",241101 - Mineral Aurifero sin Procesar,,"",14085,,,,
Partner Locations / Suppliers,Physical Locations / AQP M / Existencias,/ AQP M / Existencias,03,Mineral con Contenido Aurifero y Argentifero sin Procesar,M0001,t,MINERAL AURIFERO Y ARGENTIFERO SIN PROCESAR,2018-12-15,2018-12-15,12/2018,AQP M\IN\04603,01,E001,0002284,COMUNIDAD CAMPESINA CHILLOROYA,3.908000,0,3.908000,335.0716479017400205,1309.46,0,1309.46,335.0716479017400205,602101 - Mineral Aurifero sin Procesar,241101 - Mineral Aurifero sin Procesar,,"",14086,18PO06716,,2018-12-15,
,,/ AQP M / Existencias,"",Mineral con Contenido Aurifero y Argentifero sin Procesar,"","",MINERAL AURIFERO Y ARGENTIFERO SIN PROCESAR,,2018-12-19,12/2018,,01,E001,0002285,COMUNIDAD CAMPESINA CHILLOROYA,0,0,3.908000,383.3188331627430911,188.55,0,1498.01,383.3188331627430911,609201,241101 - Mineral Aurifero sin Procesar,"",,14086,,,,t
Physical Locations / AQP M / Existencias,Ubicaciones virtuales / Produccion,/ AQP M / Existencias,07,Mineral con Contenido Aurifero y Argentifero sin Procesar,M0001,t,MINERAL AURIFERO Y ARGENTIFERO SIN PROCESAR,2018-12-31,2018-12-31,,MAMC-004237,,,MAMC-004237,,0,3.908000,0.000000,383.3188331627430911,0,1498.0100000000000000188000,-0.0000000000000000188000,0,"",241101 - Mineral Aurifero sin Procesar,,"",14086,,,,
Ubicaciones virtuales / Produccion,Physical Locations / AMCAQ / Existencias,/ AMCAQ / Existencias,08,Mineral con Contenido Aurifero y Argentifero sin Procesar,M0001,t,MINERAL AURIFERO Y ARGENTIFERO SIN PROCESAR,2018-12-31,2018-12-31,,PAMC004243,,,PAMC004243,,3.908000,0,3.908000,653.7392832113613101,2554.81311879,0,2554.81311879,653.7392832113613101,"",241101 - Mineral Aurifero sin Procesar,,"",14086,,,,
Partner Locations / Suppliers,Physical Locations / AQP M / Existencias,/ AQP M / Existencias,03,Mineral con Contenido Aurifero y Argentifero sin Procesar,M0001,t,MINERAL AURIFERO Y ARGENTIFERO SIN PROCESAR,2018-12-15,2018-12-15,12/2018,AQP M\IN\04603,01,E001,0002284,COMUNIDAD CAMPESINA CHILLOROYA,3.512000,0,3.512000,1004.6668564920273349,3528.39,0,3528.39,1004.6668564920273349,602101 - Mineral Aurifero sin Procesar,241101 - Mineral Aurifero sin Procesar,,"",14087,18PO06716,,2018-12-15,
Physical Locations / AQP M / Existencias,Ubicaciones virtuales / Produccion,/ AQP M / Existencias,07,Mineral con Contenido Aurifero y Argentifero sin Procesar,M0001,t,MINERAL AURIFERO Y ARGENTIFERO SIN PROCESAR,2018-12-31,2018-12-31,,MAMC-004237,,,MAMC-004237,,0,3.512000,0.000000,1004.6668564920273349,0,3528.3900000000000001688000,-0.0000000000000001688000,0,"",241101 - Mineral Aurifero sin Procesar,,"",14087,,,,
Ubicaciones virtuales / Produccion,Physical Locations / AMCAQ / Existencias,/ AMCAQ / Existencias,08,Mineral con Contenido Aurifero y Argentifero sin Procesar,M0001,t,MINERAL AURIFERO Y ARGENTIFERO SIN PROCESAR,2018-12-31,2018-12-31,,PAMC004243,,,PAMC004243,,3.512000,0,3.512000,1275.0871621611617312,4478.10611351,0,4478.10611351,1275.0871621611617312,"",241101 - Mineral Aurifero sin Procesar,,"",14087,,,,
Partner Locations / Suppliers,Physical Locations / AQP M / Existencias,/ AQP M / Existencias,03,Mineral con Contenido Aurifero y Argentifero sin Procesar,M0001,t,MINERAL AURIFERO Y ARGENTIFERO SIN PROCESAR,2018-12-15,2018-12-15,12/2018,AQP M\IN\04603,01,E001,0002284,COMUNIDAD CAMPESINA CHILLOROYA,2.669000,0,2.669000,600.6744098913450731,1603.2,0,1603.2,600.6744098913450731,602101 - Mineral Aurifero sin Procesar,241101 - Mineral Aurifero sin Procesar,,"",14088,18PO06716,,2018-12-15,
Physical Locations / AQP M / Existencias,Ubicaciones virtuales / Produccion,/ AQP M / Existencias,07,Mineral con Contenido Aurifero y Argentifero sin Procesar,M0001,t,MINERAL AURIFERO Y ARGENTIFERO SIN PROCESAR,2018-12-31,2018-12-31,,MAMC-004237,,,MAMC-004237,,0,2.669000,0.000000,600.6744098913450731,0,1603.2000000000000001039000,-0.0000000000000001039000,0,"",241101 - Mineral Aurifero sin Procesar,,"",14088,,,,
Ubicaciones virtuales / Produccion,Physical Locations / AMCAQ / Existencias,/ AMCAQ / Existencias,08,Mineral con Contenido Aurifero y Argentifero sin Procesar,M0001,t,MINERAL AURIFERO Y ARGENTIFERO SIN PROCESAR,2018-12-31,2018-12-31,,PAMC004243,,,PAMC004243,,2.669000,0,2.669000,871.0946549718995879,2324.95163412,0,2324.95163412,871.0946549718995879,"",241101 - Mineral Aurifero sin Procesar,,"",14088,,,,
Partner Locations / Suppliers,Physical Locations / AQP M / Existencias,/ AQP M / Existencias,03,Mineral con Contenido Aurifero y Argentifero sin Procesar,M0001,t,MINERAL AURIFERO Y ARGENTIFERO SIN PROCESAR,2018-12-15,2018-12-15,12/2018,AQP M\IN\04603,01,E001,0002284,COMUNIDAD CAMPESINA CHILLOROYA,1.831000,0,1.831000,207.9246313489896232,380.71,0,380.71,207.9246313489896232,602101 - Mineral Aurifero sin Procesar,241101 - Mineral Aurifero sin Procesar,,"",14089,18PO06716,,2018-12-15,
Physical Locations / AQP M / Existencias,Ubicaciones virtuales / Produccion,/ AQP M / Existencias,07,Mineral con Contenido Aurifero y Argentifero sin Procesar,M0001,t,MINERAL AURIFERO Y ARGENTIFERO SIN PROCESAR,2018-12-31,2018-12-31,,MAMC-004238,,,MAMC-004238,,0,1.831000,0.000000,207.9246313489896232,0,380.7100000000000000792000,-0.0000000000000000792000,0,"",241101 - Mineral Aurifero sin Procesar,,"",14089,,,,
Ubicaciones virtuales / Produccion,Physical Locations / AMCAQ / Existencias,/ AMCAQ / Existencias,08,Mineral con Contenido Aurifero y Argentifero sin Procesar,M0001,t,MINERAL AURIFERO Y ARGENTIFERO SIN PROCESAR,2018-12-31,2018-12-31,,PAMC004244,,,PAMC004244,,1.831000,0,1.831000,478.3452060021845986,875.85007219,0,875.85007219,478.3452060021845986,"",241101 - Mineral Aurifero sin Procesar,,"",14089,,,,
Partner Locations / Suppliers,Physical Locations / AQP M / Existencias,/ AQP M / Existencias,03,Mineral con Contenido Aurifero y Argentifero sin Procesar,M0001,t,MINERAL AURIFERO Y ARGENTIFERO SIN PROCESAR,2018-12-16,2018-12-16,12/2018,AQP M\IN\04592,01,E001,0000913,COMUNIDAD CAMPESINA DE UNTUCA,2.663000,0,2.663000,4931.1716109650769808,13131.71,0,13131.71,4931.1716109650769808,602101 - Mineral Aurifero sin Procesar,241101 - Mineral Aurifero sin Procesar,,"",14090,18PO06675,,2018-12-16,
Physical Locations / AQP M / Existencias,Ubicaciones virtuales / Produccion,/ AQP M / Existencias,07,Mineral con Contenido Aurifero y Argentifero sin Procesar,M0001,t,MINERAL AURIFERO Y ARGENTIFERO SIN PROCESAR,2018-12-31,2018-12-31,,MAMC-004238,,,MAMC-004238,,0,2.663000,0.000000,4931.1716109650769808,0,13131.7099999999999998704000,0.0000000000000001296000,0,"",241101 - Mineral Aurifero sin Procesar,,"",14090,,,,
Ubicaciones virtuales / Produccion,Physical Locations / AMCAQ / Existencias,/ AMCAQ / Existencias,08,Mineral con Contenido Aurifero y Argentifero sin Procesar,M0001,t,MINERAL AURIFERO Y ARGENTIFERO SIN PROCESAR,2018-12-31,2018-12-31,,PAMC004244,,,PAMC004244,,2.663000,0,2.663000,5201.5911203079233947,13851.83715338,0,13851.83715338,5201.5911203079233947,"",241101 - Mineral Aurifero sin Procesar,,"",14090,,,,
Partner Locations / Suppliers,Physical Locations / AQP M / Existencias,/ AQP M / Existencias,03,Mineral con Contenido Aurifero y Argentifero sin Procesar,M0001,t,MINERAL AURIFERO Y ARGENTIFERO SIN PROCESAR,2018-12-16,2018-12-16,12/2018,AQP M\IN\04592,01,E001,0000913,COMUNIDAD CAMPESINA DE UNTUCA,5.731000,0,5.731000,2093.3606700401326121,11997.05,0,11997.05,2093.3606700401326121,602101 - Mineral Aurifero sin Procesar,241101 - Mineral Aurifero sin Procesar,,"",14091,18PO06675,,2018-12-16,
Physical Locations / AQP M / Existencias,Ubicaciones virtuales / Produccion,/ AQP M / Existencias,07,Mineral con Contenido Aurifero y Argentifero sin Procesar,M0001,t,MINERAL AURIFERO Y ARGENTIFERO SIN PROCESAR,2018-12-31,2018-12-31,,MAMC-004238,,,MAMC-004238,,0,5.731000,0.000000,2093.3606700401326121,0,11997.0499999999999999451000,0.0000000000000000549000,0,"",241101 - Mineral Aurifero sin Procesar,,"",14091,,,,
Ubicaciones virtuales / Produccion,Physical Locations / AMCAQ / Existencias,/ AMCAQ / Existencias,08,Mineral con Contenido Aurifero y Argentifero sin Procesar,M0001,t,MINERAL AURIFERO Y ARGENTIFERO SIN PROCESAR,2018-12-31,2018-12-31,,PAMC004244,,,PAMC004244,,5.731000,0,5.731000,2363.7808403297853778,13546.82799593,0,13546.82799593,2363.7808403297853778,"",241101 - Mineral Aurifero sin Procesar,,"",14091,,,,
Partner Locations / Suppliers,Physical Locations / AQP M / Existencias,/ AQP M / Existencias,03,Mineral con Contenido Aurifero y Argentifero sin Procesar,M0001,t,MINERAL AURIFERO Y ARGENTIFERO SIN PROCESAR,2018-12-16,2018-12-16,12/2018,AQP M\IN\04592,01,E001,0000913,COMUNIDAD CAMPESINA DE UNTUCA,4.732000,0,4.732000,2414.3744716821639899,11424.82,0,11424.82,2414.3744716821639899,602101 - Mineral Aurifero sin Procesar,241101 - Mineral Aurifero sin Procesar,,"",14092,18PO06675,,2018-12-16,
Physical Locations / AQP M / Existencias,Ubicaciones virtuales / Produccion,/ AQP M / Existencias,07,Mineral con Contenido Aurifero y Argentifero sin Procesar,M0001,t,MINERAL AURIFERO Y ARGENTIFERO SIN PROCESAR,2018-12-31,2018-12-31,,MAMC-004238,,,MAMC-004238,,0,4.732000,0.000000,2414.3744716821639899,0,11424.8200000000000002068000,-0.0000000000000002068000,0,"",241101 - Mineral Aurifero sin Procesar,,"",14092,,,,
Ubicaciones virtuales / Produccion,Physical Locations / AMCAQ / Existencias,/ AMCAQ / Existencias,08,Mineral con Contenido Aurifero y Argentifero sin Procesar,M0001,t,MINERAL AURIFERO Y ARGENTIFERO SIN PROCESAR,2018-12-31,2018-12-31,,PAMC004244,,,PAMC004244,,4.732000,0,4.732000,2684.7946909509721048,12704.44847758,0,12704.44847758,2684.7946909509721048,"",241101 - Mineral Aurifero sin Procesar,,"",14092,,,,
Partner Locations / Suppliers,Physical Locations / AQP M / Existencias,/ AQP M / Existencias,03,Mineral con Contenido Aurifero y Argentifero sin Procesar,M0002,t,LLAMPO,2018-12-16,2018-12-16,12/2018,AQP M\IN\04592,01,E001,0000913,COMUNIDAD CAMPESINA DE UNTUCA,3.107000,0,3.107000,108.1783070485999356,336.11,0,336.11,108.1783070485999356,602101 - Mineral Aurifero sin Procesar,241101 - Mineral Aurifero sin Procesar,,"",14093,18PO06675,,2018-12-16,
Physical Locations / AQP M / Existencias,Ubicaciones virtuales / Produccion,/ AQP M / Existencias,07,Mineral con Contenido Aurifero y Argentifero sin Procesar,M0002,t,LLAMPO,2018-12-31,2018-12-31,,MAMC-004238,,,MAMC-004238,,0,3.107000,0.000000,108.1783070485999356,0,336.1099999999999999092000,0.0000000000000000908000,0,"",241101 - Mineral Aurifero sin Procesar,,"",14093,,,,
Ubicaciones virtuales / Produccion,Physical Locations / AMCAQ / Existencias,/ AMCAQ / Existencias,08,Mineral con Contenido Aurifero y Argentifero sin Procesar,M0002,t,LLAMPO,2018-12-31,2018-12-31,,PAMC004244,,,PAMC004244,,3.107000,0,3.107000,313.5438238043128420,974.18066056,0,974.18066056,313.5438238043128420,"",241101 - Mineral Aurifero sin Procesar,,"",14093,,,,
Partner Locations / Suppliers,Physical Locations / AQP M / Existencias,/ AQP M / Existencias,03,Mineral con Contenido Aurifero y Argentifero sin Procesar,M0001,t,MINERAL AURIFERO Y ARGENTIFERO SIN PROCESAR,2018-12-16,2018-12-16,12/2018,AQP M\IN\04592,01,E001,0000913,COMUNIDAD CAMPESINA DE UNTUCA,1.466000,0,1.466000,2215.8458390177353342,3248.43,0,3248.43,2215.8458390177353342,602101 - Mineral Aurifero sin Procesar,241101 - Mineral Aurifero sin Procesar,,"",14094,18PO06675,,2018-12-16,
Physical Locations / AQP M / Existencias,Ubicaciones virtuales / Produccion,/ AQP M / Existencias,07,Mineral con Contenido Aurifero y Argentifero sin Procesar,M0001,t,MINERAL AURIFERO Y ARGENTIFERO SIN PROCESAR,2018-12-31,2018-12-31,,MAMC-004238,,,MAMC-004238,,0,1.466000,0.000000,2215.8458390177353342,0,3248.4299999999999999372000,0.0000000000000000628000,0,"",241101 - Mineral Aurifero sin Procesar,,"",14094,,,,
Ubicaciones virtuales / Produccion,Physical Locations / AMCAQ / Existencias,/ AMCAQ / Existencias,08,Mineral con Contenido Aurifero y Argentifero sin Procesar,M0001,t,MINERAL AURIFERO Y ARGENTIFERO SIN PROCESAR,2018-12-31,2018-12-31,,PAMC004244,,,PAMC004244,,1.466000,0,1.466000,2486.2655787858117326,3644.8653385,0,3644.8653385,2486.2655787858117326,"",241101 - Mineral Aurifero sin Procesar,,"",14094,,,,
Partner Locations / Suppliers,Physical Locations / AQP M / Existencias,/ AQP M / Existencias,03,Mineral con Contenido Aurifero y Argentifero sin Procesar,M0002,t,LLAMPO,2018-12-16,2018-12-16,12/2018,AQP M\IN\04592,01,E001,0000913,COMUNIDAD CAMPESINA DE UNTUCA,1.786000,0,1.786000,374.9944008958566629,669.74,0,669.74,374.9944008958566629,602101 - Mineral Aurifero sin Procesar,241101 - Mineral Aurifero sin Procesar,,"",14095,18PO06675,,2018-12-16,
Physical Locations / AQP M / Existencias,Ubicaciones virtuales / Produccion,/ AQP M / Existencias,07,Mineral con Contenido Aurifero y Argentifero sin Procesar,M0002,t,LLAMPO,2018-12-31,2018-12-31,,MAMC-004238,,,MAMC-004238,,0,1.786000,0.000000,374.9944008958566629,0,669.7399999999999999394000,0.0000000000000000606000,0,"",241101 - Mineral Aurifero sin Procesar,,"",14095,,,,
Ubicaciones virtuales / Produccion,Physical Locations / AMCAQ / Existencias,/ AMCAQ / Existencias,08,Mineral con Contenido Aurifero y Argentifero sin Procesar,M0002,t,LLAMPO,2018-12-31,2018-12-31,,PAMC004244,,,PAMC004244,,1.786000,0,1.786000,580.3584631746920493,1036.52021523,0,1036.52021523,580.3584631746920493,"",241101 - Mineral Aurifero sin Procesar,,"",14095,,,,
Partner Locations / Suppliers,Physical Locations / AQP M / Existencias,/ AQP M / Existencias,03,Mineral con Contenido Aurifero y Argentifero sin Procesar,M0002,t,LLAMPO,2018-12-16,2018-12-16,12/2018,AQP M\IN\04592,01,E001,0000913,COMUNIDAD CAMPESINA DE UNTUCA,0.435000,0,0.435000,1552.9195402298850575,675.52,0,675.52,1552.9195402298850575,602101 - Mineral Aurifero sin Procesar,241101 - Mineral Aurifero sin Procesar,,"",14096,18PO06675,,2018-12-16,
Physical Locations / AQP M / Existencias,Ubicaciones virtuales / Produccion,/ AQP M / Existencias,07,Mineral con Contenido Aurifero y Argentifero sin Procesar,M0002,t,LLAMPO,2018-12-31,2018-12-31,,MAMC-004238,,,MAMC-004238,,0,0.430000,0.005000,1552.9195402298850575,0,667.7554022988505747250000,7.7645977011494252750000,1552.9195402298850575,"",241101 - Mineral Aurifero sin Procesar,,"",14096,,,,
Ubicaciones virtuales / Produccion,Physical Locations / AMCAQ / Existencias,/ AMCAQ / Existencias,08,Mineral con Contenido Aurifero y Argentifero sin Procesar,M0002,t,LLAMPO,2018-12-31,2018-12-31,,PAMC004244,,,PAMC004244,,0.430000,0,0.430000,1776.3412418372093023,763.82673399,0,763.82673399,1776.3412418372093023,"",241101 - Mineral Aurifero sin Procesar,,"",14096,,,,
Virtual Locations / Compras sin factura,Physical Locations / AQP M / Existencias,/ AQP M / Existencias,03,Mineral con Contenido Aurifero y Argentifero sin Procesar,M0002,t,LLAMPO,2018-12-16,2018-12-16,,AQP M\IN\04776,,,AQP M\IN\04776,E&F INVERSIONES MINERAS E.I.R.L.,1.160000,0,1.160000,0.02586206896551724138,0.03,0,0.03,0.02586206896551724138,"",241101 - Mineral Aurifero sin Procesar,,"",14097,,,2018-12-16,
Physical Locations / AQP M / Existencias,Ubicaciones virtuales / Produccion,/ AQP M / Existencias,07,Mineral con Contenido Aurifero y Argentifero sin Procesar,M0002,t,LLAMPO,2018-12-31,2018-12-31,,MAMC-004238,,,MAMC-004238,,0,1.160000,0.000000,0.02586206896551724138,0,0.03000000000000000000080000,-0.00000000000000000000080000,0,"",241101 - Mineral Aurifero sin Procesar,,"",14097,,,,
Ubicaciones virtuales / Produccion,Physical Locations / AMCAQ / Existencias,/ AMCAQ / Existencias,08,Mineral con Contenido Aurifero y Argentifero sin Procesar,M0002,t,LLAMPO,2018-12-31,2018-12-31,,PAMC004244,,,PAMC004244,,1.160000,0,1.160000,205.3904843879310345,238.25296189,0,238.25296189,205.3904843879310345,"",241101 - Mineral Aurifero sin Procesar,,"",14097,,,,
Virtual Locations / Compras sin factura,Physical Locations / AQP M / Existencias,/ AQP M / Existencias,03,Mineral con Contenido Aurifero y Argentifero sin Procesar,M0002,t,LLAMPO,2018-12-17,2018-12-17,,AQP M\IN\04777,,,AQP M\IN\04777,AUGUSTO GERMAN DEL CARPIO  ALVARADO,13.870000,0,13.870000,0.00000000000000000000,0,0,0,0.00000000000000000000,"",241101 - Mineral Aurifero sin Procesar,,"",14098,,,2018-12-17,
Physical Locations / AQP M / Existencias,Ubicaciones virtuales / Produccion,/ AQP M / Existencias,07,Mineral con Contenido Aurifero y Argentifero sin Procesar,M0002,t,LLAMPO,2018-12-31,2018-12-31,,MAMC-004238,,,MAMC-004238,,0,13.870000,0.000000,0.00000000000000000000,0,0.00000000000000000000000000,0.00000000000000000000000000,0,"",241101 - Mineral Aurifero sin Procesar,,"",14098,,,,
Ubicaciones virtuales / Produccion,Physical Locations / AMCAQ / Existencias,/ AMCAQ / Existencias,08,Mineral con Contenido Aurifero y Argentifero sin Procesar,M0002,t,LLAMPO,2018-12-31,2018-12-31,,PAMC004244,,,PAMC004244,,13.870000,0,13.870000,205.3649363114635905,2848.41166664,0,2848.41166664,205.3649363114635905,"",241101 - Mineral Aurifero sin Procesar,,"",14098,,,,
Virtual Locations / Compras sin factura,Physical Locations / AQP M / Existencias,/ AQP M / Existencias,03,Mineral con Contenido Aurifero y Argentifero sin Procesar,M0002,t,LLAMPO,2018-12-17,2018-12-17,,AQP M\IN\04777,,,AQP M\IN\04777,AUGUSTO GERMAN DEL CARPIO  ALVARADO,14.229000,0,14.229000,876.9744887202192705,12478.47,0,12478.47,876.9744887202192705,"",241101 - Mineral Aurifero sin Procesar,,"",14099,,,2018-12-17,
Physical Locations / AQP M / Existencias,Ubicaciones virtuales / Produccion,/ AQP M / Existencias,07,Mineral con Contenido Aurifero y Argentifero sin Procesar,M0002,t,LLAMPO,2018-12-31,2018-12-31,,MAMC-004239,,,MAMC-004239,,0,14.229000,0.000000,876.9744887202192705,0,12478.4699999999999999445000,0.0000000000000000555000,0,"",241101 - Mineral Aurifero sin Procesar,,"",14099,,,,
Ubicaciones virtuales / Produccion,Physical Locations / AMCAQ / Existencias,/ AMCAQ / Existencias,08,Mineral con Contenido Aurifero y Argentifero sin Procesar,M0002,t,LLAMPO,2018-12-31,2018-12-31,,PAMC004245,,,PAMC004245,,14.229000,0,14.229000,1082.3394348900133530,15400.60781905,0,15400.60781905,1082.3394348900133530,"",241101 - Mineral Aurifero sin Procesar,,"",14099,,,,
Partner Locations / Suppliers,Physical Locations / AQP M / Existencias,/ AQP M / Existencias,03,Mineral con Contenido Aurifero y Argentifero sin Procesar,M0002,t,LLAMPO,2018-12-17,2018-12-17,12/2018,AQP M\IN\04628,01,0003,0000138,OSWALDO Y LOS MELLIZOS E.I.R.L.,11.331000,0,11.331000,13107.248256994087,148518.23,0,148518.23,13107.248256994087,602101 - Mineral Aurifero sin Procesar,241101 - Mineral Aurifero sin Procesar,,"",14100,18PO06776,,2018-12-17,
Physical Locations / AQP M / Existencias,Ubicaciones virtuales / Produccion,/ AQP M / Existencias,07,Mineral con Contenido Aurifero y Argentifero sin Procesar,M0002,t,LLAMPO,2018-12-31,2018-12-31,,MAMC-004239,,,MAMC-004239,,0,11.331000,0.000000,13107.248256994087,0,148518.229999999999797000,0.000000000000203000,0,"",241101 - Mineral Aurifero sin Procesar,,"",14100,,,,
Ubicaciones virtuales / Produccion,Physical Locations / AMCAQ / Existencias,/ AMCAQ / Existencias,08,Mineral con Contenido Aurifero y Argentifero sin Procesar,M0002,t,LLAMPO,2018-12-31,2018-12-31,,PAMC004245,,,PAMC004245,,11.331000,0,11.331000,13312.613008252581,150845.21799651,0,150845.21799651,13312.613008252581,"",241101 - Mineral Aurifero sin Procesar,,"",14100,,,,
Partner Locations / Suppliers,Physical Locations / AQP M / Existencias,/ AQP M / Existencias,03,Mineral con Contenido Aurifero y Argentifero sin Procesar,M0002,t,LLAMPO,2018-12-17,2018-12-17,12/2018,AQP M\IN\04590,01,0002,0000128,LUIS GONZAGA VALDIVIA RANILLA,2.597000,0,2.597000,1224.1740469772814786,3179.18,0,3179.18,1224.1740469772814786,602101 - Mineral Aurifero sin Procesar,241101 - Mineral Aurifero sin Procesar,,"",14101,18PO06670,,2018-12-17,
Physical Locations / AQP M / Existencias,Ubicaciones virtuales / Produccion,/ AQP M / Existencias,07,Mineral con Contenido Aurifero y Argentifero sin Procesar,M0002,t,LLAMPO,2018-12-31,2018-12-31,,MAMC-004239,,,MAMC-004239,,0,2.597000,0.000000,1224.1740469772814786,0,3179.1799999999999999242000,0.0000000000000000758000,0,"",241101 - Mineral Aurifero sin Procesar,,"",14101,,,,
Ubicaciones virtuales / Produccion,Physical Locations / AMCAQ / Existencias,/ AMCAQ / Existencias,08,Mineral con Contenido Aurifero y Argentifero sin Procesar,M0002,t,LLAMPO,2018-12-31,2018-12-31,,PAMC004245,,,PAMC004245,,2.597000,0,2.597000,1429.5390058490566038,3712.51279819,0,3712.51279819,1429.5390058490566038,"",241101 - Mineral Aurifero sin Procesar,,"",14101,,,,
Partner Locations / Suppliers,Physical Locations / AQP M / Existencias,/ AQP M / Existencias,03,Mineral con Contenido Aurifero y Argentifero sin Procesar,M0002,t,LLAMPO,2018-12-17,2018-12-17,12/2018,AQP M\IN\04590,01,0002,0000128,LUIS GONZAGA VALDIVIA RANILLA,1.006000,0,1.006000,1334.3439363817097416,1342.35,0,1342.35,1334.3439363817097416,602101 - Mineral Aurifero sin Procesar,241101 - Mineral Aurifero sin Procesar,,"",14102,18PO06670,,2018-12-17,
Physical Locations / AQP M / Existencias,Ubicaciones virtuales / Produccion,/ AQP M / Existencias,07,Mineral con Contenido Aurifero y Argentifero sin Procesar,M0002,t,LLAMPO,2018-12-31,2018-12-31,,MAMC-004239,,,MAMC-004239,,0,1.006000,0.000000,1334.3439363817097416,0,1342.3500000000000000496000,-0.0000000000000000496000,0,"",241101 - Mineral Aurifero sin Procesar,,"",14102,,,,
Ubicaciones virtuales / Produccion,Physical Locations / AMCAQ / Existencias,/ AMCAQ / Existencias,08,Mineral con Contenido Aurifero y Argentifero sin Procesar,M0002,t,LLAMPO,2018-12-31,2018-12-31,,PAMC004245,,,PAMC004245,,1.006000,0,1.006000,1539.7096179324055666,1548.94787564,0,1548.94787564,1539.7096179324055666,"",241101 - Mineral Aurifero sin Procesar,,"",14102,,,,
Virtual Locations / Compras sin factura,Physical Locations / AQP M / Existencias,/ AQP M / Existencias,03,Mineral con Contenido Aurifero y Argentifero sin Procesar,M0001,t,MINERAL AURIFERO Y ARGENTIFERO SIN PROCESAR,2018-12-17,2018-12-17,,AQP M\IN\04778,,,AQP M\IN\04778,COMUNIDAD CAMPESINA CHILLOROYA,2.748000,0,2.748000,0.00000000000000000000,0,0,0,0.00000000000000000000,"",241101 - Mineral Aurifero sin Procesar,,"",14103,,,2018-12-17,
Physical Locations / AQP M / Existencias,Ubicaciones virtuales / Produccion,/ AQP M / Existencias,07,Mineral con Contenido Aurifero y Argentifero sin Procesar,M0001,t,MINERAL AURIFERO Y ARGENTIFERO SIN PROCESAR,2018-12-31,2018-12-31,,MAMC-004239,,,MAMC-004239,,0,2.748000,0.000000,0.00000000000000000000,0,0.00000000000000000000000000,0.00000000000000000000000000,0,"",241101 - Mineral Aurifero sin Procesar,,"",14103,,,,
Ubicaciones virtuales / Produccion,Physical Locations / AMCAQ / Existencias,/ AMCAQ / Existencias,08,Mineral con Contenido Aurifero y Argentifero sin Procesar,M0001,t,MINERAL AURIFERO Y ARGENTIFERO SIN PROCESAR,2018-12-31,2018-12-31,,PAMC004245,,,PAMC004245,,2.748000,0,2.748000,270.4209653966521106,743.11681291,0,743.11681291,270.4209653966521106,"",241101 - Mineral Aurifero sin Procesar,,"",14103,,,,
Virtual Locations / Compras sin factura,Physical Locations / AQP M / Existencias,/ AQP M / Existencias,03,Mineral con Contenido Aurifero y Argentifero sin Procesar,M0001,t,MINERAL AURIFERO Y ARGENTIFERO SIN PROCESAR,2018-12-18,2018-12-18,,AQP M\IN\04779,,,AQP M\IN\04779,COMUNIDAD CAMPESINA CHILLOROYA,2.689000,0,2.689000,0.00000000000000000000,0,0,0,0.00000000000000000000,"",241101 - Mineral Aurifero sin Procesar,,"",14104,,,2018-12-18,
Physical Locations / AQP M / Existencias,Ubicaciones virtuales / Produccion,/ AQP M / Existencias,07,Mineral con Contenido Aurifero y Argentifero sin Procesar,M0001,t,MINERAL AURIFERO Y ARGENTIFERO SIN PROCESAR,2018-12-31,2018-12-31,,MAMC-004239,,,MAMC-004239,,0,2.689000,0.000000,0.00000000000000000000,0,0.00000000000000000000000000,0.00000000000000000000000000,0,"",241101 - Mineral Aurifero sin Procesar,,"",14104,,,,
Ubicaciones virtuales / Produccion,Physical Locations / AMCAQ / Existencias,/ AMCAQ / Existencias,08,Mineral con Contenido Aurifero y Argentifero sin Procesar,M0001,t,MINERAL AURIFERO Y ARGENTIFERO SIN PROCESAR,2018-12-31,2018-12-31,,PAMC004245,,,PAMC004245,,2.689000,0,2.689000,270.4201955150613611,727.15990574,0,727.15990574,270.4201955150613611,"",241101 - Mineral Aurifero sin Procesar,,"",14104,,,,
Virtual Locations / Compras sin factura,Physical Locations / AQP M / Existencias,/ AQP M / Existencias,03,Mineral con Contenido Aurifero y Argentifero sin Procesar,M0001,t,MINERAL AURIFERO Y ARGENTIFERO SIN PROCESAR,2018-12-18,2018-12-18,,AQP M\IN\04779,,,AQP M\IN\04779,COMUNIDAD CAMPESINA CHILLOROYA,2.701000,0,2.701000,0.00000000000000000000,0,0,0,0.00000000000000000000,"",241101 - Mineral Aurifero sin Procesar,,"",14105,,,2018-12-18,
Physical Locations / AQP M / Existencias,Ubicaciones virtuales / Produccion,/ AQP M / Existencias,07,Mineral con Contenido Aurifero y Argentifero sin Procesar,M0001,t,MINERAL AURIFERO Y ARGENTIFERO SIN PROCESAR,2018-12-31,2018-12-31,,MAMC-004239,,,MAMC-004239,,0,2.701000,0.000000,0.00000000000000000000,0,0.00000000000000000000000000,0.00000000000000000000000000,0,"",241101 - Mineral Aurifero sin Procesar,,"",14105,,,,
Ubicaciones virtuales / Produccion,Physical Locations / AMCAQ / Existencias,/ AMCAQ / Existencias,08,Mineral con Contenido Aurifero y Argentifero sin Procesar,M0001,t,MINERAL AURIFERO Y ARGENTIFERO SIN PROCESAR,2018-12-31,2018-12-31,,PAMC004245,,,PAMC004245,,2.701000,0,2.701000,270.4199280525731211,730.40422567,0,730.40422567,270.4199280525731211,"",241101 - Mineral Aurifero sin Procesar,,"",14105,,,,
Virtual Locations / Compras sin factura,Physical Locations / AQP M / Existencias,/ AQP M / Existencias,03,Mineral con Contenido Aurifero y Argentifero sin Procesar,M0001,t,MINERAL AURIFERO Y ARGENTIFERO SIN PROCESAR,2018-12-18,2018-12-18,,AQP M\IN\04779,,,AQP M\IN\04779,COMUNIDAD CAMPESINA CHILLOROYA,3.146000,0,3.146000,143.7349014621741894,452.19,0,452.19,143.7349014621741894,"",241101 - Mineral Aurifero sin Procesar,,"",14106,,,2018-12-18,
Physical Locations / AQP M / Existencias,Ubicaciones virtuales / Produccion,/ AQP M / Existencias,07,Mineral con Contenido Aurifero y Argentifero sin Procesar,M0001,t,MINERAL AURIFERO Y ARGENTIFERO SIN PROCESAR,2018-12-31,2018-12-31,,MAMC-004239,,,MAMC-004239,,0,3.146000,0.000000,143.7349014621741894,0,452.1899999999999998524000,0.0000000000000001476000,0,"",241101 - Mineral Aurifero sin Procesar,,"",14106,,,,
Ubicaciones virtuales / Produccion,Physical Locations / AMCAQ / Existencias,/ AMCAQ / Existencias,08,Mineral con Contenido Aurifero y Argentifero sin Procesar,M0001,t,MINERAL AURIFERO Y ARGENTIFERO SIN PROCESAR,2018-12-31,2018-12-31,,PAMC004245,,,PAMC004245,,3.146000,0,3.146000,414.1548069485060394,1302.93102266,0,1302.93102266,414.1548069485060394,"",241101 - Mineral Aurifero sin Procesar,,"",14106,,,,
Virtual Locations / Compras sin factura,Physical Locations / AQP M / Existencias,/ AQP M / Existencias,03,Mineral con Contenido Aurifero y Argentifero sin Procesar,M0001,t,MINERAL AURIFERO Y ARGENTIFERO SIN PROCESAR,2018-12-18,2018-12-18,,AQP M\IN\04779,,,AQP M\IN\04779,COMUNIDAD CAMPESINA CHILLOROYA,2.830000,0,2.830000,0.00000000000000000000,0,0,0,0.00000000000000000000,"",241101 - Mineral Aurifero sin Procesar,,"",14107,,,2018-12-18,
Physical Locations / AQP M / Existencias,Ubicaciones virtuales / Produccion,/ AQP M / Existencias,07,Mineral con Contenido Aurifero y Argentifero sin Procesar,M0001,t,MINERAL AURIFERO Y ARGENTIFERO SIN PROCESAR,2018-12-31,2018-12-31,,MAMC-004239,,,MAMC-004239,,0,2.830000,0.000000,0.00000000000000000000,0,0.00000000000000000000000000,0.00000000000000000000000000,0,"",241101 - Mineral Aurifero sin Procesar,,"",14107,,,,
Ubicaciones virtuales / Produccion,Physical Locations / AMCAQ / Existencias,/ AMCAQ / Existencias,08,Mineral con Contenido Aurifero y Argentifero sin Procesar,M0001,t,MINERAL AURIFERO Y ARGENTIFERO SIN PROCESAR,2018-12-31,2018-12-31,,PAMC004245,,,PAMC004245,,2.830000,0,2.830000,270.4203500141342756,765.28959054,0,765.28959054,270.4203500141342756,"",241101 - Mineral Aurifero sin Procesar,,"",14107,,,,
Virtual Locations / Compras sin factura,Physical Locations / AQP M / Existencias,/ AQP M / Existencias,03,Mineral con Contenido Aurifero y Argentifero sin Procesar,M0001,t,MINERAL AURIFERO Y ARGENTIFERO SIN PROCESAR,2018-12-18,2018-12-18,,AQP M\IN\04779,,,AQP M\IN\04779,COMUNIDAD CAMPESINA CHILLOROYA,3.107000,0,3.107000,0.00000000000000000000,0,0,0,0.00000000000000000000,"",241101 - Mineral Aurifero sin Procesar,,"",14108,,,2018-12-18,
Physical Locations / AQP M / Existencias,Ubicaciones virtuales / Produccion,/ AQP M / Existencias,07,Mineral con Contenido Aurifero y Argentifero sin Procesar,M0001,t,MINERAL AURIFERO Y ARGENTIFERO SIN PROCESAR,2018-12-31,2018-12-31,,MAMC-004239,,,MAMC-004239,,0,3.107000,0.000000,0.00000000000000000000,0,0.00000000000000000000000000,0.00000000000000000000000000,0,"",241101 - Mineral Aurifero sin Procesar,,"",14108,,,,
Ubicaciones virtuales / Produccion,Physical Locations / AMCAQ / Existencias,/ AMCAQ / Existencias,08,Mineral con Contenido Aurifero y Argentifero sin Procesar,M0001,t,MINERAL AURIFERO Y ARGENTIFERO SIN PROCESAR,2018-12-31,2018-12-31,,PAMC004245,,,PAMC004245,,3.107000,0,3.107000,270.4206842195043450,840.19706587,0,840.19706587,270.4206842195043450,"",241101 - Mineral Aurifero sin Procesar,,"",14108,,,,
Virtual Locations / Compras sin factura,Physical Locations / AQP M / Existencias,/ AQP M / Existencias,03,Mineral con Contenido Aurifero y Argentifero sin Procesar,M0001,t,MINERAL AURIFERO Y ARGENTIFERO SIN PROCESAR,2018-12-18,2018-12-18,,AQP M\IN\04779,,,AQP M\IN\04779,COMUNIDAD CAMPESINA CHILLOROYA,3.243000,0,3.243000,0.00000000000000000000,0,0,0,0.00000000000000000000,"",241101 - Mineral Aurifero sin Procesar,,"",14109,,,2018-12-18,
Physical Locations / AQP M / Existencias,Ubicaciones virtuales / Produccion,/ AQP M / Existencias,07,Mineral con Contenido Aurifero y Argentifero sin Procesar,M0001,t,MINERAL AURIFERO Y ARGENTIFERO SIN PROCESAR,2018-12-31,2018-12-31,,MAMC-004240,,,MAMC-004240,,0,3.243000,0.000000,0.00000000000000000000,0,0.00000000000000000000000000,0.00000000000000000000000000,0,"",241101 - Mineral Aurifero sin Procesar,,"",14109,,,,
Ubicaciones virtuales / Produccion,Physical Locations / AMCAQ / Existencias,/ AMCAQ / Existencias,08,Mineral con Contenido Aurifero y Argentifero sin Procesar,M0001,t,MINERAL AURIFERO Y ARGENTIFERO SIN PROCESAR,2018-12-31,2018-12-31,,PAMC004246,,,PAMC004246,,3.243000,0,3.243000,270.4201748689485045,876.9726271,0,876.9726271,270.4201748689485045,"",241101 - Mineral Aurifero sin Procesar,,"",14109,,,,
Partner Locations / Suppliers,Physical Locations / AQP M / Existencias,/ AQP M / Existencias,03,Mineral con Contenido Aurifero y Argentifero sin Procesar,M0002,t,LLAMPO,2018-12-18,2018-12-18,12/2018,AQP M\IN\04631,01,0001,0000565,MIRIAN MARIA CHICATA CAMACHO,14.594000,0,14.594000,1161.9754693709743730,16957.87,0,16957.87,1161.9754693709743730,602101 - Mineral Aurifero sin Procesar,241101 - Mineral Aurifero sin Procesar,,"",14110,18PO06783,,2018-12-18,
Physical Locations / AQP M / Existencias,Ubicaciones virtuales / Produccion,/ AQP M / Existencias,07,Mineral con Contenido Aurifero y Argentifero sin Procesar,M0002,t,LLAMPO,2018-12-31,2018-12-31,,MAMC-004240,,,MAMC-004240,,0,14.594000,0.000000,1161.9754693709743730,0,16957.8699999999999995620000,0.0000000000000004380000,0,"",241101 - Mineral Aurifero sin Procesar,,"",14110,,,,
Ubicaciones virtuales / Produccion,Physical Locations / AMCAQ / Existencias,/ AMCAQ / Existencias,08,Mineral con Contenido Aurifero y Argentifero sin Procesar,M0002,t,LLAMPO,2018-12-31,2018-12-31,,PAMC004246,,,PAMC004246,,14.594000,0,14.594000,1367.3402903028641908,19954.96419668,0,19954.96419668,1367.3402903028641908,"",241101 - Mineral Aurifero sin Procesar,,"",14110,,,,
Partner Locations / Suppliers,Physical Locations / AQP M / Existencias,/ AQP M / Existencias,03,Mineral con Contenido Aurifero y Argentifero sin Procesar,M0002,t,LLAMPO,2018-12-19,2018-12-19,12/2018,AQP M\IN\04640,01,0001,0000567,MIRIAN MARIA CHICATA CAMACHO,4.347000,0,4.347000,499.2201518288474810,2170.11,0,2170.11,499.2201518288474810,602101 - Mineral Aurifero sin Procesar,241101 - Mineral Aurifero sin Procesar,,"",14111,18PO06820,,2018-12-19,
Physical Locations / AQP M / Existencias,Ubicaciones virtuales / Produccion,/ AQP M / Existencias,07,Mineral con Contenido Aurifero y Argentifero sin Procesar,M0002,t,LLAMPO,2018-12-31,2018-12-31,,MAMC-004240,,,MAMC-004240,,0,4.347000,0.000000,499.2201518288474810,0,2170.1099999999999999070000,0.0000000000000000930000,0,"",241101 - Mineral Aurifero sin Procesar,,"",14111,,,,
Ubicaciones virtuales / Produccion,Physical Locations / AMCAQ / Existencias,/ AMCAQ / Existencias,08,Mineral con Contenido Aurifero y Argentifero sin Procesar,M0002,t,LLAMPO,2018-12-31,2018-12-31,,PAMC004246,,,PAMC004246,,4.347000,0,4.347000,704.5847962479871176,3062.83010929,0,3062.83010929,704.5847962479871176,"",241101 - Mineral Aurifero sin Procesar,,"",14111,,,,
,,/ AQP M / Existencias,"",Mineral con Contenido Aurifero y Argentifero sin Procesar,"","",MINERAL AURIFERO Y ARGENTIFERO SIN PROCESAR,,2018-12-27,12/2018,,08,0001,0000059,MIRIAN MARIA CHICATA CAMACHO,0,0,0,0,554.74,0,554.74,0,602101,241101 - Mineral Aurifero sin Procesar,"",,14112,,,,f
Partner Locations / Suppliers,Physical Locations / AQP M / Existencias,/ AQP M / Existencias,03,Mineral con Contenido Aurifero y Argentifero sin Procesar,M0002,t,LLAMPO,2018-12-18,2018-12-18,12/2018,AQP M\IN\04630,01,0001,0000563,MIRIAN MARIA CHICATA CAMACHO,4.411000,0,4.411000,854.7721605078213557,3770.4,0,4325.14,980.5350260711856722,602101 - Mineral Aurifero sin Procesar,241101 - Mineral Aurifero sin Procesar,,"",14112,18PO06780,,2018-12-18,
Physical Locations / AQP M / Existencias,Ubicaciones virtuales / Produccion,/ AQP M / Existencias,07,Mineral con Contenido Aurifero y Argentifero sin Procesar,M0002,t,LLAMPO,2018-12-31,2018-12-31,,MAMC-004240,,,MAMC-004240,,0,4.411000,0.000000,980.5350260711856722,0,4325.1400000000000000742000,-0.0000000000000000742000,0,"",241101 - Mineral Aurifero sin Procesar,,"",14112,,,,
Ubicaciones virtuales / Produccion,Physical Locations / AMCAQ / Existencias,/ AMCAQ / Existencias,08,Mineral con Contenido Aurifero y Argentifero sin Procesar,M0002,t,LLAMPO,2018-12-31,2018-12-31,,PAMC004246,,,PAMC004246,,4.411000,0,4.411000,1185.9000768442530039,5231.00523896,0,5231.00523896,1185.9000768442530039,"",241101 - Mineral Aurifero sin Procesar,,"",14112,,,,
Partner Locations / Suppliers,Physical Locations / AQP M / Existencias,/ AQP M / Existencias,03,Mineral con Contenido Aurifero y Argentifero sin Procesar,M0002,t,LLAMPO,2018-12-18,2018-12-18,12/2018,AQP M\IN\04615,01,0001,0000562,MIRIAN MARIA CHICATA CAMACHO,12.478000,0,12.478000,645.6267029972752044,8056.13,0,8056.13,645.6267029972752044,602101 - Mineral Aurifero sin Procesar,241101 - Mineral Aurifero sin Procesar,,"",14113,18PO06741,,2018-12-18,
Physical Locations / AQP M / Existencias,Ubicaciones virtuales / Produccion,/ AQP M / Existencias,07,Mineral con Contenido Aurifero y Argentifero sin Procesar,M0002,t,LLAMPO,2018-12-31,2018-12-31,,MAMC-004240,,,MAMC-004240,,0,12.478000,0.000000,645.6267029972752044,0,8056.1300000000000005032000,-0.0000000000000005032000,0,"",241101 - Mineral Aurifero sin Procesar,,"",14113,,,,
Ubicaciones virtuales / Produccion,Physical Locations / AMCAQ / Existencias,/ AMCAQ / Existencias,08,Mineral con Contenido Aurifero y Argentifero sin Procesar,M0002,t,LLAMPO,2018-12-31,2018-12-31,,PAMC004246,,,PAMC004246,,12.478000,0,12.478000,850.9914897122936368,10618.67180863,0,10618.67180863,850.9914897122936368,"",241101 - Mineral Aurifero sin Procesar,,"",14113,,,,
Virtual Locations / Compras sin factura,Physical Locations / AQP M / Existencias,/ AQP M / Existencias,03,Mineral con Contenido Aurifero y Argentifero sin Procesar,M0001,t,MINERAL AURIFERO Y ARGENTIFERO SIN PROCESAR,2018-12-19,2018-12-19,,AQP M\IN\04746,,,AQP M\IN\04746,OSCAR EMERSON CASTILLO VILELA,29.977000,0,29.977000,2578.5552256730159789,77297.35,0,77297.35,2578.5552256730159789,"",241101 - Mineral Aurifero sin Procesar,,"",14114,,,2018-12-19,
Physical Locations / AQP M / Existencias,Ubicaciones virtuales / Produccion,/ AQP M / Existencias,07,Mineral con Contenido Aurifero y Argentifero sin Procesar,M0001,t,MINERAL AURIFERO Y ARGENTIFERO SIN PROCESAR,2018-12-31,2018-12-31,,MAMC-004240,,,MAMC-004240,,0,29.977000,0.000000,2578.5552256730159789,0,77297.3499999999999994853000,0.0000000000000005147000,0,"",241101 - Mineral Aurifero sin Procesar,,"",14114,,,,
Ubicaciones virtuales / Produccion,Physical Locations / AMCAQ / Existencias,/ AMCAQ / Existencias,08,Mineral con Contenido Aurifero y Argentifero sin Procesar,M0001,t,MINERAL AURIFERO Y ARGENTIFERO SIN PROCESAR,2018-12-31,2018-12-31,,PAMC004246,,,PAMC004246,,29.977000,0,29.977000,2780.6884528671981853,83356.6977516,0,83356.6977516,2780.6884528671981853,"",241101 - Mineral Aurifero sin Procesar,,"",14114,,,,
Partner Locations / Suppliers,Physical Locations / AQP M / Existencias,/ AQP M / Existencias,03,Mineral con Contenido Aurifero y Argentifero sin Procesar,M0002,t,LLAMPO,2018-12-18,2018-12-18,12/2018,AQP M\IN\04615,01,0001,0000562,MIRIAN MARIA CHICATA CAMACHO,12.512000,0,12.512000,700.8304028132992327,8768.79,0,8768.79,700.8304028132992327,602101 - Mineral Aurifero sin Procesar,241101 - Mineral Aurifero sin Procesar,,"",14115,18PO06741,,2018-12-18,
Physical Locations / AQP M / Existencias,Ubicaciones virtuales / Produccion,/ AQP M / Existencias,07,Mineral con Contenido Aurifero y Argentifero sin Procesar,M0002,t,LLAMPO,2018-12-31,2018-12-31,,MAMC-004240,,,MAMC-004240,,0,12.512000,0.000000,700.8304028132992327,0,8768.7899999999999995424000,0.0000000000000004576000,0,"",241101 - Mineral Aurifero sin Procesar,,"",14115,,,,
Ubicaciones virtuales / Produccion,Physical Locations / AMCAQ / Existencias,/ AMCAQ / Existencias,08,Mineral con Contenido Aurifero y Argentifero sin Procesar,M0002,t,LLAMPO,2018-12-31,2018-12-31,,PAMC004246,,,PAMC004246,,12.512000,0,12.512000,906.1953774896099744,11338.31656315,0,11338.31656315,906.1953774896099744,"",241101 - Mineral Aurifero sin Procesar,,"",14115,,,,
Partner Locations / Suppliers,Physical Locations / AQP M / Existencias,/ AQP M / Existencias,03,Mineral con Contenido Aurifero y Argentifero sin Procesar,M0001,t,MINERAL AURIFERO Y ARGENTIFERO SIN PROCESAR,2018-12-18,2018-12-18,12/2018,AQP M\IN\04632,01,0004,0000243,HELARD MANUEL BELLIDO PERLACIO,1.628000,0,1.628000,4423.4828009828009828,7201.43,0,7201.43,4423.4828009828009828,602101 - Mineral Aurifero sin Procesar,241101 - Mineral Aurifero sin Procesar,,"",14116,18PO06784,,2018-12-18,
Physical Locations / AQP M / Existencias,Ubicaciones virtuales / Produccion,/ AQP M / Existencias,07,Mineral con Contenido Aurifero y Argentifero sin Procesar,M0001,t,MINERAL AURIFERO Y ARGENTIFERO SIN PROCESAR,2018-12-31,2018-12-31,,MAMC-004240,,,MAMC-004240,,0,1.628000,0.000000,4423.4828009828009828,0,7201.4299999999999999984000,0.0000000000000000016000,0,"",241101 - Mineral Aurifero sin Procesar,,"",14116,,,,
Ubicaciones virtuales / Produccion,Physical Locations / AMCAQ / Existencias,/ AMCAQ / Existencias,08,Mineral con Contenido Aurifero y Argentifero sin Procesar,M0001,t,MINERAL AURIFERO Y ARGENTIFERO SIN PROCESAR,2018-12-31,2018-12-31,,PAMC004246,,,PAMC004246,,1.628000,0,1.628000,4693.9027346928746929,7641.67365208,0,7641.67365208,4693.9027346928746929,"",241101 - Mineral Aurifero sin Procesar,,"",14116,,,,
Partner Locations / Suppliers,Physical Locations / AQP M / Existencias,/ AQP M / Existencias,03,Mineral con Contenido Aurifero y Argentifero sin Procesar,M0001,t,MINERAL AURIFERO Y ARGENTIFERO SIN PROCESAR,2018-12-18,2018-12-18,12/2018,AQP M\IN\04632,01,0004,0000243,HELARD MANUEL BELLIDO PERLACIO,3.874000,0,3.874000,1860.9344346928239546,7209.26,0,7209.26,1860.9344346928239546,602101 - Mineral Aurifero sin Procesar,241101 - Mineral Aurifero sin Procesar,,"",14117,18PO06784,,2018-12-18,
Physical Locations / AQP M / Existencias,Ubicaciones virtuales / Produccion,/ AQP M / Existencias,07,Mineral con Contenido Aurifero y Argentifero sin Procesar,M0001,t,MINERAL AURIFERO Y ARGENTIFERO SIN PROCESAR,2018-12-31,2018-12-31,,MAMC-004240,,,MAMC-004240,,0,3.874000,0.000000,1860.9344346928239546,0,7209.2600000000000001204000,-0.0000000000000001204000,0,"",241101 - Mineral Aurifero sin Procesar,,"",14117,,,,
Ubicaciones virtuales / Produccion,Physical Locations / AMCAQ / Existencias,/ AMCAQ / Existencias,08,Mineral con Contenido Aurifero y Argentifero sin Procesar,M0001,t,MINERAL AURIFERO Y ARGENTIFERO SIN PROCESAR,2018-12-31,2018-12-31,,PAMC004246,,,PAMC004246,,3.874000,0,3.874000,2131.3548384202374806,8256.86864404,0,8256.86864404,2131.3548384202374806,"",241101 - Mineral Aurifero sin Procesar,,"",14117,,,,
Partner Locations / Suppliers,Physical Locations / AQP M / Existencias,/ AQP M / Existencias,03,Mineral con Contenido Aurifero y Argentifero sin Procesar,M0001,t,MINERAL AURIFERO Y ARGENTIFERO SIN PROCESAR,2018-12-18,2018-12-18,12/2018,AQP M\IN\04632,01,0004,0000243,HELARD MANUEL BELLIDO PERLACIO,2.449000,0,2.449000,1009.4038383013474888,2472.03,0,2472.03,1009.4038383013474888,602101 - Mineral Aurifero sin Procesar,241101 - Mineral Aurifero sin Procesar,,"",14118,18PO06784,,2018-12-18,
Physical Locations / AQP M / Existencias,Ubicaciones virtuales / Produccion,/ AQP M / Existencias,07,Mineral con Contenido Aurifero y Argentifero sin Procesar,M0001,t,MINERAL AURIFERO Y ARGENTIFERO SIN PROCESAR,2018-12-31,2018-12-31,,MAMC-004240,,,MAMC-004240,,0,2.449000,0.000000,1009.4038383013474888,0,2472.0300000000000000712000,-0.0000000000000000712000,0,"",241101 - Mineral Aurifero sin Procesar,,"",14118,,,,
Ubicaciones virtuales / Produccion,Physical Locations / AMCAQ / Existencias,/ AMCAQ / Existencias,08,Mineral con Contenido Aurifero y Argentifero sin Procesar,M0001,t,MINERAL AURIFERO Y ARGENTIFERO SIN PROCESAR,2018-12-31,2018-12-31,,PAMC004246,,,PAMC004246,,2.449000,0,2.449000,1279.8235767333605553,3134.28793942,0,3134.28793942,1279.8235767333605553,"",241101 - Mineral Aurifero sin Procesar,,"",14118,,,,
Partner Locations / Suppliers,Physical Locations / AQP M / Existencias,/ AQP M / Existencias,03,Mineral con Contenido Aurifero y Argentifero sin Procesar,M0002,t,LLAMPO,2018-12-18,2018-12-18,12/2018,AQP M\IN\04633,01,E001,0000375,INVERSIONES VALEDANA E.I.R.L.,3.647000,0,3.647000,1027.1620510008225939,3746.06,0,3746.06,1027.1620510008225939,602101 - Mineral Aurifero sin Procesar,241101 - Mineral Aurifero sin Procesar,,"",14119,18PO06785,,2018-12-18,
Physical Locations / AQP M / Existencias,Ubicaciones virtuales / Produccion,/ AQP M / Existencias,07,Mineral con Contenido Aurifero y Argentifero sin Procesar,M0002,t,LLAMPO,2018-12-31,2018-12-31,,MAMC-004241,,,MAMC-004241,,0,3.647000,0.000000,1027.1620510008225939,0,3746.0599999999999999533000,0.0000000000000000467000,0,"",241101 - Mineral Aurifero sin Procesar,,"",14119,,,,
Ubicaciones virtuales / Produccion,Physical Locations / AMCAQ / Existencias,/ AMCAQ / Existencias,08,Mineral con Contenido Aurifero y Argentifero sin Procesar,M0002,t,LLAMPO,2018-12-31,2018-12-31,,PAMC004247,,,PAMC004247,,3.647000,0,3.647000,1232.5265304469426926,4495.02425654,0,4495.02425654,1232.5265304469426926,"",241101 - Mineral Aurifero sin Procesar,,"",14119,,,,
Partner Locations / Suppliers,Physical Locations / AQP M / Existencias,/ AQP M / Existencias,03,Mineral con Contenido Aurifero y Argentifero sin Procesar,M0002,t,LLAMPO,2018-12-18,2018-12-18,12/2018,AQP M\IN\04633,01,E001,0000375,INVERSIONES VALEDANA E.I.R.L.,9.531000,0,9.531000,1279.4984786486202917,12194.9,0,12194.9,1279.4984786486202917,602101 - Mineral Aurifero sin Procesar,241101 - Mineral Aurifero sin Procesar,,"",14120,18PO06785,,2018-12-18,
Physical Locations / AQP M / Existencias,Ubicaciones virtuales / Produccion,/ AQP M / Existencias,07,Mineral con Contenido Aurifero y Argentifero sin Procesar,M0002,t,LLAMPO,2018-12-31,2018-12-31,,MAMC-004241,,,MAMC-004241,,0,9.531000,0.000000,1279.4984786486202917,0,12194.9000000000000001927000,-0.0000000000000001927000,0,"",241101 - Mineral Aurifero sin Procesar,,"",14120,,,,
Ubicaciones virtuales / Produccion,Physical Locations / AMCAQ / Existencias,/ AMCAQ / Existencias,08,Mineral con Contenido Aurifero y Argentifero sin Procesar,M0002,t,LLAMPO,2018-12-31,2018-12-31,,PAMC004247,,,PAMC004247,,9.531000,0,9.531000,1484.8633129724058336,14152.23223594,0,14152.23223594,1484.8633129724058336,"",241101 - Mineral Aurifero sin Procesar,,"",14120,,,,
Partner Locations / Suppliers,Physical Locations / AQP M / Existencias,/ AQP M / Existencias,03,Mineral con Contenido Aurifero y Argentifero sin Procesar,M0002,t,LLAMPO,2018-12-18,2018-12-18,12/2018,AQP M\IN\04633,01,E001,0000375,INVERSIONES VALEDANA E.I.R.L.,10.722000,0,10.722000,770.7974258533855624,8264.49,0,8264.49,770.7974258533855624,602101 - Mineral Aurifero sin Procesar,241101 - Mineral Aurifero sin Procesar,,"",14121,18PO06785,,2018-12-18,
Physical Locations / AQP M / Existencias,Ubicaciones virtuales / Produccion,/ AQP M / Existencias,07,Mineral con Contenido Aurifero y Argentifero sin Procesar,M0002,t,LLAMPO,2018-12-31,2018-12-31,,MAMC-004241,,,MAMC-004241,,0,10.722000,0.000000,770.7974258533855624,0,8264.4900000000000000528000,-0.0000000000000000528000,0,"",241101 - Mineral Aurifero sin Procesar,,"",14121,,,,
Ubicaciones virtuales / Produccion,Physical Locations / AMCAQ / Existencias,/ AMCAQ / Existencias,08,Mineral con Contenido Aurifero y Argentifero sin Procesar,M0002,t,LLAMPO,2018-12-31,2018-12-31,,PAMC004247,,,PAMC004247,,10.722000,0,10.722000,976.1621712049990673,10466.41079966,0,10466.41079966,976.1621712049990673,"",241101 - Mineral Aurifero sin Procesar,,"",14121,,,,
Partner Locations / Suppliers,Physical Locations / AQP M / Existencias,/ AQP M / Existencias,03,Mineral con Contenido Aurifero y Argentifero sin Procesar,M0002,t,LLAMPO,2018-12-19,2018-12-19,12/2018,AQP M\IN\04642,01,0001,0000066,ALEX RELY CHOCRE CHARCCAHUANA,5.250000,0,5.250000,1872.3923809523809524,9830.06,0,9830.06,1872.3923809523809524,602101 - Mineral Aurifero sin Procesar,241101 - Mineral Aurifero sin Procesar,,"",14122,18PO06827,,2018-12-19,
Physical Locations / AQP M / Existencias,Ubicaciones virtuales / Produccion,/ AQP M / Existencias,07,Mineral con Contenido Aurifero y Argentifero sin Procesar,M0002,t,LLAMPO,2018-12-31,2018-12-31,,MAMC-004241,,,MAMC-004241,,0,5.250000,0.000000,1872.3923809523809524,0,9830.0600000000000001000000,-0.0000000000000001000000,0,"",241101 - Mineral Aurifero sin Procesar,,"",14122,,,,
Ubicaciones virtuales / Produccion,Physical Locations / AMCAQ / Existencias,/ AMCAQ / Existencias,08,Mineral con Contenido Aurifero y Argentifero sin Procesar,M0002,t,LLAMPO,2018-12-31,2018-12-31,,PAMC004247,,,PAMC004247,,5.250000,0,5.250000,2077.7572201790476190,10908.22540594,0,10908.22540594,2077.7572201790476190,"",241101 - Mineral Aurifero sin Procesar,,"",14122,,,,
Partner Locations / Suppliers,Physical Locations / AQP M / Existencias,/ AQP M / Existencias,03,Mineral con Contenido Aurifero y Argentifero sin Procesar,M0001,t,MINERAL AURIFERO Y ARGENTIFERO SIN PROCESAR,2018-12-19,2018-12-19,12/2018,AQP M\IN\04614,01,0001,0000030,EDIZON AQUIMA ARIAS,4.375000,0,4.375000,853.3394285714285714,3733.36,0,3733.36,853.3394285714285714,602101 - Mineral Aurifero sin Procesar,241101 - Mineral Aurifero sin Procesar,,"",14123,18PO06740,,2018-12-19,
Physical Locations / AQP M / Existencias,Ubicaciones virtuales / Produccion,/ AQP M / Existencias,07,Mineral con Contenido Aurifero y Argentifero sin Procesar,M0001,t,MINERAL AURIFERO Y ARGENTIFERO SIN PROCESAR,2018-12-31,2018-12-31,,MAMC-004241,,,MAMC-004241,,0,4.375000,0.000000,853.3394285714285714,0,3733.3599999999999998750000,0.0000000000000001250000,0,"",241101 - Mineral Aurifero sin Procesar,,"",14123,,,,
Ubicaciones virtuales / Produccion,Physical Locations / AMCAQ / Existencias,/ AMCAQ / Existencias,08,Mineral con Contenido Aurifero y Argentifero sin Procesar,M0001,t,MINERAL AURIFERO Y ARGENTIFERO SIN PROCESAR,2018-12-31,2018-12-31,,PAMC004247,,,PAMC004247,,4.375000,0,4.375000,1123.7597489645714286,4916.44890172,0,4916.44890172,1123.7597489645714286,"",241101 - Mineral Aurifero sin Procesar,,"",14123,,,,
Partner Locations / Suppliers,Physical Locations / AQP M / Existencias,/ AQP M / Existencias,03,Mineral con Contenido Aurifero y Argentifero sin Procesar,M0001,t,MINERAL AURIFERO Y ARGENTIFERO SIN PROCESAR,2018-12-19,2018-12-19,12/2018,AQP M\IN\04614,01,0001,0000030,EDIZON AQUIMA ARIAS,7.097000,0,7.097000,1159.3391573904466676,8227.83,0,8227.83,1159.3391573904466676,602101 - Mineral Aurifero sin Procesar,241101 - Mineral Aurifero sin Procesar,,"",14124,18PO06740,,2018-12-19,
Physical Locations / AQP M / Existencias,Ubicaciones virtuales / Produccion,/ AQP M / Existencias,07,Mineral con Contenido Aurifero y Argentifero sin Procesar,M0001,t,MINERAL AURIFERO Y ARGENTIFERO SIN PROCESAR,2018-12-31,2018-12-31,,MAMC-004241,,,MAMC-004241,,0,7.097000,0.000000,1159.3391573904466676,0,8227.8299999999999999572000,0.0000000000000000428000,0,"",241101 - Mineral Aurifero sin Procesar,,"",14124,,,,
Ubicaciones virtuales / Produccion,Physical Locations / AMCAQ / Existencias,/ AMCAQ / Existencias,08,Mineral con Contenido Aurifero y Argentifero sin Procesar,M0001,t,MINERAL AURIFERO Y ARGENTIFERO SIN PROCESAR,2018-12-31,2018-12-31,,PAMC004247,,,PAMC004247,,7.097000,0,7.097000,1429.7594705213470480,10147.00296229,0,10147.00296229,1429.7594705213470480,"",241101 - Mineral Aurifero sin Procesar,,"",14124,,,,
Partner Locations / Suppliers,Physical Locations / AQP M / Existencias,/ AQP M / Existencias,03,Mineral con Contenido Aurifero y Argentifero sin Procesar,M0002,t,LLAMPO,2018-12-19,2018-12-19,12/2018,AQP M\IN\04620,01,0001,0000014,MINING BOBADILLA EXPLORER EMPRESA INDIVIDUAL DE RESPONSABILIDAD LIMITADA,0.810000,0,0.810000,2022.5925925925925926,1638.3,0,1638.3,2022.5925925925925926,602101 - Mineral Aurifero sin Procesar,241101 - Mineral Aurifero sin Procesar,,"",14125,18PO06759,,2018-12-19,
Physical Locations / AQP M / Existencias,Ubicaciones virtuales / Produccion,/ AQP M / Existencias,07,Mineral con Contenido Aurifero y Argentifero sin Procesar,M0002,t,LLAMPO,2018-12-31,2018-12-31,,MAMC-004241,,,MAMC-004241,,0,0.810000,0.000000,2022.5925925925925926,0,1638.3000000000000000060000,-0.0000000000000000060000,0,"",241101 - Mineral Aurifero sin Procesar,,"",14125,,,,
Ubicaciones virtuales / Produccion,Physical Locations / AMCAQ / Existencias,/ AMCAQ / Existencias,08,Mineral con Contenido Aurifero y Argentifero sin Procesar,M0002,t,LLAMPO,2018-12-31,2018-12-31,,PAMC004247,,,PAMC004247,,0.810000,0,0.810000,2227.9582560370370370,1804.64618739,0,1804.64618739,2227.9582560370370370,"",241101 - Mineral Aurifero sin Procesar,,"",14125,,,,
Partner Locations / Suppliers,Physical Locations / AQP M / Existencias,/ AQP M / Existencias,03,Mineral con Contenido Aurifero y Argentifero sin Procesar,M0002,t,LLAMPO,2018-12-19,2018-12-19,12/2018,AQP M\IN\04620,01,0001,0000014,MINING BOBADILLA EXPLORER EMPRESA INDIVIDUAL DE RESPONSABILIDAD LIMITADA,4.914000,0,4.914000,530.3642653642653643,2606.21,0,2606.21,530.3642653642653643,602101 - Mineral Aurifero sin Procesar,241101 - Mineral Aurifero sin Procesar,,"",14126,18PO06759,,2018-12-19,
Physical Locations / AQP M / Existencias,Ubicaciones virtuales / Produccion,/ AQP M / Existencias,07,Mineral con Contenido Aurifero y Argentifero sin Procesar,M0002,t,LLAMPO,2018-12-31,2018-12-31,,MAMC-004241,,,MAMC-004241,,0,4.914000,0.000000,530.3642653642653643,0,2606.2100000000000001702000,-0.0000000000000001702000,0,"",241101 - Mineral Aurifero sin Procesar,,"",14126,,,,
Ubicaciones virtuales / Produccion,Physical Locations / AMCAQ / Existencias,/ AMCAQ / Existencias,08,Mineral con Contenido Aurifero y Argentifero sin Procesar,M0002,t,LLAMPO,2018-12-31,2018-12-31,,PAMC004247,,,PAMC004247,,4.914000,0,4.914000,735.7293807061457061,3615.37417679,0,3615.37417679,735.7293807061457061,"",241101 - Mineral Aurifero sin Procesar,,"",14126,,,,
Partner Locations / Suppliers,Physical Locations / AQP M / Existencias,/ AQP M / Existencias,03,Mineral con Contenido Aurifero y Argentifero sin Procesar,M0002,t,LLAMPO,2018-12-19,2018-12-19,12/2018,AQP M\IN\04622,01,0001,0000149,VIRGILIO ENRIQUEZ  FERNANDEZ,6.114000,0,6.114000,849.1609421000981354,5191.77,0,5191.77,849.1609421000981354,602101 - Mineral Aurifero sin Procesar,241101 - Mineral Aurifero sin Procesar,,"",14127,18PO06770,,2018-12-19,
Physical Locations / AQP M / Existencias,Ubicaciones virtuales / Produccion,/ AQP M / Existencias,07,Mineral con Contenido Aurifero y Argentifero sin Procesar,M0002,t,LLAMPO,2018-12-31,2018-12-31,,MAMC-004241,,,MAMC-004241,,0,6.114000,0.000000,849.1609421000981354,0,5191.7699999999999998356000,0.0000000000000001644000,0,"",241101 - Mineral Aurifero sin Procesar,,"",14127,,,,
Ubicaciones virtuales / Produccion,Physical Locations / AMCAQ / Existencias,/ AMCAQ / Existencias,08,Mineral con Contenido Aurifero y Argentifero sin Procesar,M0002,t,LLAMPO,2018-12-31,2018-12-31,,PAMC004247,,,PAMC004247,,6.114000,0,6.114000,1054.5260252567877004,6447.37211842,0,6447.37211842,1054.5260252567877004,"",241101 - Mineral Aurifero sin Procesar,,"",14127,,,,
Partner Locations / Suppliers,Physical Locations / AQP M / Existencias,/ AQP M / Existencias,03,Mineral con Contenido Aurifero y Argentifero sin Procesar,M0002,t,LLAMPO,2018-12-19,2018-12-19,12/2018,AQP M\IN\04620,01,0001,0000014,MINING BOBADILLA EXPLORER EMPRESA INDIVIDUAL DE RESPONSABILIDAD LIMITADA,5.419000,0,5.419000,516.2613028233991511,2797.62,0,2797.62,516.2613028233991511,602101 - Mineral Aurifero sin Procesar,241101 - Mineral Aurifero sin Procesar,,"",14128,18PO06759,,2018-12-19,
Physical Locations / AQP M / Existencias,Ubicaciones virtuales / Produccion,/ AQP M / Existencias,07,Mineral con Contenido Aurifero y Argentifero sin Procesar,M0002,t,LLAMPO,2018-12-31,2018-12-31,,MAMC-004241,,,MAMC-004241,,0,5.419000,0.000000,516.2613028233991511,0,2797.6199999999999998109000,0.0000000000000001891000,0,"",241101 - Mineral Aurifero sin Procesar,,"",14128,,,,
Ubicaciones virtuales / Produccion,Physical Locations / AMCAQ / Existencias,/ AMCAQ / Existencias,08,Mineral con Contenido Aurifero y Argentifero sin Procesar,M0002,t,LLAMPO,2018-12-31,2018-12-31,,PAMC004247,,,PAMC004247,,5.419000,0,5.419000,721.6257788005167005,3910.49009532,0,3910.49009532,721.6257788005167005,"",241101 - Mineral Aurifero sin Procesar,,"",14128,,,,
Partner Locations / Suppliers,Physical Locations / AQP M / Existencias,/ AQP M / Existencias,03,Mineral con Contenido Aurifero y Argentifero sin Procesar,M0002,t,LLAMPO,2018-12-19,2018-12-19,12/2018,AQP M\IN\04622,01,0001,0000149,VIRGILIO ENRIQUEZ  FERNANDEZ,6.394000,0,6.394000,884.4088207694713794,5654.91,0,5654.91,884.4088207694713794,602101 - Mineral Aurifero sin Procesar,241101 - Mineral Aurifero sin Procesar,,"",14129,18PO06770,,2018-12-19,
Physical Locations / AQP M / Existencias,Ubicaciones virtuales / Produccion,/ AQP M / Existencias,07,Mineral con Contenido Aurifero y Argentifero sin Procesar,M0002,t,LLAMPO,2018-12-31,2018-12-31,,MAMC-004242,,,MAMC-004242,,0,6.394000,0.000000,884.4088207694713794,0,5654.9099999999999998836000,0.0000000000000001164000,0,"",241101 - Mineral Aurifero sin Procesar,,"",14129,,,,
Ubicaciones virtuales / Produccion,Physical Locations / AMCAQ / Existencias,/ AMCAQ / Existencias,08,Mineral con Contenido Aurifero y Argentifero sin Procesar,M0002,t,LLAMPO,2018-12-31,2018-12-31,,PAMC004248,,,PAMC004248,,6.394000,0,6.394000,1089.7735954191429465,6968.01236911,0,6968.01236911,1089.7735954191429465,"",241101 - Mineral Aurifero sin Procesar,,"",14129,,,,
Virtual Locations / Compras sin factura,Physical Locations / AQP M / Existencias,/ AQP M / Existencias,03,Mineral con Contenido Aurifero y Argentifero sin Procesar,M0001,t,MINERAL AURIFERO Y ARGENTIFERO SIN PROCESAR,2018-12-19,2018-12-19,,AQP M\IN\04746,,,AQP M\IN\04746,OSCAR EMERSON CASTILLO VILELA,31.650000,0,31.650000,2499.1921011058451817,79099.43,0,79099.43,2499.1921011058451817,"",241101 - Mineral Aurifero sin Procesar,,"",14130,,,2018-12-19,
Physical Locations / AQP M / Existencias,Ubicaciones virtuales / Produccion,/ AQP M / Existencias,07,Mineral con Contenido Aurifero y Argentifero sin Procesar,M0001,t,MINERAL AURIFERO Y ARGENTIFERO SIN PROCESAR,2018-12-31,2018-12-31,,MAMC-004242,,,MAMC-004242,,0,31.650000,0.000000,2499.1921011058451817,0,79099.4300000000000008050000,-0.0000000000000008050000,0,"",241101 - Mineral Aurifero sin Procesar,,"",14130,,,,
Ubicaciones virtuales / Produccion,Physical Locations / AMCAQ / Existencias,/ AMCAQ / Existencias,08,Mineral con Contenido Aurifero y Argentifero sin Procesar,M0001,t,MINERAL AURIFERO Y ARGENTIFERO SIN PROCESAR,2018-12-31,2018-12-31,,PAMC004248,,,PAMC004248,,31.650000,0,31.650000,2701.3253269892575039,85496.94659921,0,85496.94659921,2701.3253269892575039,"",241101 - Mineral Aurifero sin Procesar,,"",14130,,,,
Virtual Locations / Compras sin factura,Physical Locations / AQP M / Existencias,/ AQP M / Existencias,03,Mineral con Contenido Aurifero y Argentifero sin Procesar,M0002,t,LLAMPO,2018-12-19,2018-12-19,,AQP M\IN\04752,,,AQP M\IN\04752,ROLANDO SONCCO MOLINA,7.392000,0,7.392000,766.3068181818181818,5664.54,0,5664.54,766.3068181818181818,"",241101 - Mineral Aurifero sin Procesar,,"",14131,,,2018-12-19,
Physical Locations / AQP M / Existencias,Ubicaciones virtuales / Produccion,/ AQP M / Existencias,07,Mineral con Contenido Aurifero y Argentifero sin Procesar,M0002,t,LLAMPO,2018-12-31,2018-12-31,,MAMC-004242,,,MAMC-004242,,0,7.392000,0.000000,766.3068181818181818,0,5664.5399999999999998656000,0.0000000000000001344000,0,"",241101 - Mineral Aurifero sin Procesar,,"",14131,,,,
Ubicaciones virtuales / Produccion,Physical Locations / AMCAQ / Existencias,/ AMCAQ / Existencias,08,Mineral con Contenido Aurifero y Argentifero sin Procesar,M0002,t,LLAMPO,2018-12-31,2018-12-31,,PAMC004248,,,PAMC004248,,7.392000,0,7.392000,971.6715494494047619,7182.59609353,0,7182.59609353,971.6715494494047619,"",241101 - Mineral Aurifero sin Procesar,,"",14131,,,,
Virtual Locations / Compras sin factura,Physical Locations / AQP M / Existencias,/ AQP M / Existencias,03,Mineral con Contenido Aurifero y Argentifero sin Procesar,M0002,t,LLAMPO,2018-12-19,2018-12-19,,AQP M\IN\04752,,,AQP M\IN\04752,ROLANDO SONCCO MOLINA,7.029000,0,7.029000,806.6083368900270309,5669.65,0,5669.65,806.6083368900270309,"",241101 - Mineral Aurifero sin Procesar,,"",14132,,,2018-12-19,
Physical Locations / AQP M / Existencias,Ubicaciones virtuales / Produccion,/ AQP M / Existencias,07,Mineral con Contenido Aurifero y Argentifero sin Procesar,M0002,t,LLAMPO,2018-12-31,2018-12-31,,MAMC-004242,,,MAMC-004242,,0,7.029000,0.000000,806.6083368900270309,0,5669.6500000000000001961000,-0.0000000000000001961000,0,"",241101 - Mineral Aurifero sin Procesar,,"",14132,,,,
Ubicaciones virtuales / Produccion,Physical Locations / AMCAQ / Existencias,/ AMCAQ / Existencias,08,Mineral con Contenido Aurifero y Argentifero sin Procesar,M0002,t,LLAMPO,2018-12-31,2018-12-31,,PAMC004248,,,PAMC004248,,7.029000,0,7.029000,1011.9734440404040404,7113.16133816,0,7113.16133816,1011.9734440404040404,"",241101 - Mineral Aurifero sin Procesar,,"",14132,,,,
Virtual Locations / Compras sin factura,Physical Locations / AQP M / Existencias,/ AQP M / Existencias,03,Mineral con Contenido Aurifero y Argentifero sin Procesar,M0001,t,MINERAL AURIFERO Y ARGENTIFERO SIN PROCESAR,2018-12-19,2018-12-19,,AQP M\IN\04746,,,AQP M\IN\04746,OSCAR EMERSON CASTILLO VILELA,30.824000,0,30.824000,755.9246042045159616,23300.62,0,23300.62,755.9246042045159616,"",241101 - Mineral Aurifero sin Procesar,,"",14133,,,2018-12-19,
Physical Locations / AQP M / Existencias,Ubicaciones virtuales / Produccion,/ AQP M / Existencias,07,Mineral con Contenido Aurifero y Argentifero sin Procesar,M0001,t,MINERAL AURIFERO Y ARGENTIFERO SIN PROCESAR,2018-12-31,2018-12-31,,MAMC-004242,,,MAMC-004242,,0,30.824000,0.000000,755.9246042045159616,0,23300.6200000000000003584000,-0.0000000000000003584000,0,"",241101 - Mineral Aurifero sin Procesar,,"",14133,,,,
Ubicaciones virtuales / Produccion,Physical Locations / AMCAQ / Existencias,/ AMCAQ / Existencias,08,Mineral con Contenido Aurifero y Argentifero sin Procesar,M0001,t,MINERAL AURIFERO Y ARGENTIFERO SIN PROCESAR,2018-12-31,2018-12-31,,PAMC004248,,,PAMC004248,,30.824000,0,30.824000,958.0578016607189203,29531.17367839,0,29531.17367839,958.0578016607189203,"",241101 - Mineral Aurifero sin Procesar,,"",14133,,,,
Virtual Locations / Compras sin factura,Physical Locations / AQP M / Existencias,/ AQP M / Existencias,03,Mineral con Contenido Aurifero y Argentifero sin Procesar,M0001,t,MINERAL AURIFERO Y ARGENTIFERO SIN PROCESAR,2018-12-19,2018-12-19,,AQP M\IN\04753,,,AQP M\IN\04753,EDWIN CUNO QUIÑONES,1.187000,0,1.187000,144.5914069081718618,171.63,0,171.63,144.5914069081718618,"",241101 - Mineral Aurifero sin Procesar,,"",14134,,,2018-12-19,
Physical Locations / AQP M / Existencias,Ubicaciones virtuales / Produccion,/ AQP M / Existencias,07,Mineral con Contenido Aurifero y Argentifero sin Procesar,M0001,t,MINERAL AURIFERO Y ARGENTIFERO SIN PROCESAR,2018-12-31,2018-12-31,,MAMC-004242,,,MAMC-004242,,0,1.187000,0.000000,144.5914069081718618,0,171.6299999999999999566000,0.0000000000000000434000,0,"",241101 - Mineral Aurifero sin Procesar,,"",14134,,,,
Ubicaciones virtuales / Produccion,Physical Locations / AMCAQ / Existencias,/ AMCAQ / Existencias,08,Mineral con Contenido Aurifero y Argentifero sin Procesar,M0001,t,MINERAL AURIFERO Y ARGENTIFERO SIN PROCESAR,2018-12-31,2018-12-31,,PAMC004248,,,PAMC004248,,1.187000,0,1.187000,415.0121443892165122,492.61941539,0,492.61941539,415.0121443892165122,"",241101 - Mineral Aurifero sin Procesar,,"",14134,,,,
Virtual Locations / Compras sin factura,Physical Locations / AQP M / Existencias,/ AQP M / Existencias,03,Mineral con Contenido Aurifero y Argentifero sin Procesar,M0001,t,MINERAL AURIFERO Y ARGENTIFERO SIN PROCESAR,2018-12-19,2018-12-19,,AQP M\IN\04753,,,AQP M\IN\04753,EDWIN CUNO QUIÑONES,1.632000,0,1.632000,635.2450980392156863,1036.72,0,1036.72,635.2450980392156863,"",241101 - Mineral Aurifero sin Procesar,,"",14135,,,2018-12-19,
Physical Locations / AQP M / Existencias,Ubicaciones virtuales / Produccion,/ AQP M / Existencias,07,Mineral con Contenido Aurifero y Argentifero sin Procesar,M0001,t,MINERAL AURIFERO Y ARGENTIFERO SIN PROCESAR,2018-12-31,2018-12-31,,MAMC-004242,,,MAMC-004242,,0,1.632000,0.000000,635.2450980392156863,0,1036.7200000000000000416000,-0.0000000000000000416000,0,"",241101 - Mineral Aurifero sin Procesar,,"",14135,,,,
Ubicaciones virtuales / Produccion,Physical Locations / AMCAQ / Existencias,/ AMCAQ / Existencias,08,Mineral con Contenido Aurifero y Argentifero sin Procesar,M0001,t,MINERAL AURIFERO Y ARGENTIFERO SIN PROCESAR,2018-12-31,2018-12-31,,PAMC004248,,,PAMC004248,,1.632000,0,1.632000,905.6655713112745098,1478.04621238,0,1478.04621238,905.6655713112745098,"",241101 - Mineral Aurifero sin Procesar,,"",14135,,,,
Virtual Locations / Compras sin factura,Physical Locations / AQP M / Existencias,/ AQP M / Existencias,03,Mineral con Contenido Aurifero y Argentifero sin Procesar,M0001,t,MINERAL AURIFERO Y ARGENTIFERO SIN PROCESAR,2018-12-19,2018-12-19,,AQP M\IN\04753,,,AQP M\IN\04753,EDWIN CUNO QUIÑONES,8.425000,0,8.425000,186.3596439169139466,1570.08,0,1570.08,186.3596439169139466,"",241101 - Mineral Aurifero sin Procesar,,"",14136,,,2018-12-19,
Physical Locations / AQP M / Existencias,Ubicaciones virtuales / Produccion,/ AQP M / Existencias,07,Mineral con Contenido Aurifero y Argentifero sin Procesar,M0001,t,MINERAL AURIFERO Y ARGENTIFERO SIN PROCESAR,2018-12-31,2018-12-31,,MAMC-004242,,,MAMC-004242,,0,8.425000,0.000000,186.3596439169139466,0,1570.0800000000000001050000,-0.0000000000000001050000,0,"",241101 - Mineral Aurifero sin Procesar,,"",14136,,,,
Ubicaciones virtuales / Produccion,Physical Locations / AMCAQ / Existencias,/ AMCAQ / Existencias,08,Mineral con Contenido Aurifero y Argentifero sin Procesar,M0001,t,MINERAL AURIFERO Y ARGENTIFERO SIN PROCESAR,2018-12-31,2018-12-31,,PAMC004248,,,PAMC004248,,8.425000,0,8.425000,456.7799236035608309,3848.37085636,0,3848.37085636,456.7799236035608309,"",241101 - Mineral Aurifero sin Procesar,,"",14136,,,,
Virtual Locations / Compras sin factura,Physical Locations / AQP M / Existencias,/ AQP M / Existencias,03,Mineral con Contenido Aurifero y Argentifero sin Procesar,M0001,t,MINERAL AURIFERO Y ARGENTIFERO SIN PROCESAR,2018-12-19,2018-12-19,,AQP M\IN\04747,,,AQP M\IN\04747,VICENTE OSCAR CASTILLO  ZAVALETA,31.967000,0,31.967000,853.5533518941408327,27285.54,0,27285.54,853.5533518941408327,"",241101 - Mineral Aurifero sin Procesar,,"",14137,,,2018-12-19,
Physical Locations / AQP M / Existencias,Ubicaciones virtuales / Produccion,/ AQP M / Existencias,07,Mineral con Contenido Aurifero y Argentifero sin Procesar,M0001,t,MINERAL AURIFERO Y ARGENTIFERO SIN PROCESAR,2018-12-31,2018-12-31,,MAMC-004242,,,MAMC-004242,,0,31.967000,0.000000,853.5533518941408327,0,27285.5399999999999989209000,0.0000000000000010791000,0,"",241101 - Mineral Aurifero sin Procesar,,"",14137,,,,
Ubicaciones virtuales / Produccion,Physical Locations / AMCAQ / Existencias,/ AMCAQ / Existencias,08,Mineral con Contenido Aurifero y Argentifero sin Procesar,M0001,t,MINERAL AURIFERO Y ARGENTIFERO SIN PROCESAR,2018-12-31,2018-12-31,,PAMC004248,,,PAMC004248,,31.967000,0,31.967000,1055.6865690909375293,33747.13255413,0,33747.13255413,1055.6865690909375293,"",241101 - Mineral Aurifero sin Procesar,,"",14137,,,,
Partner Locations / Suppliers,Physical Locations / AQP M / Existencias,/ AQP M / Existencias,03,Mineral con Contenido Aurifero y Argentifero sin Procesar,M0001,t,MINERAL AURIFERO Y ARGENTIFERO SIN PROCESAR,2018-12-19,2018-12-19,12/2018,AQP M\IN\04621,01,0005,0000015,RUSBEL ANGEL QUISPE ARREDONDO,3.364000,0,3.364000,0.00000000000000000000,0,0,0,0.00000000000000000000,,241101 - Mineral Aurifero sin Procesar,,"",14138,18PO06760,,2018-12-19,
Physical Locations / AQP M / Existencias,Ubicaciones virtuales / Produccion,/ AQP M / Existencias,07,Mineral con Contenido Aurifero y Argentifero sin Procesar,M0001,t,MINERAL AURIFERO Y ARGENTIFERO SIN PROCESAR,2018-12-31,2018-12-31,,MAMC-004242,,,MAMC-004242,,0,3.364000,0.000000,0.00000000000000000000,0,0.00000000000000000000000000,0.00000000000000000000000000,0,"",241101 - Mineral Aurifero sin Procesar,,"",14138,,,,
Ubicaciones virtuales / Produccion,Physical Locations / AMCAQ / Existencias,/ AMCAQ / Existencias,08,Mineral con Contenido Aurifero y Argentifero sin Procesar,M0001,t,MINERAL AURIFERO Y ARGENTIFERO SIN PROCESAR,2018-12-31,2018-12-31,,PAMC004248,,,PAMC004248,,3.364000,0,3.364000,270.4199753061831153,909.69279693,0,909.69279693,270.4199753061831153,"",241101 - Mineral Aurifero sin Procesar,,"",14138,,,,
Virtual Locations / Compras sin factura,Physical Locations / AQP M / Existencias,/ AQP M / Existencias,03,Mineral con Contenido Aurifero y Argentifero sin Procesar,M0001,t,MINERAL AURIFERO Y ARGENTIFERO SIN PROCESAR,2018-12-19,2018-12-19,,AQP M\IN\04747,,,AQP M\IN\04747,VICENTE OSCAR CASTILLO  ZAVALETA,32.180000,0,32.180000,818.6743318831572405,26344.94,0,26344.94,818.6743318831572405,"",241101 - Mineral Aurifero sin Procesar,,"",14139,,,2018-12-19,
Physical Locations / AQP M / Existencias,Ubicaciones virtuales / Produccion,/ AQP M / Existencias,07,Mineral con Contenido Aurifero y Argentifero sin Procesar,M0001,t,MINERAL AURIFERO Y ARGENTIFERO SIN PROCESAR,2018-12-31,2018-12-31,,MAMC-004243,,,MAMC-004243,,0,32.180000,0.000000,818.6743318831572405,0,26344.9399999999999992900000,0.0000000000000007100000,0,"",241101 - Mineral Aurifero sin Procesar,,"",14139,,,,
Ubicaciones virtuales / Produccion,Physical Locations / AMCAQ / Existencias,/ AMCAQ / Existencias,08,Mineral con Contenido Aurifero y Argentifero sin Procesar,M0001,t,MINERAL AURIFERO Y ARGENTIFERO SIN PROCESAR,2018-12-31,2018-12-31,,PAMC004249,,,PAMC004249,,32.180000,0,32.180000,1020.8075379449968925,32849.58657107,0,32849.58657107,1020.8075379449968925,"",241101 - Mineral Aurifero sin Procesar,,"",14139,,,,
Partner Locations / Suppliers,Physical Locations / AQP M / Existencias,/ AQP M / Existencias,03,Mineral con Contenido Aurifero y Argentifero sin Procesar,M0001,t,MINERAL AURIFERO Y ARGENTIFERO SIN PROCESAR,2018-12-19,2018-12-19,12/2018,AQP M\IN\04621,01,0005,0000015,RUSBEL ANGEL QUISPE ARREDONDO,7.108000,0,7.108000,400.9243106359032077,2849.77,0,2849.77,400.9243106359032077,602101 - Mineral Aurifero sin Procesar,241101 - Mineral Aurifero sin Procesar,,"",14140,18PO06760,,2018-12-19,
,,/ AQP M / Existencias,"",Mineral con Contenido Aurifero y Argentifero sin Procesar,"","",MINERAL AURIFERO Y ARGENTIFERO SIN PROCESAR,,2018-12-19,12/2018,,01,E001,0002285,COMUNIDAD CAMPESINA CHILLOROYA,0,0,7.108000,414.2318514350028137,94.59,0,2944.36,414.2318514350028137,609201,241101 - Mineral Aurifero sin Procesar,"",,14140,,,,t
Physical Locations / AQP M / Existencias,Ubicaciones virtuales / Produccion,/ AQP M / Existencias,07,Mineral con Contenido Aurifero y Argentifero sin Procesar,M0001,t,MINERAL AURIFERO Y ARGENTIFERO SIN PROCESAR,2018-12-31,2018-12-31,,MAMC-004243,,,MAMC-004243,,0,7.108000,0.000000,414.2318514350028137,0,2944.3599999999999997796000,0.0000000000000002204000,0,"",241101 - Mineral Aurifero sin Procesar,,"",14140,,,,
Ubicaciones virtuales / Produccion,Physical Locations / AMCAQ / Existencias,/ AMCAQ / Existencias,08,Mineral con Contenido Aurifero y Argentifero sin Procesar,M0001,t,MINERAL AURIFERO Y ARGENTIFERO SIN PROCESAR,2018-12-31,2018-12-31,,PAMC004249,,,PAMC004249,,7.108000,0,7.108000,684.6519019330332020,4866.50571894,0,4866.50571894,684.6519019330332020,"",241101 - Mineral Aurifero sin Procesar,,"",14140,,,,
Virtual Locations / Compras sin factura,Physical Locations / AQP M / Existencias,/ AQP M / Existencias,03,Mineral con Contenido Aurifero y Argentifero sin Procesar,M0001,t,MINERAL AURIFERO Y ARGENTIFERO SIN PROCESAR,2018-12-19,2018-12-19,,AQP M\IN\04747,,,AQP M\IN\04747,VICENTE OSCAR CASTILLO  ZAVALETA,32.487000,0,32.487000,405.7142857142857143,13180.44,0,13180.44,405.7142857142857143,"",241101 - Mineral Aurifero sin Procesar,,"",14141,,,2018-12-19,
Physical Locations / AQP M / Existencias,Ubicaciones virtuales / Produccion,/ AQP M / Existencias,07,Mineral con Contenido Aurifero y Argentifero sin Procesar,M0001,t,MINERAL AURIFERO Y ARGENTIFERO SIN PROCESAR,2018-12-31,2018-12-31,,MAMC-004243,,,MAMC-004243,,0,32.487000,0.000000,405.7142857142857143,0,13180.4400000000000004641000,-0.0000000000000004641000,0,"",241101 - Mineral Aurifero sin Procesar,,"",14141,,,,
Ubicaciones virtuales / Produccion,Physical Locations / AMCAQ / Existencias,/ AMCAQ / Existencias,08,Mineral con Contenido Aurifero y Argentifero sin Procesar,M0001,t,MINERAL AURIFERO Y ARGENTIFERO SIN PROCESAR,2018-12-31,2018-12-31,,PAMC004249,,,PAMC004249,,32.487000,0,32.487000,607.8475551614491951,19747.14352453,0,19747.14352453,607.8475551614491951,"",241101 - Mineral Aurifero sin Procesar,,"",14141,,,,
Partner Locations / Suppliers,Physical Locations / AQP M / Existencias,/ AQP M / Existencias,03,Mineral con Contenido Aurifero y Argentifero sin Procesar,M0001,t,MINERAL AURIFERO Y ARGENTIFERO SIN PROCESAR,2018-12-19,2018-12-19,12/2018,AQP M\IN\04621,01,0005,0000015,RUSBEL ANGEL QUISPE ARREDONDO,2.367000,0,2.367000,3765.6822982678495986,8913.37,0,8913.37,3765.6822982678495986,602101 - Mineral Aurifero sin Procesar,241101 - Mineral Aurifero sin Procesar,,"",14142,18PO06760,,2018-12-19,
Physical Locations / AQP M / Existencias,Ubicaciones virtuales / Produccion,/ AQP M / Existencias,07,Mineral con Contenido Aurifero y Argentifero sin Procesar,M0001,t,MINERAL AURIFERO Y ARGENTIFERO SIN PROCESAR,2018-12-31,2018-12-31,,MAMC-004243,,,MAMC-004243,,0,2.367000,0.000000,3765.6822982678495986,0,8913.3699999999999998862000,0.0000000000000001138000,0,"",241101 - Mineral Aurifero sin Procesar,,"",14142,,,,
Ubicaciones virtuales / Produccion,Physical Locations / AMCAQ / Existencias,/ AMCAQ / Existencias,08,Mineral con Contenido Aurifero y Argentifero sin Procesar,M0001,t,MINERAL AURIFERO Y ARGENTIFERO SIN PROCESAR,2018-12-31,2018-12-31,,PAMC004249,,,PAMC004249,,2.367000,0,2.367000,4036.1027456780735108,9553.45519902,0,9553.45519902,4036.1027456780735108,"",241101 - Mineral Aurifero sin Procesar,,"",14142,,,,
Partner Locations / Suppliers,Physical Locations / AQP M / Existencias,/ AQP M / Existencias,03,Mineral con Contenido Aurifero y Argentifero sin Procesar,M0001,t,MINERAL AURIFERO Y ARGENTIFERO SIN PROCESAR,2018-12-19,2018-12-19,12/2018,AQP M\IN\04616,01,0001,0000270,E&F INVERSIONES MINERAS E.I.R.L.,0.932000,0,0.932000,988.6266094420600858,921.4,0,921.4,988.6266094420600858,602101 - Mineral Aurifero sin Procesar,241101 - Mineral Aurifero sin Procesar,,"",14143,18PO06745,,2018-12-19,
Physical Locations / AQP M / Existencias,Ubicaciones virtuales / Produccion,/ AQP M / Existencias,07,Mineral con Contenido Aurifero y Argentifero sin Procesar,M0001,t,MINERAL AURIFERO Y ARGENTIFERO SIN PROCESAR,2018-12-31,2018-12-31,,MAMC-004243,,,MAMC-004243,,0,0.932000,0.000000,988.6266094420600858,0,921.3999999999999999656000,0.0000000000000000344000,0,"",241101 - Mineral Aurifero sin Procesar,,"",14143,,,,
Ubicaciones virtuales / Produccion,Physical Locations / AMCAQ / Existencias,/ AMCAQ / Existencias,08,Mineral con Contenido Aurifero y Argentifero sin Procesar,M0001,t,MINERAL AURIFERO Y ARGENTIFERO SIN PROCESAR,2018-12-31,2018-12-31,,PAMC004249,,,PAMC004249,,0.932000,0,0.932000,1259.0473121244635193,1173.4320949,0,1173.4320949,1259.0473121244635193,"",241101 - Mineral Aurifero sin Procesar,,"",14143,,,,
Partner Locations / Suppliers,Physical Locations / AQP M / Existencias,/ AQP M / Existencias,03,Mineral con Contenido Aurifero y Argentifero sin Procesar,M0001,t,MINERAL AURIFERO Y ARGENTIFERO SIN PROCESAR,2018-12-19,2018-12-19,12/2018,AQP M\IN\04616,01,0001,0000270,E&F INVERSIONES MINERAS E.I.R.L.,5.092000,0,5.092000,1854.8134328358208955,9444.71,0,9444.71,1854.8134328358208955,602101 - Mineral Aurifero sin Procesar,241101 - Mineral Aurifero sin Procesar,,"",14144,18PO06745,,2018-12-19,
Physical Locations / AQP M / Existencias,Ubicaciones virtuales / Produccion,/ AQP M / Existencias,07,Mineral con Contenido Aurifero y Argentifero sin Procesar,M0001,t,MINERAL AURIFERO Y ARGENTIFERO SIN PROCESAR,2018-12-31,2018-12-31,,MAMC-004243,,,MAMC-004243,,0,5.092000,0.000000,1854.8134328358208955,0,9444.7099999999999998860000,0.0000000000000001140000,0,"",241101 - Mineral Aurifero sin Procesar,,"",14144,,,,
Ubicaciones virtuales / Produccion,Physical Locations / AMCAQ / Existencias,/ AMCAQ / Existencias,08,Mineral con Contenido Aurifero y Argentifero sin Procesar,M0001,t,MINERAL AURIFERO Y ARGENTIFERO SIN PROCESAR,2018-12-31,2018-12-31,,PAMC004249,,,PAMC004249,,5.092000,0,5.092000,2125.2337576237234878,10821.69029382,0,10821.69029382,2125.2337576237234878,"",241101 - Mineral Aurifero sin Procesar,,"",14144,,,,
Virtual Locations / Compras sin factura,Physical Locations / AQP M / Existencias,/ AQP M / Existencias,03,Mineral con Contenido Aurifero y Argentifero sin Procesar,M0001,t,MINERAL AURIFERO Y ARGENTIFERO SIN PROCESAR,2018-12-19,2018-12-19,,AQP M\IN\04746,,,AQP M\IN\04746,OSCAR EMERSON CASTILLO VILELA,33.053000,0,33.053000,861.3051765346564608,28468.72,0,28468.72,861.3051765346564608,"",241101 - Mineral Aurifero sin Procesar,,"",14145,,,2018-12-19,
Physical Locations / AQP M / Existencias,Ubicaciones virtuales / Produccion,/ AQP M / Existencias,07,Mineral con Contenido Aurifero y Argentifero sin Procesar,M0001,t,MINERAL AURIFERO Y ARGENTIFERO SIN PROCESAR,2018-12-31,2018-12-31,,MAMC-004243,,,MAMC-004243,,0,33.053000,0.000000,861.3051765346564608,0,28468.7199999999999988224000,0.0000000000000011776000,0,"",241101 - Mineral Aurifero sin Procesar,,"",14145,,,,
Ubicaciones virtuales / Produccion,Physical Locations / AMCAQ / Existencias,/ AMCAQ / Existencias,08,Mineral con Contenido Aurifero y Argentifero sin Procesar,M0001,t,MINERAL AURIFERO Y ARGENTIFERO SIN PROCESAR,2018-12-31,2018-12-31,,PAMC004249,,,PAMC004249,,33.053000,0,33.053000,1063.4384301267661029,35149.83043098,0,35149.83043098,1063.4384301267661029,"",241101 - Mineral Aurifero sin Procesar,,"",14145,,,,
Partner Locations / Suppliers,Physical Locations / AQP M / Existencias,/ AQP M / Existencias,03,Mineral con Contenido Aurifero y Argentifero sin Procesar,M0001,t,MINERAL AURIFERO Y ARGENTIFERO SIN PROCESAR,2018-12-19,2018-12-19,12/2018,AQP M\IN\04653,01,0003,0000023,LALO ZENON APAZA PFOCCORI,1.455000,0,1.455000,1288.4398625429553265,1874.68,0,1874.68,1288.4398625429553265,602101 - Mineral Aurifero sin Procesar,241101 - Mineral Aurifero sin Procesar,,"",14146,18PO06927,,2018-12-19,
Physical Locations / AQP M / Existencias,Ubicaciones virtuales / Produccion,/ AQP M / Existencias,07,Mineral con Contenido Aurifero y Argentifero sin Procesar,M0001,t,MINERAL AURIFERO Y ARGENTIFERO SIN PROCESAR,2018-12-31,2018-12-31,,MAMC-004243,,,MAMC-004243,,0,1.455000,0.000000,1288.4398625429553265,0,1874.6800000000000000575000,-0.0000000000000000575000,0,"",241101 - Mineral Aurifero sin Procesar,,"",14146,,,,
Ubicaciones virtuales / Produccion,Physical Locations / AMCAQ / Existencias,/ AMCAQ / Existencias,08,Mineral con Contenido Aurifero y Argentifero sin Procesar,M0001,t,MINERAL AURIFERO Y ARGENTIFERO SIN PROCESAR,2018-12-31,2018-12-31,,PAMC004249,,,PAMC004249,,1.455000,0,1.455000,1558.8600520549828179,2268.14137574,0,2268.14137574,1558.8600520549828179,"",241101 - Mineral Aurifero sin Procesar,,"",14146,,,,
Virtual Locations / Compras sin factura,Physical Locations / AQP M / Existencias,/ AQP M / Existencias,03,Mineral con Contenido Aurifero y Argentifero sin Procesar,M0001,t,MINERAL AURIFERO Y ARGENTIFERO SIN PROCESAR,2018-12-19,2018-12-19,,AQP M\IN\04746,,,AQP M\IN\04746,OSCAR EMERSON CASTILLO VILELA,2.083000,0,2.083000,2915.2472395583293327,6072.46,0,6072.46,2915.2472395583293327,"",241101 - Mineral Aurifero sin Procesar,,"",14147,,,2018-12-19,
Physical Locations / AQP M / Existencias,Ubicaciones virtuales / Produccion,/ AQP M / Existencias,07,Mineral con Contenido Aurifero y Argentifero sin Procesar,M0001,t,MINERAL AURIFERO Y ARGENTIFERO SIN PROCESAR,2018-12-31,2018-12-31,,MAMC-004243,,,MAMC-004243,,0,2.083000,0.000000,2915.2472395583293327,0,6072.4600000000000000141000,-0.0000000000000000141000,0,"",241101 - Mineral Aurifero sin Procesar,,"",14147,,,,
Ubicaciones virtuales / Produccion,Physical Locations / AMCAQ / Existencias,/ AMCAQ / Existencias,08,Mineral con Contenido Aurifero y Argentifero sin Procesar,M0001,t,MINERAL AURIFERO Y ARGENTIFERO SIN PROCESAR,2018-12-31,2018-12-31,,PAMC004249,,,PAMC004249,,2.083000,0,2.083000,3117.3807083341334614,6493.50401546,0,6493.50401546,3117.3807083341334614,"",241101 - Mineral Aurifero sin Procesar,,"",14147,,,,
Partner Locations / Suppliers,Physical Locations / AQP M / Existencias,/ AQP M / Existencias,03,Mineral con Contenido Aurifero y Argentifero sin Procesar,M0001,t,MINERAL AURIFERO Y ARGENTIFERO SIN PROCESAR,2018-12-19,2018-12-19,12/2018,AQP M\IN\04652,01,0003,0000024,LALO ZENON APAZA PFOCCORI,3.546000,0,3.546000,1274.4613649182177101,4519.24,0,4519.24,1274.4613649182177101,602101 - Mineral Aurifero sin Procesar,241101 - Mineral Aurifero sin Procesar,,"",14148,18PO06926,,2018-12-19,
Physical Locations / AQP M / Existencias,Ubicaciones virtuales / Produccion,/ AQP M / Existencias,07,Mineral con Contenido Aurifero y Argentifero sin Procesar,M0001,t,MINERAL AURIFERO Y ARGENTIFERO SIN PROCESAR,2018-12-31,2018-12-31,,MAMC-004243,,,MAMC-004243,,0,3.546000,0.000000,1274.4613649182177101,0,4519.2400000000000000146000,-0.0000000000000000146000,0,"",241101 - Mineral Aurifero sin Procesar,,"",14148,,,,
Ubicaciones virtuales / Produccion,Physical Locations / AMCAQ / Existencias,/ AMCAQ / Existencias,08,Mineral con Contenido Aurifero y Argentifero sin Procesar,M0001,t,MINERAL AURIFERO Y ARGENTIFERO SIN PROCESAR,2018-12-31,2018-12-31,,PAMC004249,,,PAMC004249,,3.546000,0,3.546000,1544.8813929357021997,5478.14941935,0,5478.14941935,1544.8813929357021997,"",241101 - Mineral Aurifero sin Procesar,,"",14148,,,,
Virtual Locations / Compras sin factura,Physical Locations / AQP M / Existencias,/ AQP M / Existencias,03,Mineral con Contenido Aurifero y Argentifero sin Procesar,M0001,t,MINERAL AURIFERO Y ARGENTIFERO SIN PROCESAR,2018-12-19,2018-12-19,,AQP M\IN\04748,,,AQP M\IN\04748,OSCAR EMERSON CASTILLO VILELA,33.716000,0,33.716000,2145.1064776367303357,72324.41,0,72324.41,2145.1064776367303357,"",241101 - Mineral Aurifero sin Procesar,,"",14149,,,2018-12-19,
Physical Locations / AQP M / Existencias,Ubicaciones virtuales / Produccion,/ AQP M / Existencias,07,Mineral con Contenido Aurifero y Argentifero sin Procesar,M0001,t,MINERAL AURIFERO Y ARGENTIFERO SIN PROCESAR,2018-12-31,2018-12-31,,MAMC-004244,,,MAMC-004244,,0,33.716000,0.000000,2145.1064776367303357,0,72324.4099999999999984612000,0.0000000000000015388000,0,"",241101 - Mineral Aurifero sin Procesar,,"",14149,,,,
Ubicaciones virtuales / Produccion,Physical Locations / AMCAQ / Existencias,/ AMCAQ / Existencias,08,Mineral con Contenido Aurifero y Argentifero sin Procesar,M0001,t,MINERAL AURIFERO Y ARGENTIFERO SIN PROCESAR,2018-12-31,2018-12-31,,PAMC004250,,,PAMC004250,,33.716000,0,33.716000,2347.2397099982204295,79139.5340623,0,79139.5340623,2347.2397099982204295,"",241101 - Mineral Aurifero sin Procesar,,"",14149,,,,
Partner Locations / Suppliers,Physical Locations / AQP M / Existencias,/ AQP M / Existencias,03,Mineral con Contenido Aurifero y Argentifero sin Procesar,M0001,t,MINERAL AURIFERO Y ARGENTIFERO SIN PROCESAR,2018-12-19,2018-12-19,12/2018,AQP M\IN\04653,01,0003,0000023,LALO ZENON APAZA PFOCCORI,8.799000,0,8.799000,5785.3983407205364246,50905.72,0,50905.72,5785.3983407205364246,602101 - Mineral Aurifero sin Procesar,241101 - Mineral Aurifero sin Procesar,,"",14150,18PO06927,,2018-12-19,
,,/ AQP M / Existencias,"",Mineral con Contenido Aurifero y Argentifero sin Procesar,"","",MINERAL AURIFERO Y ARGENTIFERO SIN PROCESAR,,2018-12-27,12/2018,,01,0003,0000010,LALO ZENON APAZA PFOCCORI,0,0,8.799000,5862.0093192408228208,674.1,0,51579.82,5862.0093192408228208,609201,241101 - Mineral Aurifero sin Procesar,"",,14150,,,,t
,,/ AQP M / Existencias,"",Mineral con Contenido Aurifero y Argentifero sin Procesar,"","",MINERAL AURIFERO Y ARGENTIFERO SIN PROCESAR,,2018-12-31,12/2018,,01,0003,0000026,LALO ZENON APAZA PFOCCORI,0,0,8.799000,5938.6430276167746335,674.3,0,52254.12,5938.6430276167746335,609201,241101 - Mineral Aurifero sin Procesar,"",,14150,,,,t
Physical Locations / AQP M / Existencias,Ubicaciones virtuales / Produccion,/ AQP M / Existencias,07,Mineral con Contenido Aurifero y Argentifero sin Procesar,M0001,t,MINERAL AURIFERO Y ARGENTIFERO SIN PROCESAR,2018-12-31,2018-12-31,,MAMC-004244,,,MAMC-004244,,0,8.799000,0.000000,5938.6430276167746335,0,52254.1200000000000001665000,-0.0000000000000001665000,0,"",241101 - Mineral Aurifero sin Procesar,,"",14150,,,,
Ubicaciones virtuales / Produccion,Physical Locations / AMCAQ / Existencias,/ AMCAQ / Existencias,08,Mineral con Contenido Aurifero y Argentifero sin Procesar,M0001,t,MINERAL AURIFERO Y ARGENTIFERO SIN PROCESAR,2018-12-31,2018-12-31,,PAMC004250,,,PAMC004250,,8.799000,0,8.799000,6209.0633979429480623,54633.5488385,0,54633.5488385,6209.0633979429480623,"",241101 - Mineral Aurifero sin Procesar,,"",14150,,,,
Partner Locations / Suppliers,Physical Locations / AQP M / Existencias,/ AQP M / Existencias,03,Mineral con Contenido Aurifero y Argentifero sin Procesar,M0001,t,MINERAL AURIFERO Y ARGENTIFERO SIN PROCESAR,2018-12-19,2018-12-19,12/2018,AQP M\IN\04652,01,0003,0000024,LALO ZENON APAZA PFOCCORI,9.370000,0,9.370000,3072.9957310565635005,28793.97,0,28793.97,3072.9957310565635005,602101 - Mineral Aurifero sin Procesar,241101 - Mineral Aurifero sin Procesar,,"",14151,18PO06926,,2018-12-19,
,,/ AQP M / Existencias,"",Mineral con Contenido Aurifero y Argentifero sin Procesar,"","",MINERAL AURIFERO Y ARGENTIFERO SIN PROCESAR,,2018-12-27,12/2018,,01,0003,0000010,LALO ZENON APAZA PFOCCORI,0,0,9.370000,3128.3159018143009605,518.35,0,29312.32,3128.3159018143009605,609201,241101 - Mineral Aurifero sin Procesar,"",,14151,,,,t
,,/ AQP M / Existencias,"",Mineral con Contenido Aurifero y Argentifero sin Procesar,"","",MINERAL AURIFERO Y ARGENTIFERO SIN PROCESAR,,2018-12-31,12/2018,,01,0003,0000026,LALO ZENON APAZA PFOCCORI,0,0,9.370000,3183.6531483457844184,518.51,0,29830.83,3183.6531483457844184,609201,241101 - Mineral Aurifero sin Procesar,"",,14151,,,,t
Physical Locations / AQP M / Existencias,Ubicaciones virtuales / Produccion,/ AQP M / Existencias,07,Mineral con Contenido Aurifero y Argentifero sin Procesar,M0001,t,MINERAL AURIFERO Y ARGENTIFERO SIN PROCESAR,2018-12-31,2018-12-31,,MAMC-004244,,,MAMC-004244,,0,9.370000,0.000000,3183.6531483457844184,0,29830.8300000000000004080000,-0.0000000000000004080000,0,"",241101 - Mineral Aurifero sin Procesar,,"",14151,,,,
Ubicaciones virtuales / Produccion,Physical Locations / AMCAQ / Existencias,/ AMCAQ / Existencias,08,Mineral con Contenido Aurifero y Argentifero sin Procesar,M0001,t,MINERAL AURIFERO Y ARGENTIFERO SIN PROCESAR,2018-12-31,2018-12-31,,PAMC004250,,,PAMC004250,,9.370000,0,9.370000,3454.0733821889007471,32364.66759111,0,32364.66759111,3454.0733821889007471,"",241101 - Mineral Aurifero sin Procesar,,"",14151,,,,
Virtual Locations / Compras sin factura,Physical Locations / AQP M / Existencias,/ AQP M / Existencias,03,Mineral con Contenido Aurifero y Argentifero sin Procesar,M0001,t,MINERAL AURIFERO Y ARGENTIFERO SIN PROCESAR,2018-12-19,2018-12-19,,AQP M\IN\04748,,,AQP M\IN\04748,OSCAR EMERSON CASTILLO VILELA,29.613000,0,29.613000,2331.8380441022523892,69052.72,0,69052.72,2331.8380441022523892,"",241101 - Mineral Aurifero sin Procesar,,"",14152,,,2018-12-19,
Physical Locations / AQP M / Existencias,Ubicaciones virtuales / Produccion,/ AQP M / Existencias,07,Mineral con Contenido Aurifero y Argentifero sin Procesar,M0001,t,MINERAL AURIFERO Y ARGENTIFERO SIN PROCESAR,2018-12-31,2018-12-31,,MAMC-004244,,,MAMC-004244,,0,29.613000,0.000000,2331.8380441022523892,0,69052.7200000000000013796000,-0.0000000000000013796000,0,"",241101 - Mineral Aurifero sin Procesar,,"",14152,,,,
Ubicaciones virtuales / Produccion,Physical Locations / AMCAQ / Existencias,/ AMCAQ / Existencias,08,Mineral con Contenido Aurifero y Argentifero sin Procesar,M0001,t,MINERAL AURIFERO Y ARGENTIFERO SIN PROCESAR,2018-12-31,2018-12-31,,PAMC004250,,,PAMC004250,,29.613000,0,29.613000,2533.9712615466180394,75038.49096818,0,75038.49096818,2533.9712615466180394,"",241101 - Mineral Aurifero sin Procesar,,"",14152,,,,
Partner Locations / Suppliers,Physical Locations / AQP M / Existencias,/ AQP M / Existencias,03,Mineral con Contenido Aurifero y Argentifero sin Procesar,M0001,t,MINERAL AURIFERO Y ARGENTIFERO SIN PROCESAR,2018-12-19,2018-12-19,12/2018,AQP M\IN\04629,01,0001,0000564,MIRIAN MARIA CHICATA CAMACHO,6.316000,0,6.316000,774.5044331855604813,4891.77,0,4891.77,774.5044331855604813,602101 - Mineral Aurifero sin Procesar,241101 - Mineral Aurifero sin Procesar,,"",14153,18PO06778,,2018-12-19,
Physical Locations / AQP M / Existencias,Ubicaciones virtuales / Produccion,/ AQP M / Existencias,07,Mineral con Contenido Aurifero y Argentifero sin Procesar,M0001,t,MINERAL AURIFERO Y ARGENTIFERO SIN PROCESAR,2018-12-31,2018-12-31,,MAMC-004244,,,MAMC-004244,,0,6.316000,0.000000,774.5044331855604813,0,4891.7699999999999998908000,0.0000000000000001092000,0,"",241101 - Mineral Aurifero sin Procesar,,"",14153,,,,
Ubicaciones virtuales / Produccion,Physical Locations / AMCAQ / Existencias,/ AMCAQ / Existencias,08,Mineral con Contenido Aurifero y Argentifero sin Procesar,M0001,t,MINERAL AURIFERO Y ARGENTIFERO SIN PROCESAR,2018-12-31,2018-12-31,,PAMC004250,,,PAMC004250,,6.316000,0,6.316000,1044.9242789043698543,6599.74174556,0,6599.74174556,1044.9242789043698543,"",241101 - Mineral Aurifero sin Procesar,,"",14153,,,,
Partner Locations / Suppliers,Physical Locations / AQP M / Existencias,/ AQP M / Existencias,03,Mineral con Contenido Aurifero y Argentifero sin Procesar,M0002,t,LLAMPO,2018-12-19,2018-12-19,12/2018,AQP M\IN\04640,01,0001,0000567,MIRIAN MARIA CHICATA CAMACHO,4.842000,0,4.842000,521.4580751755472945,2524.9,0,2524.9,521.4580751755472945,602101 - Mineral Aurifero sin Procesar,241101 - Mineral Aurifero sin Procesar,,"",14154,18PO06820,,2018-12-19,
Physical Locations / AQP M / Existencias,Ubicaciones virtuales / Produccion,/ AQP M / Existencias,07,Mineral con Contenido Aurifero y Argentifero sin Procesar,M0002,t,LLAMPO,2018-12-31,2018-12-31,,MAMC-004244,,,MAMC-004244,,0,4.842000,0.000000,521.4580751755472945,0,2524.8999999999999999690000,0.0000000000000000310000,0,"",241101 - Mineral Aurifero sin Procesar,,"",14154,,,,
Ubicaciones virtuales / Produccion,Physical Locations / AMCAQ / Existencias,/ AMCAQ / Existencias,08,Mineral con Contenido Aurifero y Argentifero sin Procesar,M0002,t,LLAMPO,2018-12-31,2018-12-31,,PAMC004250,,,PAMC004250,,4.842000,0,4.842000,726.8230482507228418,3519.27719963,0,3519.27719963,726.8230482507228418,"",241101 - Mineral Aurifero sin Procesar,,"",14154,,,,
Virtual Locations / Compras sin factura,Physical Locations / AQP M / Existencias,/ AQP M / Existencias,03,Mineral con Contenido Aurifero y Argentifero sin Procesar,M0001,t,MINERAL AURIFERO Y ARGENTIFERO SIN PROCESAR,2018-12-19,2018-12-19,,AQP M\IN\04748,,,AQP M\IN\04748,OSCAR EMERSON CASTILLO VILELA,30.037000,0,30.037000,880.6485334753803642,26452.04,0,26452.04,880.6485334753803642,"",241101 - Mineral Aurifero sin Procesar,,"",14155,,,2018-12-19,
Physical Locations / AQP M / Existencias,Ubicaciones virtuales / Produccion,/ AQP M / Existencias,07,Mineral con Contenido Aurifero y Argentifero sin Procesar,M0001,t,MINERAL AURIFERO Y ARGENTIFERO SIN PROCESAR,2018-12-31,2018-12-31,,MAMC-004244,,,MAMC-004244,,0,30.037000,0.000000,880.6485334753803642,0,26452.0399999999999994754000,0.0000000000000005246000,0,"",241101 - Mineral Aurifero sin Procesar,,"",14155,,,,
Ubicaciones virtuales / Produccion,Physical Locations / AMCAQ / Existencias,/ AMCAQ / Existencias,08,Mineral con Contenido Aurifero y Argentifero sin Procesar,M0001,t,MINERAL AURIFERO Y ARGENTIFERO SIN PROCESAR,2018-12-31,2018-12-31,,PAMC004250,,,PAMC004250,,30.037000,0,30.037000,1082.7818231041715218,32523.51762058,0,32523.51762058,1082.7818231041715218,"",241101 - Mineral Aurifero sin Procesar,,"",14155,,,,
Partner Locations / Suppliers,Physical Locations / AQP M / Existencias,/ AQP M / Existencias,03,Mineral con Contenido Aurifero y Argentifero sin Procesar,M0002,t,LLAMPO,2018-12-19,2018-12-19,12/2018,AQP M\IN\04629,01,0001,0000564,MIRIAN MARIA CHICATA CAMACHO,1.456000,0,1.456000,654.5329670329670330,953,0,953,654.5329670329670330,602101 - Mineral Aurifero sin Procesar,241101 - Mineral Aurifero sin Procesar,,"",14156,18PO06778,,2018-12-19,
Physical Locations / AQP M / Existencias,Ubicaciones virtuales / Produccion,/ AQP M / Existencias,07,Mineral con Contenido Aurifero y Argentifero sin Procesar,M0002,t,LLAMPO,2018-12-31,2018-12-31,,MAMC-004244,,,MAMC-004244,,0,1.456000,0.000000,654.5329670329670330,0,953.0000000000000000480000,-0.0000000000000000480000,0,"",241101 - Mineral Aurifero sin Procesar,,"",14156,,,,
Ubicaciones virtuales / Produccion,Physical Locations / AMCAQ / Existencias,/ AMCAQ / Existencias,08,Mineral con Contenido Aurifero y Argentifero sin Procesar,M0002,t,LLAMPO,2018-12-31,2018-12-31,,PAMC004250,,,PAMC004250,,1.456000,0,1.456000,859.8988213873626374,1252.01268394,0,1252.01268394,859.8988213873626374,"",241101 - Mineral Aurifero sin Procesar,,"",14156,,,,
Partner Locations / Suppliers,Physical Locations / AQP M / Existencias,/ AQP M / Existencias,03,Mineral con Contenido Aurifero y Argentifero sin Procesar,M0002,t,LLAMPO,2018-12-19,2018-12-19,12/2018,AQP M\IN\04629,01,0001,0000564,MIRIAN MARIA CHICATA CAMACHO,5.745000,0,5.745000,781.2706701479547433,4488.4,0,4488.4,781.2706701479547433,602101 - Mineral Aurifero sin Procesar,241101 - Mineral Aurifero sin Procesar,,"",14157,18PO06778,,2018-12-19,
Physical Locations / AQP M / Existencias,Ubicaciones virtuales / Produccion,/ AQP M / Existencias,07,Mineral con Contenido Aurifero y Argentifero sin Procesar,M0002,t,LLAMPO,2018-12-31,2018-12-31,,MAMC-004244,,,MAMC-004244,,0,5.745000,0.000000,781.2706701479547433,0,4488.4000000000000002585000,-0.0000000000000002585000,0,"",241101 - Mineral Aurifero sin Procesar,,"",14157,,,,
Ubicaciones virtuales / Produccion,Physical Locations / AMCAQ / Existencias,/ AMCAQ / Existencias,08,Mineral con Contenido Aurifero y Argentifero sin Procesar,M0002,t,LLAMPO,2018-12-31,2018-12-31,,PAMC004250,,,PAMC004250,,5.745000,0,5.745000,986.6353685865970409,5668.22019253,0,5668.22019253,986.6353685865970409,"",241101 - Mineral Aurifero sin Procesar,,"",14157,,,,
Partner Locations / Suppliers,Physical Locations / AQP M / Existencias,/ AQP M / Existencias,03,Mineral con Contenido Aurifero y Argentifero sin Procesar,M0002,t,LLAMPO,2018-12-19,2018-12-19,12/2018,AQP M\IN\04629,01,0001,0000564,MIRIAN MARIA CHICATA CAMACHO,6.156000,0,6.156000,513.6500974658869396,3162.03,0,3162.03,513.6500974658869396,602101 - Mineral Aurifero sin Procesar,241101 - Mineral Aurifero sin Procesar,,"",14158,18PO06778,,2018-12-19,
Physical Locations / AQP M / Existencias,Ubicaciones virtuales / Produccion,/ AQP M / Existencias,07,Mineral con Contenido Aurifero y Argentifero sin Procesar,M0002,t,LLAMPO,2018-12-31,2018-12-31,,MAMC-004244,,,MAMC-004244,,0,6.156000,0.000000,513.6500974658869396,0,3162.0300000000000001776000,-0.0000000000000001776000,0,"",241101 - Mineral Aurifero sin Procesar,,"",14158,,,,
Ubicaciones virtuales / Produccion,Physical Locations / AMCAQ / Existencias,/ AMCAQ / Existencias,08,Mineral con Contenido Aurifero y Argentifero sin Procesar,M0002,t,LLAMPO,2018-12-31,2018-12-31,,PAMC004250,,,PAMC004250,,6.156000,0,6.156000,719.0148225747238467,4426.25524777,0,4426.25524777,719.0148225747238467,"",241101 - Mineral Aurifero sin Procesar,,"",14158,,,,
Virtual Locations / Compras sin factura,Physical Locations / AQP M / Existencias,/ AQP M / Existencias,03,Mineral con Contenido Aurifero y Argentifero sin Procesar,M0001,t,MINERAL AURIFERO Y ARGENTIFERO SIN PROCESAR,2018-12-19,2018-12-19,,AQP M\IN\04748,,,AQP M\IN\04748,OSCAR EMERSON CASTILLO VILELA,33.830000,0,33.830000,783.0195093112621933,26489.55,0,26489.55,783.0195093112621933,"",241101 - Mineral Aurifero sin Procesar,,"",14159,,,2018-12-19,
Physical Locations / AQP M / Existencias,Ubicaciones virtuales / Produccion,/ AQP M / Existencias,07,Mineral con Contenido Aurifero y Argentifero sin Procesar,M0001,t,MINERAL AURIFERO Y ARGENTIFERO SIN PROCESAR,2018-12-31,2018-12-31,,MAMC-004245,,,MAMC-004245,,0,33.830000,0.000000,783.0195093112621933,0,26489.5499999999999993390000,0.0000000000000006610000,0,"",241101 - Mineral Aurifero sin Procesar,,"",14159,,,,
Ubicaciones virtuales / Produccion,Physical Locations / AMCAQ / Existencias,/ AMCAQ / Existencias,08,Mineral con Contenido Aurifero y Argentifero sin Procesar,M0001,t,MINERAL AURIFERO Y ARGENTIFERO SIN PROCESAR,2018-12-31,2018-12-31,,PAMC004251,,,PAMC004251,,33.830000,0,33.830000,985.1527486644989654,33327.71748732,0,33327.71748732,985.1527486644989654,"",241101 - Mineral Aurifero sin Procesar,,"",14159,,,,
Virtual Locations / Compras sin factura,Physical Locations / AQP M / Existencias,/ AQP M / Existencias,03,Mineral con Contenido Aurifero y Argentifero sin Procesar,M0001,t,MINERAL AURIFERO Y ARGENTIFERO SIN PROCESAR,2018-12-19,2018-12-19,,AQP M\IN\04748,,,AQP M\IN\04748,OSCAR EMERSON CASTILLO VILELA,35.392000,0,35.392000,759.2611324593128391,26871.77,0,26871.77,759.2611324593128391,"",241101 - Mineral Aurifero sin Procesar,,"",14160,,,2018-12-19,
Physical Locations / AQP M / Existencias,Ubicaciones virtuales / Produccion,/ AQP M / Existencias,07,Mineral con Contenido Aurifero y Argentifero sin Procesar,M0001,t,MINERAL AURIFERO Y ARGENTIFERO SIN PROCESAR,2018-12-31,2018-12-31,,MAMC-004245,,,MAMC-004245,,0,35.392000,0.000000,759.2611324593128391,0,26871.7700000000000014272000,-0.0000000000000014272000,0,"",241101 - Mineral Aurifero sin Procesar,,"",14160,,,,
Ubicaciones virtuales / Produccion,Physical Locations / AMCAQ / Existencias,/ AMCAQ / Existencias,08,Mineral con Contenido Aurifero y Argentifero sin Procesar,M0001,t,MINERAL AURIFERO Y ARGENTIFERO SIN PROCESAR,2018-12-31,2018-12-31,,PAMC004251,,,PAMC004251,,35.392000,0,35.392000,961.3943960024864376,34025.67046332,0,34025.67046332,961.3943960024864376,"",241101 - Mineral Aurifero sin Procesar,,"",14160,,,,
Partner Locations / Suppliers,Physical Locations / AQP M / Existencias,/ AQP M / Existencias,03,Mineral con Contenido Aurifero y Argentifero sin Procesar,M0002,t,LLAMPO,2018-12-20,2018-12-20,12/2018,AQP M\IN\04619,01,E001,0000918,COMUNIDAD CAMPESINA DE UNTUCA,3.565000,0,3.565000,3976.6816269284712482,14176.87,0,14176.87,3976.6816269284712482,602101 - Mineral Aurifero sin Procesar,241101 - Mineral Aurifero sin Procesar,,"",14161,18PO06757,,2018-12-20,
Physical Locations / AQP M / Existencias,Ubicaciones virtuales / Produccion,/ AQP M / Existencias,07,Mineral con Contenido Aurifero y Argentifero sin Procesar,M0002,t,LLAMPO,2018-12-31,2018-12-31,,MAMC-004245,,,MAMC-004245,,0,3.565000,0.000000,3976.6816269284712482,0,14176.8699999999999998330000,0.0000000000000001670000,0,"",241101 - Mineral Aurifero sin Procesar,,"",14161,,,,
Ubicaciones virtuales / Produccion,Physical Locations / AMCAQ / Existencias,/ AMCAQ / Existencias,08,Mineral con Contenido Aurifero y Argentifero sin Procesar,M0002,t,LLAMPO,2018-12-31,2018-12-31,,PAMC004251,,,PAMC004251,,3.565000,0,3.565000,4182.0466051753155680,14908.99614745,0,14908.99614745,4182.0466051753155680,"",241101 - Mineral Aurifero sin Procesar,,"",14161,,,,
Partner Locations / Suppliers,Physical Locations / AQP M / Existencias,/ AQP M / Existencias,03,Mineral con Contenido Aurifero y Argentifero sin Procesar,M0002,t,LLAMPO,2018-12-20,2018-12-20,12/2018,AQP M\IN\04619,01,E001,0000918,COMUNIDAD CAMPESINA DE UNTUCA,2.062000,0,2.062000,4861.1057225994180407,10023.6,0,10023.6,4861.1057225994180407,602101 - Mineral Aurifero sin Procesar,241101 - Mineral Aurifero sin Procesar,,"",14162,18PO06757,,2018-12-20,
Physical Locations / AQP M / Existencias,Ubicaciones virtuales / Produccion,/ AQP M / Existencias,07,Mineral con Contenido Aurifero y Argentifero sin Procesar,M0002,t,LLAMPO,2018-12-31,2018-12-31,,MAMC-004245,,,MAMC-004245,,0,2.062000,0.000000,4861.1057225994180407,0,10023.5999999999999999234000,0.0000000000000000766000,0,"",241101 - Mineral Aurifero sin Procesar,,"",14162,,,,
Ubicaciones virtuales / Produccion,Physical Locations / AMCAQ / Existencias,/ AMCAQ / Existencias,08,Mineral con Contenido Aurifero y Argentifero sin Procesar,M0002,t,LLAMPO,2018-12-31,2018-12-31,,PAMC004251,,,PAMC004251,,2.062000,0,2.062000,5066.4709174878758487,10447.06303186,0,10447.06303186,5066.4709174878758487,"",241101 - Mineral Aurifero sin Procesar,,"",14162,,,,
Partner Locations / Suppliers,Physical Locations / AQP M / Existencias,/ AQP M / Existencias,03,Mineral con Contenido Aurifero y Argentifero sin Procesar,M0002,t,LLAMPO,2018-12-20,2018-12-20,12/2018,AQP M\IN\04619,01,E001,0000918,COMUNIDAD CAMPESINA DE UNTUCA,3.076000,0,3.076000,655.2145643693107932,2015.44,0,2015.44,655.2145643693107932,602101 - Mineral Aurifero sin Procesar,241101 - Mineral Aurifero sin Procesar,,"",14163,18PO06757,,2018-12-20,
Physical Locations / AQP M / Existencias,Ubicaciones virtuales / Produccion,/ AQP M / Existencias,07,Mineral con Contenido Aurifero y Argentifero sin Procesar,M0002,t,LLAMPO,2018-12-31,2018-12-31,,MAMC-004245,,,MAMC-004245,,0,3.076000,0.000000,655.2145643693107932,0,2015.4399999999999998832000,0.0000000000000001168000,0,"",241101 - Mineral Aurifero sin Procesar,,"",14163,,,,
Ubicaciones virtuales / Produccion,Physical Locations / AMCAQ / Existencias,/ AMCAQ / Existencias,08,Mineral con Contenido Aurifero y Argentifero sin Procesar,M0002,t,LLAMPO,2018-12-31,2018-12-31,,PAMC004251,,,PAMC004251,,3.076000,0,3.076000,860.5791892327698309,2647.14158608,0,2647.14158608,860.5791892327698309,"",241101 - Mineral Aurifero sin Procesar,,"",14163,,,,
Partner Locations / Suppliers,Physical Locations / AQP M / Existencias,/ AQP M / Existencias,03,Mineral con Contenido Aurifero y Argentifero sin Procesar,M0002,t,LLAMPO,2018-12-20,2018-12-20,12/2018,AQP M\IN\04619,01,E001,0000918,COMUNIDAD CAMPESINA DE UNTUCA,0.844000,0,0.844000,1421.3862559241706161,1199.65,0,1199.65,1421.3862559241706161,602101 - Mineral Aurifero sin Procesar,241101 - Mineral Aurifero sin Procesar,,"",14164,18PO06757,,2018-12-20,
Physical Locations / AQP M / Existencias,Ubicaciones virtuales / Produccion,/ AQP M / Existencias,07,Mineral con Contenido Aurifero y Argentifero sin Procesar,M0002,t,LLAMPO,2018-12-31,2018-12-31,,MAMC-004245,,,MAMC-004245,,0,0.844000,0.000000,1421.3862559241706161,0,1199.6499999999999999884000,0.0000000000000000116000,0,"",241101 - Mineral Aurifero sin Procesar,,"",14164,,,,
Ubicaciones virtuales / Produccion,Physical Locations / AMCAQ / Existencias,/ AMCAQ / Existencias,08,Mineral con Contenido Aurifero y Argentifero sin Procesar,M0002,t,LLAMPO,2018-12-31,2018-12-31,,PAMC004251,,,PAMC004251,,0.844000,0,0.844000,1626.7519409478672986,1372.97863816,0,1372.97863816,1626.7519409478672986,"",241101 - Mineral Aurifero sin Procesar,,"",14164,,,,
Partner Locations / Suppliers,Physical Locations / AQP M / Existencias,/ AQP M / Existencias,03,Mineral con Contenido Aurifero y Argentifero sin Procesar,M0001,t,MINERAL AURIFERO Y ARGENTIFERO SIN PROCESAR,2018-12-20,2018-12-20,12/2018,AQP M\IN\04619,01,E001,0000918,COMUNIDAD CAMPESINA DE UNTUCA,3.077000,0,3.077000,2749.2265193370165746,8459.37,0,8459.37,2749.2265193370165746,602101 - Mineral Aurifero sin Procesar,241101 - Mineral Aurifero sin Procesar,,"",14165,18PO06757,,2018-12-20,
Physical Locations / AQP M / Existencias,Ubicaciones virtuales / Produccion,/ AQP M / Existencias,07,Mineral con Contenido Aurifero y Argentifero sin Procesar,M0001,t,MINERAL AURIFERO Y ARGENTIFERO SIN PROCESAR,2018-12-31,2018-12-31,,MAMC-004245,,,MAMC-004245,,0,3.077000,0.000000,2749.2265193370165746,0,8459.3700000000000000442000,-0.0000000000000000442000,0,"",241101 - Mineral Aurifero sin Procesar,,"",14165,,,,
Ubicaciones virtuales / Produccion,Physical Locations / AMCAQ / Existencias,/ AMCAQ / Existencias,08,Mineral con Contenido Aurifero y Argentifero sin Procesar,M0001,t,MINERAL AURIFERO Y ARGENTIFERO SIN PROCESAR,2018-12-31,2018-12-31,,PAMC004251,,,PAMC004251,,3.077000,0,3.077000,3019.6463165388365291,9291.45171599,0,9291.45171599,3019.6463165388365291,"",241101 - Mineral Aurifero sin Procesar,,"",14165,,,,
Partner Locations / Suppliers,Physical Locations / AQP M / Existencias,/ AQP M / Existencias,03,Mineral con Contenido Aurifero y Argentifero sin Procesar,M0002,t,LLAMPO,2018-12-20,2018-12-20,12/2018,AQP M\IN\04619,01,E001,0000918,COMUNIDAD CAMPESINA DE UNTUCA,0.621000,0,0.621000,1346.9243156199677939,836.44,0,836.44,1346.9243156199677939,602101 - Mineral Aurifero sin Procesar,241101 - Mineral Aurifero sin Procesar,,"",14166,18PO06757,,2018-12-20,
Physical Locations / AQP M / Existencias,Ubicaciones virtuales / Produccion,/ AQP M / Existencias,07,Mineral con Contenido Aurifero y Argentifero sin Procesar,M0002,t,LLAMPO,2018-12-31,2018-12-31,,MAMC-004245,,,MAMC-004245,,0,0.621000,0.000000,1346.9243156199677939,0,836.4400000000000000119000,-0.0000000000000000119000,0,"",241101 - Mineral Aurifero sin Procesar,,"",14166,,,,
Ubicaciones virtuales / Produccion,Physical Locations / AMCAQ / Existencias,/ AMCAQ / Existencias,08,Mineral con Contenido Aurifero y Argentifero sin Procesar,M0002,t,LLAMPO,2018-12-31,2018-12-31,,PAMC004251,,,PAMC004251,,0.621000,0,0.621000,1552.2865556360708535,963.96995105,0,963.96995105,1552.2865556360708535,"",241101 - Mineral Aurifero sin Procesar,,"",14166,,,,
Partner Locations / Suppliers,Physical Locations / AQP M / Existencias,/ AQP M / Existencias,03,Mineral con Contenido Aurifero y Argentifero sin Procesar,M0002,t,LLAMPO,2018-12-20,2018-12-20,12/2018,AQP M\IN\04619,01,E001,0000918,COMUNIDAD CAMPESINA DE UNTUCA,0.307000,0,0.307000,2013.4853420195439739,618.14,0,618.14,2013.4853420195439739,602101 - Mineral Aurifero sin Procesar,241101 - Mineral Aurifero sin Procesar,,"",14167,18PO06757,,2018-12-20,
Physical Locations / AQP M / Existencias,Ubicaciones virtuales / Produccion,/ AQP M / Existencias,07,Mineral con Contenido Aurifero y Argentifero sin Procesar,M0002,t,LLAMPO,2018-12-31,2018-12-31,,MAMC-004245,,,MAMC-004245,,0,0.307000,0.000000,2013.4853420195439739,0,618.1399999999999999873000,0.0000000000000000127000,0,"",241101 - Mineral Aurifero sin Procesar,,"",14167,,,,
Ubicaciones virtuales / Produccion,Physical Locations / AMCAQ / Existencias,/ AMCAQ / Existencias,08,Mineral con Contenido Aurifero y Argentifero sin Procesar,M0002,t,LLAMPO,2018-12-31,2018-12-31,,PAMC004251,,,PAMC004251,,0.307000,0,0.307000,2218.8509757980456026,681.18724957,0,681.18724957,2218.8509757980456026,"",241101 - Mineral Aurifero sin Procesar,,"",14167,,,,
Partner Locations / Suppliers,Physical Locations / AQP M / Existencias,/ AQP M / Existencias,03,Mineral con Contenido Aurifero y Argentifero sin Procesar,M0002,t,LLAMPO,2018-12-20,2018-12-20,12/2018,AQP M\IN\04619,01,E001,0000918,COMUNIDAD CAMPESINA DE UNTUCA,0.366000,0,0.366000,2758.7978142076502732,1009.72,0,1009.72,2758.7978142076502732,602101 - Mineral Aurifero sin Procesar,241101 - Mineral Aurifero sin Procesar,,"",14168,18PO06757,,2018-12-20,
Physical Locations / AQP M / Existencias,Ubicaciones virtuales / Produccion,/ AQP M / Existencias,07,Mineral con Contenido Aurifero y Argentifero sin Procesar,M0002,t,LLAMPO,2018-12-31,2018-12-31,,MAMC-004245,,,MAMC-004245,,0,0.366000,0.000000,2758.7978142076502732,0,1009.7199999999999999912000,0.0000000000000000088000,0,"",241101 - Mineral Aurifero sin Procesar,,"",14168,,,,
Ubicaciones virtuales / Produccion,Physical Locations / AMCAQ / Existencias,/ AMCAQ / Existencias,08,Mineral con Contenido Aurifero y Argentifero sin Procesar,M0002,t,LLAMPO,2018-12-31,2018-12-31,,PAMC004251,,,PAMC004251,,0.366000,0,0.366000,2964.1668769398907104,1084.88507696,0,1084.88507696,2964.1668769398907104,"",241101 - Mineral Aurifero sin Procesar,,"",14168,,,,
Ubicaciones virtuales / Transformacion Lote Trujillo,Physical Locations / AMCAQ / Existencias,/ AMCAQ / Existencias,06,Mineral con Contenido Aurifero y Argentifero sin Procesar,M0001,t,MINERAL AURIFERO Y ARGENTIFERO SIN PROCESAR,2018-12-20,2018-12-20,,ILT-000332,,,ILT-000332,NEGOCIOS ARGOS E.I.R.L.,12.156000,0,12.156000,691.0419560858835143,8400.30601818,0,8400.30601818,691.0419560858835143,"",241101 - Mineral Aurifero sin Procesar,,"",14169,,,2018-12-20,
Physical Locations / AMCTJ / Existencias,Ubicaciones virtuales / Transformacion Lote Trujillo,/ AMCTJ / Existencias,06,Mineral con Contenido Aurifero y Argentifero sin Procesar,M0001,t,MINERAL AURIFERO Y ARGENTIFERO SIN PROCESAR,2018-12-20,2018-12-20,,CLT-000317,,,CLT-000317,NEGOCIOS ARGOS E.I.R.L.,0,12.156000,-12.156000,0,0,0.000000,0.000000,0,"",241101 - Mineral Aurifero sin Procesar,0000 LOTES TRUJILLO,"",14169,,,2018-12-20,
Partner Locations / Suppliers,Physical Locations / AQP M / Existencias,/ AQP M / Existencias,03,Mineral con Contenido Aurifero y Argentifero sin Procesar,M0001,t,MINERAL AURIFERO Y ARGENTIFERO SIN PROCESAR,2018-12-20,2018-12-20,12/2018,AQP M\IN\04634,01,0001,0001275,EDWIN CUNO QUIÑONES,8.631000,0,8.631000,1009.0105433901054339,8708.77,0,8708.77,1009.0105433901054339,602101 - Mineral Aurifero sin Procesar,241101 - Mineral Aurifero sin Procesar,,"",14170,18PO06796,,2018-12-20,
Physical Locations / AQP M / Existencias,Ubicaciones virtuales / Produccion,/ AQP M / Existencias,07,Mineral con Contenido Aurifero y Argentifero sin Procesar,M0001,t,MINERAL AURIFERO Y ARGENTIFERO SIN PROCESAR,2018-12-31,2018-12-31,,MAMC-004246,,,MAMC-004246,,0,8.631000,0.000000,1009.0105433901054339,0,8708.7699999999999999909000,0.0000000000000000091000,0,"",241101 - Mineral Aurifero sin Procesar,,"",14170,,,,
Ubicaciones virtuales / Produccion,Physical Locations / AMCAQ / Existencias,/ AMCAQ / Existencias,08,Mineral con Contenido Aurifero y Argentifero sin Procesar,M0001,t,MINERAL AURIFERO Y ARGENTIFERO SIN PROCESAR,2018-12-31,2018-12-31,,PAMC004252,,,PAMC004252,,8.631000,0,8.631000,1279.4306620542231491,11042.76604419,0,11042.76604419,1279.4306620542231491,"",241101 - Mineral Aurifero sin Procesar,,"",14170,,,,
Ubicaciones virtuales / Transformacion Lote Trujillo,Physical Locations / AMCAQ / Existencias,/ AMCAQ / Existencias,06,Mineral con Contenido Aurifero y Argentifero sin Procesar,M0001,t,MINERAL AURIFERO Y ARGENTIFERO SIN PROCESAR,2018-12-20,2018-12-20,,ILT-000342,,,ILT-000342,NEGOCIOS ARGOS E.I.R.L.,21.956000,0,21.956000,7178.5237402418473310,157611.66724075,0,157611.66724075,7178.5237402418473310,"",241101 - Mineral Aurifero sin Procesar,,"",14171,,,2018-12-20,
Physical Locations / AMCTJ / Existencias,Ubicaciones virtuales / Transformacion Lote Trujillo,/ AMCTJ / Existencias,06,Mineral con Contenido Aurifero y Argentifero sin Procesar,M0001,t,MINERAL AURIFERO Y ARGENTIFERO SIN PROCESAR,2018-12-20,2018-12-20,,CLT-000327,,,CLT-000327,NEGOCIOS ARGOS E.I.R.L.,0,21.956000,-21.956000,0,0,0.000000,0.000000,0,"",241101 - Mineral Aurifero sin Procesar,0000 LOTES TRUJILLO,"",14171,,,2018-12-20,
Ubicaciones virtuales / Transformacion Lote Trujillo,Physical Locations / AMCAQ / Existencias,/ AMCAQ / Existencias,06,Mineral con Contenido Aurifero y Argentifero sin Procesar,M0001,t,MINERAL AURIFERO Y ARGENTIFERO SIN PROCESAR,2018-12-21,2018-12-21,,ILT-000349,,,ILT-000349,JENNY MAYERLING ARANDA MORILLO,9.449000,0,9.449000,956.0556385194200444,9033.76972837,0,9033.76972837,956.0556385194200444,"",241101 - Mineral Aurifero sin Procesar,,"",14172,,,2018-12-21,
Physical Locations / AMCTJ / Existencias,Ubicaciones virtuales / Transformacion Lote Trujillo,/ AMCTJ / Existencias,06,Mineral con Contenido Aurifero y Argentifero sin Procesar,M0001,t,MINERAL AURIFERO Y ARGENTIFERO SIN PROCESAR,2018-12-21,2018-12-21,,CLT-000334,,,CLT-000334,JENNY MAYERLING ARANDA MORILLO,0,9.449000,-9.449000,0,0,0.000000,0.000000,0,"",241101 - Mineral Aurifero sin Procesar,0000 LOTES TRUJILLO,"",14172,,,2018-12-21,
Partner Locations / Suppliers,Physical Locations / AQP M / Existencias,/ AQP M / Existencias,03,Mineral con Contenido Aurifero y Argentifero sin Procesar,M0001,t,MINERAL AURIFERO Y ARGENTIFERO SIN PROCESAR,2018-12-20,2018-12-20,12/2018,AQP M\IN\04634,01,0001,0001275,EDWIN CUNO QUIÑONES,4.780000,0,4.780000,1109.7196652719665272,5304.46,0,5304.46,1109.7196652719665272,602101 - Mineral Aurifero sin Procesar,241101 - Mineral Aurifero sin Procesar,,"",14173,18PO06796,,2018-12-20,
Physical Locations / AQP M / Existencias,Ubicaciones virtuales / Produccion,/ AQP M / Existencias,07,Mineral con Contenido Aurifero y Argentifero sin Procesar,M0001,t,MINERAL AURIFERO Y ARGENTIFERO SIN PROCESAR,2018-12-31,2018-12-31,,MAMC-004246,,,MAMC-004246,,0,4.780000,0.000000,1109.7196652719665272,0,5304.4600000000000000160000,-0.0000000000000000160000,0,"",241101 - Mineral Aurifero sin Procesar,,"",14173,,,,
Ubicaciones virtuales / Produccion,Physical Locations / AMCAQ / Existencias,/ AMCAQ / Existencias,08,Mineral con Contenido Aurifero y Argentifero sin Procesar,M0001,t,MINERAL AURIFERO Y ARGENTIFERO SIN PROCESAR,2018-12-31,2018-12-31,,PAMC004252,,,PAMC004252,,4.780000,0,4.780000,1380.1397383598326360,6597.06794936,0,6597.06794936,1380.1397383598326360,"",241101 - Mineral Aurifero sin Procesar,,"",14173,,,,
Ubicaciones virtuales / Transformacion Lote Trujillo,Physical Locations / AMCAQ / Existencias,/ AMCAQ / Existencias,06,Mineral con Contenido Aurifero y Argentifero sin Procesar,M0001,t,MINERAL AURIFERO Y ARGENTIFERO SIN PROCESAR,2018-12-20,2018-12-20,,ILT-000335,,,ILT-000335,LEYDEN VEGA CASTAÑEDA,22.307000,0,22.307000,990.8497841045411754,22102.88613402,0,22102.88613402,990.8497841045411754,"",241101 - Mineral Aurifero sin Procesar,,"",14174,,,2018-12-20,
Physical Locations / AMCTJ / Existencias,Ubicaciones virtuales / Transformacion Lote Trujillo,/ AMCTJ / Existencias,06,Mineral con Contenido Aurifero y Argentifero sin Procesar,M0001,t,MINERAL AURIFERO Y ARGENTIFERO SIN PROCESAR,2018-12-20,2018-12-20,,CLT-000320,,,CLT-000320,LEYDEN VEGA CASTAÑEDA,0,22.307000,-22.307000,0,0,0.000000,0.000000,0,"",241101 - Mineral Aurifero sin Procesar,0000 LOTES TRUJILLO,"",14174,,,2018-12-20,
Partner Locations / Suppliers,Physical Locations / AQP M / Existencias,/ AQP M / Existencias,03,Mineral con Contenido Aurifero y Argentifero sin Procesar,M0001,t,MINERAL AURIFERO Y ARGENTIFERO SIN PROCESAR,2018-12-20,2018-12-20,12/2018,AQP M\IN\04634,01,0001,0001275,EDWIN CUNO QUIÑONES,6.018000,0,6.018000,528.4130940511797940,3179.99,0,3179.99,528.4130940511797940,602101 - Mineral Aurifero sin Procesar,241101 - Mineral Aurifero sin Procesar,,"",14175,18PO06796,,2018-12-20,
Physical Locations / AQP M / Existencias,Ubicaciones virtuales / Produccion,/ AQP M / Existencias,07,Mineral con Contenido Aurifero y Argentifero sin Procesar,M0001,t,MINERAL AURIFERO Y ARGENTIFERO SIN PROCESAR,2018-12-31,2018-12-31,,MAMC-004246,,,MAMC-004246,,0,6.018000,0.000000,528.4130940511797940,0,3179.9900000000000002920000,-0.0000000000000002920000,0,"",241101 - Mineral Aurifero sin Procesar,,"",14175,,,,
Ubicaciones virtuales / Produccion,Physical Locations / AMCAQ / Existencias,/ AMCAQ / Existencias,08,Mineral con Contenido Aurifero y Argentifero sin Procesar,M0001,t,MINERAL AURIFERO Y ARGENTIFERO SIN PROCESAR,2018-12-31,2018-12-31,,PAMC004252,,,PAMC004252,,6.018000,0,6.018000,798.8333461083416417,4807.37907688,0,4807.37907688,798.8333461083416417,"",241101 - Mineral Aurifero sin Procesar,,"",14175,,,,
Partner Locations / Suppliers,Physical Locations / AQP M / Existencias,/ AQP M / Existencias,03,Mineral con Contenido Aurifero y Argentifero sin Procesar,M0002,t,LLAMPO,2018-12-23,2018-12-23,12/2018,AQP M\IN\04637,01,0002,0000130,LUIS GONZAGA VALDIVIA RANILLA,0.540000,0,0.540000,1065.0370370370370370,575.12,0,575.12,1065.0370370370370370,602101 - Mineral Aurifero sin Procesar,241101 - Mineral Aurifero sin Procesar,,"",14176,18PO06802,,2018-12-23,
Physical Locations / AQP M / Existencias,Ubicaciones virtuales / Produccion,/ AQP M / Existencias,07,Mineral con Contenido Aurifero y Argentifero sin Procesar,M0002,t,LLAMPO,2018-12-31,2018-12-31,,MAMC-004246,,,MAMC-004246,,0,0.540000,0.000000,1065.0370370370370370,0,575.1199999999999999800000,0.0000000000000000200000,0,"",241101 - Mineral Aurifero sin Procesar,,"",14176,,,,
Ubicaciones virtuales / Produccion,Physical Locations / AMCAQ / Existencias,/ AMCAQ / Existencias,08,Mineral con Contenido Aurifero y Argentifero sin Procesar,M0002,t,LLAMPO,2018-12-31,2018-12-31,,PAMC004252,,,PAMC004252,,0.540000,0,0.540000,1270.4019789444444444,686.01706863,0,686.01706863,1270.4019789444444444,"",241101 - Mineral Aurifero sin Procesar,,"",14176,,,,
Partner Locations / Suppliers,Physical Locations / AQP M / Existencias,/ AQP M / Existencias,03,Mineral con Contenido Aurifero y Argentifero sin Procesar,M0001,t,MINERAL AURIFERO Y ARGENTIFERO SIN PROCESAR,2018-12-21,2018-12-21,12/2018,AQP M\IN\04626,01,0002,0000009,VALENTIN PERLACIO  CALDERON,9.632000,0,9.632000,1701.1731727574750831,16385.7,0,16385.7,1701.1731727574750831,602101 - Mineral Aurifero sin Procesar,241101 - Mineral Aurifero sin Procesar,,"",14177,18PO06774,,2018-12-21,
Physical Locations / AQP M / Existencias,Ubicaciones virtuales / Produccion,/ AQP M / Existencias,07,Mineral con Contenido Aurifero y Argentifero sin Procesar,M0001,t,MINERAL AURIFERO Y ARGENTIFERO SIN PROCESAR,2018-12-31,2018-12-31,,MAMC-004246,,,MAMC-004246,,0,9.632000,0.000000,1701.1731727574750831,0,16385.7000000000000004192000,-0.0000000000000004192000,0,"",241101 - Mineral Aurifero sin Procesar,,"",14177,,,,
Ubicaciones virtuales / Produccion,Physical Locations / AMCAQ / Existencias,/ AMCAQ / Existencias,08,Mineral con Contenido Aurifero y Argentifero sin Procesar,M0001,t,MINERAL AURIFERO Y ARGENTIFERO SIN PROCESAR,2018-12-31,2018-12-31,,PAMC004252,,,PAMC004252,,9.632000,0,9.632000,1971.5932596397425249,18990.38627685,0,18990.38627685,1971.5932596397425249,"",241101 - Mineral Aurifero sin Procesar,,"",14177,,,,
Partner Locations / Suppliers,Physical Locations / AQP M / Existencias,/ AQP M / Existencias,03,Mineral con Contenido Aurifero y Argentifero sin Procesar,M0001,t,MINERAL AURIFERO Y ARGENTIFERO SIN PROCESAR,2018-12-21,2018-12-21,12/2018,AQP M\IN\04626,01,0002,0000009,VALENTIN PERLACIO  CALDERON,9.361000,0,9.361000,1482.5819891037282342,13878.45,0,13878.45,1482.5819891037282342,602101 - Mineral Aurifero sin Procesar,241101 - Mineral Aurifero sin Procesar,,"",14178,18PO06774,,2018-12-21,
Physical Locations / AQP M / Existencias,Ubicaciones virtuales / Produccion,/ AQP M / Existencias,07,Mineral con Contenido Aurifero y Argentifero sin Procesar,M0001,t,MINERAL AURIFERO Y ARGENTIFERO SIN PROCESAR,2018-12-31,2018-12-31,,MAMC-004246,,,MAMC-004246,,0,9.361000,0.000000,1482.5819891037282342,0,13878.4500000000000003462000,-0.0000000000000003462000,0,"",241101 - Mineral Aurifero sin Procesar,,"",14178,,,,
Ubicaciones virtuales / Produccion,Physical Locations / AMCAQ / Existencias,/ AMCAQ / Existencias,08,Mineral con Contenido Aurifero y Argentifero sin Procesar,M0001,t,MINERAL AURIFERO Y ARGENTIFERO SIN PROCESAR,2018-12-31,2018-12-31,,PAMC004252,,,PAMC004252,,9.361000,0,9.361000,1753.0020378303600043,16409.85207613,0,16409.85207613,1753.0020378303600043,"",241101 - Mineral Aurifero sin Procesar,,"",14178,,,,
Partner Locations / Suppliers,Physical Locations / AQP M / Existencias,/ AQP M / Existencias,03,Mineral con Contenido Aurifero y Argentifero sin Procesar,M0001,t,MINERAL AURIFERO Y ARGENTIFERO SIN PROCESAR,2018-12-21,2018-12-21,12/2018,AQP M\IN\04626,01,0002,0000009,VALENTIN PERLACIO  CALDERON,7.401000,0,7.401000,1740.7971895689771652,12883.64,0,12883.64,1740.7971895689771652,602101 - Mineral Aurifero sin Procesar,241101 - Mineral Aurifero sin Procesar,,"",14179,18PO06774,,2018-12-21,
Physical Locations / AQP M / Existencias,Ubicaciones virtuales / Produccion,/ AQP M / Existencias,07,Mineral con Contenido Aurifero y Argentifero sin Procesar,M0001,t,MINERAL AURIFERO Y ARGENTIFERO SIN PROCESAR,2018-12-31,2018-12-31,,MAMC-004246,,,MAMC-004246,,0,7.401000,0.000000,1740.7971895689771652,0,12883.6399999999999996452000,0.0000000000000003548000,0,"",241101 - Mineral Aurifero sin Procesar,,"",14179,,,,
Ubicaciones virtuales / Produccion,Physical Locations / AMCAQ / Existencias,/ AMCAQ / Existencias,08,Mineral con Contenido Aurifero y Argentifero sin Procesar,M0001,t,MINERAL AURIFERO Y ARGENTIFERO SIN PROCESAR,2018-12-31,2018-12-31,,PAMC004252,,,PAMC004252,,7.401000,0,7.401000,2011.2174181461964599,14885.0201117,0,14885.0201117,2011.2174181461964599,"",241101 - Mineral Aurifero sin Procesar,,"",14179,,,,
Ubicaciones virtuales / Transformacion Lote Trujillo,Physical Locations / AMCAQ / Existencias,/ AMCAQ / Existencias,06,Mineral con Contenido Aurifero y Argentifero sin Procesar,M0001,t,MINERAL AURIFERO Y ARGENTIFERO SIN PROCESAR,2018-12-15,2018-12-15,,ILT-000330,,,ILT-000330,NEGOCIOS ARGOS E.I.R.L.,12.713000,0,12.713000,2640.1119609132384174,33563.74335909,0,33563.74335909,2640.1119609132384174,"",241101 - Mineral Aurifero sin Procesar,,"",14180,,,2018-12-15,
Physical Locations / AMCTJ / Existencias,Ubicaciones virtuales / Transformacion Lote Trujillo,/ AMCTJ / Existencias,06,Mineral con Contenido Aurifero y Argentifero sin Procesar,M0001,t,MINERAL AURIFERO Y ARGENTIFERO SIN PROCESAR,2018-12-15,2018-12-15,,CLT-000315,,,CLT-000315,NEGOCIOS ARGOS E.I.R.L.,0,12.713000,-12.713000,0,0,0.000000,0.000000,0,"",241101 - Mineral Aurifero sin Procesar,0000 LOTES TRUJILLO,"",14180,,,2018-12-15,
Ubicaciones virtuales / Transformacion Lote Trujillo,Physical Locations / AMCAQ / Existencias,/ AMCAQ / Existencias,06,Mineral con Contenido Aurifero y Argentifero sin Procesar,M0001,t,MINERAL AURIFERO Y ARGENTIFERO SIN PROCESAR,2018-12-21,2018-12-21,,ILT-000349,,,ILT-000349,JENNY MAYERLING ARANDA MORILLO,15.826000,0,15.826000,956.0556385201567042,15130.53653522,0,15130.53653522,956.0556385201567042,"",241101 - Mineral Aurifero sin Procesar,,"",14181,,,2018-12-21,
Physical Locations / AMCTJ / Existencias,Ubicaciones virtuales / Transformacion Lote Trujillo,/ AMCTJ / Existencias,06,Mineral con Contenido Aurifero y Argentifero sin Procesar,M0001,t,MINERAL AURIFERO Y ARGENTIFERO SIN PROCESAR,2018-12-21,2018-12-21,,CLT-000334,,,CLT-000334,JENNY MAYERLING ARANDA MORILLO,0,15.826000,-15.826000,0,0,0.000000,0.000000,0,"",241101 - Mineral Aurifero sin Procesar,0000 LOTES TRUJILLO,"",14181,,,2018-12-21,
Partner Locations / Suppliers,Physical Locations / AQP M / Existencias,/ AQP M / Existencias,03,Mineral con Contenido Aurifero y Argentifero sin Procesar,M0002,t,LLAMPO,2018-12-21,2018-12-21,12/2018,AQP M\IN\04639,01,E001,0000925,COMUNIDAD CAMPESINA DE UNTUCA,2.175000,0,2.175000,1293.8988505747126437,2814.23,0,2814.23,1293.8988505747126437,602101 - Mineral Aurifero sin Procesar,241101 - Mineral Aurifero sin Procesar,,"",14182,18PO06817,,2018-12-21,
Physical Locations / AQP M / Existencias,Ubicaciones virtuales / Produccion,/ AQP M / Existencias,07,Mineral con Contenido Aurifero y Argentifero sin Procesar,M0002,t,LLAMPO,2018-12-31,2018-12-31,,MAMC-004246,,,MAMC-004246,,0,2.175000,0.000000,1293.8988505747126437,0,2814.2300000000000000475000,-0.0000000000000000475000,0,"",241101 - Mineral Aurifero sin Procesar,,"",14182,,,,
Ubicaciones virtuales / Produccion,Physical Locations / AMCAQ / Existencias,/ AMCAQ / Existencias,08,Mineral con Contenido Aurifero y Argentifero sin Procesar,M0002,t,LLAMPO,2018-12-31,2018-12-31,,PAMC004252,,,PAMC004252,,2.175000,0,2.175000,1499.2644668643678161,3260.90021543,0,3260.90021543,1499.2644668643678161,"",241101 - Mineral Aurifero sin Procesar,,"",14182,,,,
Partner Locations / Suppliers,Physical Locations / AQP M / Existencias,/ AQP M / Existencias,03,Mineral con Contenido Aurifero y Argentifero sin Procesar,M0001,t,MINERAL AURIFERO Y ARGENTIFERO SIN PROCESAR,2018-12-21,2018-12-21,12/2018,AQP M\IN\04639,01,E001,0000925,COMUNIDAD CAMPESINA DE UNTUCA,5.360000,0,5.360000,453.1305970149253731,2428.78,0,2428.78,453.1305970149253731,602101 - Mineral Aurifero sin Procesar,241101 - Mineral Aurifero sin Procesar,,"",14183,18PO06817,,2018-12-21,
Physical Locations / AQP M / Existencias,Ubicaciones virtuales / Produccion,/ AQP M / Existencias,07,Mineral con Contenido Aurifero y Argentifero sin Procesar,M0001,t,MINERAL AURIFERO Y ARGENTIFERO SIN PROCESAR,2018-12-31,2018-12-31,,MAMC-004246,,,MAMC-004246,,0,5.360000,0.000000,453.1305970149253731,0,2428.7799999999999998160000,0.0000000000000001840000,0,"",241101 - Mineral Aurifero sin Procesar,,"",14183,,,,
Ubicaciones virtuales / Produccion,Physical Locations / AMCAQ / Existencias,/ AMCAQ / Existencias,08,Mineral con Contenido Aurifero y Argentifero sin Procesar,M0001,t,MINERAL AURIFERO Y ARGENTIFERO SIN PROCESAR,2018-12-31,2018-12-31,,PAMC004252,,,PAMC004252,,5.360000,0,5.360000,723.5510117667910448,3878.23342307,0,3878.23342307,723.5510117667910448,"",241101 - Mineral Aurifero sin Procesar,,"",14183,,,,
Partner Locations / Suppliers,Physical Locations / AQP M / Existencias,/ AQP M / Existencias,03,Mineral con Contenido Aurifero y Argentifero sin Procesar,M0001,t,MINERAL AURIFERO Y ARGENTIFERO SIN PROCESAR,2018-12-21,2018-12-21,12/2018,AQP M\IN\04639,01,E001,0000925,COMUNIDAD CAMPESINA DE UNTUCA,5.294000,0,5.294000,134.4540989799773328,711.8,0,711.8,134.4540989799773328,602101 - Mineral Aurifero sin Procesar,241101 - Mineral Aurifero sin Procesar,,"",14184,18PO06817,,2018-12-21,
Physical Locations / AQP M / Existencias,Ubicaciones virtuales / Produccion,/ AQP M / Existencias,07,Mineral con Contenido Aurifero y Argentifero sin Procesar,M0001,t,MINERAL AURIFERO Y ARGENTIFERO SIN PROCESAR,2018-12-31,2018-12-31,,MAMC-004246,,,MAMC-004246,,0,5.294000,0.000000,134.4540989799773328,0,711.7999999999999998432000,0.0000000000000001568000,0,"",241101 - Mineral Aurifero sin Procesar,,"",14184,,,,
Ubicaciones virtuales / Produccion,Physical Locations / AMCAQ / Existencias,/ AMCAQ / Existencias,08,Mineral con Contenido Aurifero y Argentifero sin Procesar,M0001,t,MINERAL AURIFERO Y ARGENTIFERO SIN PROCESAR,2018-12-31,2018-12-31,,PAMC004252,,,PAMC004252,,5.294000,0,5.294000,404.8739864242538723,2143.40288413,0,2143.40288413,404.8739864242538723,"",241101 - Mineral Aurifero sin Procesar,,"",14184,,,,
Partner Locations / Suppliers,Physical Locations / AQP M / Existencias,/ AQP M / Existencias,03,Mineral con Contenido Aurifero y Argentifero sin Procesar,M0001,t,MINERAL AURIFERO Y ARGENTIFERO SIN PROCESAR,2018-12-21,2018-12-21,12/2018,AQP M\IN\04639,01,E001,0000925,COMUNIDAD CAMPESINA DE UNTUCA,2.135000,0,2.135000,428.1405152224824356,914.08,0,914.08,428.1405152224824356,602101 - Mineral Aurifero sin Procesar,241101 - Mineral Aurifero sin Procesar,,"",14185,18PO06817,,2018-12-21,
Physical Locations / AQP M / Existencias,Ubicaciones virtuales / Produccion,/ AQP M / Existencias,07,Mineral con Contenido Aurifero y Argentifero sin Procesar,M0001,t,MINERAL AURIFERO Y ARGENTIFERO SIN PROCESAR,2018-12-31,2018-12-31,,MAMC-004247,,,MAMC-004247,,0,2.135000,0.000000,428.1405152224824356,0,914.0800000000000000060000,-0.0000000000000000060000,0,"",241101 - Mineral Aurifero sin Procesar,,"",14185,,,,
Ubicaciones virtuales / Produccion,Physical Locations / AMCAQ / Existencias,/ AMCAQ / Existencias,08,Mineral con Contenido Aurifero y Argentifero sin Procesar,M0001,t,MINERAL AURIFERO Y ARGENTIFERO SIN PROCESAR,2018-12-31,2018-12-31,,PAMC004253,,,PAMC004253,,2.135000,0,2.135000,698.5607595362997658,1491.42722161,0,1491.42722161,698.5607595362997658,"",241101 - Mineral Aurifero sin Procesar,,"",14185,,,,
Partner Locations / Suppliers,Physical Locations / AQP M / Existencias,/ AQP M / Existencias,03,Mineral con Contenido Aurifero y Argentifero sin Procesar,M0001,t,MINERAL AURIFERO Y ARGENTIFERO SIN PROCESAR,2018-12-21,2018-12-21,12/2018,AQP M\IN\04639,01,E001,0000925,COMUNIDAD CAMPESINA DE UNTUCA,4.004000,0,4.004000,428.1343656343656344,1714.25,0,1714.25,428.1343656343656344,602101 - Mineral Aurifero sin Procesar,241101 - Mineral Aurifero sin Procesar,,"",14186,18PO06817,,2018-12-21,
Physical Locations / AQP M / Existencias,Ubicaciones virtuales / Produccion,/ AQP M / Existencias,07,Mineral con Contenido Aurifero y Argentifero sin Procesar,M0001,t,MINERAL AURIFERO Y ARGENTIFERO SIN PROCESAR,2018-12-31,2018-12-31,,MAMC-004247,,,MAMC-004247,,0,4.004000,0.000000,428.1343656343656344,0,1714.2500000000000001376000,-0.0000000000000001376000,0,"",241101 - Mineral Aurifero sin Procesar,,"",14186,,,,
Ubicaciones virtuales / Produccion,Physical Locations / AMCAQ / Existencias,/ AMCAQ / Existencias,08,Mineral con Contenido Aurifero y Argentifero sin Procesar,M0001,t,MINERAL AURIFERO Y ARGENTIFERO SIN PROCESAR,2018-12-31,2018-12-31,,PAMC004253,,,PAMC004253,,4.004000,0,4.004000,698.5541691883116883,2797.01089343,0,2797.01089343,698.5541691883116883,"",241101 - Mineral Aurifero sin Procesar,,"",14186,,,,
Partner Locations / Suppliers,Physical Locations / AQP M / Existencias,/ AQP M / Existencias,03,Mineral con Contenido Aurifero y Argentifero sin Procesar,M0001,t,MINERAL AURIFERO Y ARGENTIFERO SIN PROCESAR,2018-12-21,2018-12-21,12/2018,AQP M\IN\04639,01,E001,0000925,COMUNIDAD CAMPESINA DE UNTUCA,5.261000,0,5.261000,296.6394221630868656,1560.62,0,1560.62,296.6394221630868656,602101 - Mineral Aurifero sin Procesar,241101 - Mineral Aurifero sin Procesar,,"",14187,18PO06817,,2018-12-21,
Physical Locations / AQP M / Existencias,Ubicaciones virtuales / Produccion,/ AQP M / Existencias,07,Mineral con Contenido Aurifero y Argentifero sin Procesar,M0001,t,MINERAL AURIFERO Y ARGENTIFERO SIN PROCESAR,2018-12-31,2018-12-31,,MAMC-004247,,,MAMC-004247,,0,5.261000,0.000000,296.6394221630868656,0,1560.6199999999999999216000,0.0000000000000000784000,0,"",241101 - Mineral Aurifero sin Procesar,,"",14187,,,,
Ubicaciones virtuales / Produccion,Physical Locations / AMCAQ / Existencias,/ AMCAQ / Existencias,08,Mineral con Contenido Aurifero y Argentifero sin Procesar,M0001,t,MINERAL AURIFERO Y ARGENTIFERO SIN PROCESAR,2018-12-31,2018-12-31,,PAMC004253,,,PAMC004253,,5.261000,0,5.261000,567.0592599353735031,2983.29876652,0,2983.29876652,567.0592599353735031,"",241101 - Mineral Aurifero sin Procesar,,"",14187,,,,
Partner Locations / Suppliers,Physical Locations / AQP M / Existencias,/ AQP M / Existencias,03,Mineral con Contenido Aurifero y Argentifero sin Procesar,M0001,t,MINERAL AURIFERO Y ARGENTIFERO SIN PROCESAR,2018-12-21,2018-12-21,12/2018,AQP M\IN\04639,01,E001,0000925,COMUNIDAD CAMPESINA DE UNTUCA,3.631000,0,3.631000,0.00000000000000000000,0,0,0,0.00000000000000000000,,241101 - Mineral Aurifero sin Procesar,,"",14188,18PO06817,,2018-12-21,
Physical Locations / AQP M / Existencias,Ubicaciones virtuales / Produccion,/ AQP M / Existencias,07,Mineral con Contenido Aurifero y Argentifero sin Procesar,M0001,t,MINERAL AURIFERO Y ARGENTIFERO SIN PROCESAR,2018-12-31,2018-12-31,,MAMC-004247,,,MAMC-004247,,0,3.631000,0.000000,0.00000000000000000000,0,0.00000000000000000000000000,0.00000000000000000000000000,0,"",241101 - Mineral Aurifero sin Procesar,,"",14188,,,,
Ubicaciones virtuales / Produccion,Physical Locations / AMCAQ / Existencias,/ AMCAQ / Existencias,08,Mineral con Contenido Aurifero y Argentifero sin Procesar,M0001,t,MINERAL AURIFERO Y ARGENTIFERO SIN PROCESAR,2018-12-31,2018-12-31,,PAMC004253,,,PAMC004253,,3.631000,0,3.631000,270.4198395318094189,981.89443734,0,981.89443734,270.4198395318094189,"",241101 - Mineral Aurifero sin Procesar,,"",14188,,,,
Partner Locations / Suppliers,Physical Locations / AQP M / Existencias,/ AQP M / Existencias,03,Mineral con Contenido Aurifero y Argentifero sin Procesar,M0001,t,MINERAL AURIFERO Y ARGENTIFERO SIN PROCESAR,2018-12-21,2018-12-21,12/2018,AQP M\IN\04627,01,0002,0000008,VALENTIN PERLACIO  CALDERON,4.773000,0,4.773000,1569.5851665619107480,7491.63,0,7491.63,1569.5851665619107480,602101 - Mineral Aurifero sin Procesar,241101 - Mineral Aurifero sin Procesar,,"",14189,18PO06775,,2018-12-21,
Physical Locations / AQP M / Existencias,Ubicaciones virtuales / Produccion,/ AQP M / Existencias,07,Mineral con Contenido Aurifero y Argentifero sin Procesar,M0001,t,MINERAL AURIFERO Y ARGENTIFERO SIN PROCESAR,2018-12-31,2018-12-31,,MAMC-004247,,,MAMC-004247,,0,4.773000,0.000000,1569.5851665619107480,0,7491.6300000000000002040000,-0.0000000000000002040000,0,"",241101 - Mineral Aurifero sin Procesar,,"",14189,,,,
Ubicaciones virtuales / Produccion,Physical Locations / AMCAQ / Existencias,/ AMCAQ / Existencias,08,Mineral con Contenido Aurifero y Argentifero sin Procesar,M0001,t,MINERAL AURIFERO Y ARGENTIFERO SIN PROCESAR,2018-12-31,2018-12-31,,PAMC004253,,,PAMC004253,,4.773000,0,4.773000,1840.0058223842447098,8782.34779024,0,8782.34779024,1840.0058223842447098,"",241101 - Mineral Aurifero sin Procesar,,"",14189,,,,
Partner Locations / Suppliers,Physical Locations / AQP M / Existencias,/ AQP M / Existencias,03,Mineral con Contenido Aurifero y Argentifero sin Procesar,M0001,t,MINERAL AURIFERO Y ARGENTIFERO SIN PROCESAR,2018-12-22,2018-12-22,12/2018,AQP M\IN\04635,01,0002,0000129,LUIS GONZAGA VALDIVIA RANILLA,0.738000,0,0.738000,2994.2682926829268293,2209.77,0,2209.77,2994.2682926829268293,602101 - Mineral Aurifero sin Procesar,241101 - Mineral Aurifero sin Procesar,,"",14190,18PO06797,,2018-12-22,
Physical Locations / AQP M / Existencias,Ubicaciones virtuales / Produccion,/ AQP M / Existencias,07,Mineral con Contenido Aurifero y Argentifero sin Procesar,M0001,t,MINERAL AURIFERO Y ARGENTIFERO SIN PROCESAR,2018-12-31,2018-12-31,,MAMC-004247,,,MAMC-004247,,0,0.738000,0.000000,2994.2682926829268293,0,2209.7700000000000000234000,-0.0000000000000000234000,0,"",241101 - Mineral Aurifero sin Procesar,,"",14190,,,,
Ubicaciones virtuales / Produccion,Physical Locations / AMCAQ / Existencias,/ AMCAQ / Existencias,08,Mineral con Contenido Aurifero y Argentifero sin Procesar,M0001,t,MINERAL AURIFERO Y ARGENTIFERO SIN PROCESAR,2018-12-31,2018-12-31,,PAMC004253,,,PAMC004253,,0.738000,0,0.738000,3264.6899590514905149,2409.34118978,0,2409.34118978,3264.6899590514905149,"",241101 - Mineral Aurifero sin Procesar,,"",14190,,,,
Partner Locations / Suppliers,Physical Locations / AQP M / Existencias,/ AQP M / Existencias,03,Mineral con Contenido Aurifero y Argentifero sin Procesar,M0001,t,MINERAL AURIFERO Y ARGENTIFERO SIN PROCESAR,2018-12-22,2018-12-22,12/2018,AQP M\IN\04648,01,E001,0000011,EDWIN RUFO CHOQUE  CHANCOLLA,3.733000,0,3.733000,1037.5167425663005626,3873.05,0,3873.05,1037.5167425663005626,602101 - Mineral Aurifero sin Procesar,241101 - Mineral Aurifero sin Procesar,,"",14191,18PO06920,,2018-12-22,
,,/ AQP M / Existencias,"",Mineral con Contenido Aurifero y Argentifero sin Procesar,"","",MINERAL AURIFERO Y ARGENTIFERO SIN PROCESAR,,2018-12-28,12/2018,,01,E001,0000012,EDWIN RUFO CHOQUE  CHANCOLLA,0,0,3.733000,1188.2560942941334048,562.71,0,4435.76,1188.2560942941334048,609201,241101 - Mineral Aurifero sin Procesar,"",,14191,,,,t
Physical Locations / AQP M / Existencias,Ubicaciones virtuales / Produccion,/ AQP M / Existencias,07,Mineral con Contenido Aurifero y Argentifero sin Procesar,M0001,t,MINERAL AURIFERO Y ARGENTIFERO SIN PROCESAR,2018-12-31,2018-12-31,,MAMC-004247,,,MAMC-004247,,0,3.733000,0.000000,1188.2560942941334048,0,4435.7600000000000001184000,-0.0000000000000001184000,0,"",241101 - Mineral Aurifero sin Procesar,,"",14191,,,,
Ubicaciones virtuales / Produccion,Physical Locations / AMCAQ / Existencias,/ AMCAQ / Existencias,08,Mineral con Contenido Aurifero y Argentifero sin Procesar,M0001,t,MINERAL AURIFERO Y ARGENTIFERO SIN PROCESAR,2018-12-31,2018-12-31,,PAMC004253,,,PAMC004253,,3.733000,0,3.733000,1458.6763887570318778,5445.23895923,0,5445.23895923,1458.6763887570318778,"",241101 - Mineral Aurifero sin Procesar,,"",14191,,,,
Partner Locations / Suppliers,Physical Locations / AQP M / Existencias,/ AQP M / Existencias,03,Mineral con Contenido Aurifero y Argentifero sin Procesar,M0001,t,MINERAL AURIFERO Y ARGENTIFERO SIN PROCESAR,2018-12-22,2018-12-22,12/2018,AQP M\IN\04648,01,E001,0000011,EDWIN RUFO CHOQUE  CHANCOLLA,15.273000,0,15.273000,573.8185032410135533,8763.93,0,8763.93,573.8185032410135533,602101 - Mineral Aurifero sin Procesar,241101 - Mineral Aurifero sin Procesar,,"",14192,18PO06920,,2018-12-22,
,,/ AQP M / Existencias,"",Mineral con Contenido Aurifero y Argentifero sin Procesar,"","",MINERAL AURIFERO Y ARGENTIFERO SIN PROCESAR,,2018-12-28,12/2018,,01,E001,0000012,EDWIN RUFO CHOQUE  CHANCOLLA,0,0,15.273000,671.2171806455837098,1487.57,0,10251.50,671.2171806455837098,609201,241101 - Mineral Aurifero sin Procesar,"",,14192,,,,t
Physical Locations / AQP M / Existencias,Ubicaciones virtuales / Produccion,/ AQP M / Existencias,07,Mineral con Contenido Aurifero y Argentifero sin Procesar,M0001,t,MINERAL AURIFERO Y ARGENTIFERO SIN PROCESAR,2018-12-31,2018-12-31,,MAMC-004247,,,MAMC-004247,,0,15.273000,0.000000,671.2171806455837098,0,10251.4999999999999997754000,0.0000000000000002246000,0,"",241101 - Mineral Aurifero sin Procesar,,"",14192,,,,
Ubicaciones virtuales / Produccion,Physical Locations / AMCAQ / Existencias,/ AMCAQ / Existencias,08,Mineral con Contenido Aurifero y Argentifero sin Procesar,M0001,t,MINERAL AURIFERO Y ARGENTIFERO SIN PROCESAR,2018-12-31,2018-12-31,,PAMC004253,,,PAMC004253,,15.273000,0,15.273000,941.6372880324756106,14381.62630012,0,14381.62630012,941.6372880324756106,"",241101 - Mineral Aurifero sin Procesar,,"",14192,,,,
Partner Locations / Suppliers,Physical Locations / AQP M / Existencias,/ AQP M / Existencias,03,Mineral con Contenido Aurifero y Argentifero sin Procesar,M0001,t,MINERAL AURIFERO Y ARGENTIFERO SIN PROCESAR,2018-12-22,2018-12-22,12/2018,AQP M\IN\04648,01,E001,0000011,EDWIN RUFO CHOQUE  CHANCOLLA,5.205000,0,5.205000,4260.1421709894332373,22174.04,0,22174.04,4260.1421709894332373,602101 - Mineral Aurifero sin Procesar,241101 - Mineral Aurifero sin Procesar,,"",14193,18PO06920,,2018-12-22,
,,/ AQP M / Existencias,"",Mineral con Contenido Aurifero y Argentifero sin Procesar,"","",MINERAL AURIFERO Y ARGENTIFERO SIN PROCESAR,,2018-12-28,12/2018,,01,E001,0000012,EDWIN RUFO CHOQUE  CHANCOLLA,0,0,5.205000,4351.5638808837656100,475.85,0,22649.89,4351.5638808837656100,609201,241101 - Mineral Aurifero sin Procesar,"",,14193,,,,t
Physical Locations / AQP M / Existencias,Ubicaciones virtuales / Produccion,/ AQP M / Existencias,07,Mineral con Contenido Aurifero y Argentifero sin Procesar,M0001,t,MINERAL AURIFERO Y ARGENTIFERO SIN PROCESAR,2018-12-31,2018-12-31,,MAMC-004247,,,MAMC-004247,,0,5.205000,0.000000,4351.5638808837656100,0,22649.8900000000000000500000,-0.0000000000000000500000,0,"",241101 - Mineral Aurifero sin Procesar,,"",14193,,,,
Ubicaciones virtuales / Produccion,Physical Locations / AMCAQ / Existencias,/ AMCAQ / Existencias,08,Mineral con Contenido Aurifero y Argentifero sin Procesar,M0001,t,MINERAL AURIFERO Y ARGENTIFERO SIN PROCESAR,2018-12-31,2018-12-31,,PAMC004253,,,PAMC004253,,5.205000,0,5.205000,4621.9839528780019212,24057.42647473,0,24057.42647473,4621.9839528780019212,"",241101 - Mineral Aurifero sin Procesar,,"",14193,,,,
Partner Locations / Suppliers,Physical Locations / AQP M / Existencias,/ AQP M / Existencias,03,Mineral con Contenido Aurifero y Argentifero sin Procesar,M0001,t,MINERAL AURIFERO Y ARGENTIFERO SIN PROCESAR,2018-12-22,2018-12-22,12/2018,AQP M\IN\04648,01,E001,0000011,EDWIN RUFO CHOQUE  CHANCOLLA,6.225000,0,6.225000,597.4843373493975904,3719.34,0,3719.34,597.4843373493975904,602101 - Mineral Aurifero sin Procesar,241101 - Mineral Aurifero sin Procesar,,"",14194,18PO06920,,2018-12-22,
,,/ AQP M / Existencias,"",Mineral con Contenido Aurifero y Argentifero sin Procesar,"","",MINERAL AURIFERO Y ARGENTIFERO SIN PROCESAR,,2018-12-28,12/2018,,01,E001,0000012,EDWIN RUFO CHOQUE  CHANCOLLA,0,0,6.225000,671.1485943775100402,458.56,0,4177.90,671.1485943775100402,609201,241101 - Mineral Aurifero sin Procesar,"",,14194,,,,t
Physical Locations / AQP M / Existencias,Ubicaciones virtuales / Produccion,/ AQP M / Existencias,07,Mineral con Contenido Aurifero y Argentifero sin Procesar,M0001,t,MINERAL AURIFERO Y ARGENTIFERO SIN PROCESAR,2018-12-31,2018-12-31,,MAMC-004247,,,MAMC-004247,,0,6.225000,0.000000,671.1485943775100402,0,4177.9000000000000002450000,-0.0000000000000002450000,0,"",241101 - Mineral Aurifero sin Procesar,,"",14194,,,,
Ubicaciones virtuales / Produccion,Physical Locations / AMCAQ / Existencias,/ AMCAQ / Existencias,08,Mineral con Contenido Aurifero y Argentifero sin Procesar,M0001,t,MINERAL AURIFERO Y ARGENTIFERO SIN PROCESAR,2018-12-31,2018-12-31,,PAMC004253,,,PAMC004253,,6.225000,0,6.225000,941.5684261783132530,5861.26345296,0,5861.26345296,941.5684261783132530,"",241101 - Mineral Aurifero sin Procesar,,"",14194,,,,
Partner Locations / Suppliers,Physical Locations / AQP M / Existencias,/ AQP M / Existencias,03,Mineral con Contenido Aurifero y Argentifero sin Procesar,M0002,t,LLAMPO,2018-12-22,2018-12-22,12/2018,AQP M\IN\04636,01,0004,0000244,HELARD MANUEL BELLIDO PERLACIO,5.196000,0,5.196000,785.6793687451886066,4082.39,0,4082.39,785.6793687451886066,602101 - Mineral Aurifero sin Procesar,241101 - Mineral Aurifero sin Procesar,,"",14195,18PO06798,,2018-12-22,
Physical Locations / AQP M / Existencias,Ubicaciones virtuales / Produccion,/ AQP M / Existencias,07,Mineral con Contenido Aurifero y Argentifero sin Procesar,M0002,t,LLAMPO,2018-12-31,2018-12-31,,MAMC-004248,,,MAMC-004248,,0,5.196000,0.000000,785.6793687451886066,0,4082.3899999999999998936000,0.0000000000000001064000,0,"",241101 - Mineral Aurifero sin Procesar,,"",14195,,,,
Ubicaciones virtuales / Produccion,Physical Locations / AMCAQ / Existencias,/ AMCAQ / Existencias,08,Mineral con Contenido Aurifero y Argentifero sin Procesar,M0002,t,LLAMPO,2018-12-31,2018-12-31,,PAMC004254,,,PAMC004254,,5.196000,0,5.196000,991.0442743918398768,5149.46604974,0,5149.46604974,991.0442743918398768,"",241101 - Mineral Aurifero sin Procesar,,"",14195,,,,
Partner Locations / Suppliers,Physical Locations / AQP M / Existencias,/ AQP M / Existencias,03,Mineral con Contenido Aurifero y Argentifero sin Procesar,M0002,t,LLAMPO,2018-12-22,2018-12-22,12/2018,AQP M\IN\04623,01,E001,0000049,URSULA LUZIER HUAMANI ROJAS,11.471000,0,11.471000,677.4431174265539186,7770.95,0,7770.95,677.4431174265539186,602101 - Mineral Aurifero sin Procesar,241101 - Mineral Aurifero sin Procesar,,"",14196,18PO06771,,2018-12-22,
Physical Locations / AQP M / Existencias,Ubicaciones virtuales / Produccion,/ AQP M / Existencias,07,Mineral con Contenido Aurifero y Argentifero sin Procesar,M0002,t,LLAMPO,2018-12-31,2018-12-31,,MAMC-004248,,,MAMC-004248,,0,11.471000,0.000000,677.4431174265539186,0,7770.9500000000000002606000,-0.0000000000000002606000,0,"",241101 - Mineral Aurifero sin Procesar,,"",14196,,,,
Ubicaciones virtuales / Produccion,Physical Locations / AMCAQ / Existencias,/ AMCAQ / Existencias,08,Mineral con Contenido Aurifero y Argentifero sin Procesar,M0002,t,LLAMPO,2018-12-31,2018-12-31,,PAMC004254,,,PAMC004254,,11.471000,0,11.471000,882.8081404376253160,10126.69217896,0,10126.69217896,882.8081404376253160,"",241101 - Mineral Aurifero sin Procesar,,"",14196,,,,
Partner Locations / Suppliers,Physical Locations / AQP M / Existencias,/ AQP M / Existencias,03,Mineral con Contenido Aurifero y Argentifero sin Procesar,M0002,t,LLAMPO,2018-12-22,2018-12-22,12/2018,AQP M\IN\04635,01,0002,0000129,LUIS GONZAGA VALDIVIA RANILLA,3.056000,0,3.056000,0.00000000000000000000,0,0,0,0.00000000000000000000,,241101 - Mineral Aurifero sin Procesar,,"",14197,18PO06797,,2018-12-22,
Physical Locations / AQP M / Existencias,Ubicaciones virtuales / Produccion,/ AQP M / Existencias,07,Mineral con Contenido Aurifero y Argentifero sin Procesar,M0002,t,LLAMPO,2018-12-31,2018-12-31,,MAMC-004248,,,MAMC-004248,,0,3.056000,0.000000,0.00000000000000000000,0,0.00000000000000000000000000,0.00000000000000000000000000,0,"",241101 - Mineral Aurifero sin Procesar,,"",14197,,,,
Ubicaciones virtuales / Produccion,Physical Locations / AMCAQ / Existencias,/ AMCAQ / Existencias,08,Mineral con Contenido Aurifero y Argentifero sin Procesar,M0002,t,LLAMPO,2018-12-31,2018-12-31,,PAMC004254,,,PAMC004254,,3.056000,0,3.056000,205.3643690314136126,627.59351176,0,627.59351176,205.3643690314136126,"",241101 - Mineral Aurifero sin Procesar,,"",14197,,,,
Partner Locations / Suppliers,Physical Locations / AQP M / Existencias,/ AQP M / Existencias,03,Mineral con Contenido Aurifero y Argentifero sin Procesar,M0002,t,LLAMPO,2018-12-22,2018-12-22,12/2018,AQP M\IN\04635,01,0002,0000129,LUIS GONZAGA VALDIVIA RANILLA,1.599000,0,1.599000,1164.7592245153220763,1862.45,0,1862.45,1164.7592245153220763,602101 - Mineral Aurifero sin Procesar,241101 - Mineral Aurifero sin Procesar,,"",14198,18PO06797,,2018-12-22,
Physical Locations / AQP M / Existencias,Ubicaciones virtuales / Produccion,/ AQP M / Existencias,07,Mineral con Contenido Aurifero y Argentifero sin Procesar,M0002,t,LLAMPO,2018-12-31,2018-12-31,,MAMC-004248,,,MAMC-004248,,0,1.599000,0.000000,1164.7592245153220763,0,1862.4500000000000000037000,-0.0000000000000000037000,0,"",241101 - Mineral Aurifero sin Procesar,,"",14198,,,,
Ubicaciones virtuales / Produccion,Physical Locations / AMCAQ / Existencias,/ AMCAQ / Existencias,08,Mineral con Contenido Aurifero y Argentifero sin Procesar,M0002,t,LLAMPO,2018-12-31,2018-12-31,,PAMC004254,,,PAMC004254,,1.599000,0,1.599000,1370.1244989243277048,2190.82907378,0,2190.82907378,1370.1244989243277048,"",241101 - Mineral Aurifero sin Procesar,,"",14198,,,,
Partner Locations / Suppliers,Physical Locations / AQP M / Existencias,/ AQP M / Existencias,03,Mineral con Contenido Aurifero y Argentifero sin Procesar,M0002,t,LLAMPO,2018-12-22,2018-12-22,12/2018,AQP M\IN\04635,01,0002,0000129,LUIS GONZAGA VALDIVIA RANILLA,4.282000,0,4.282000,1244.7337692666978048,5329.95,0,5329.95,1244.7337692666978048,602101 - Mineral Aurifero sin Procesar,241101 - Mineral Aurifero sin Procesar,,"",14199,18PO06797,,2018-12-22,
Physical Locations / AQP M / Existencias,Ubicaciones virtuales / Produccion,/ AQP M / Existencias,07,Mineral con Contenido Aurifero y Argentifero sin Procesar,M0002,t,LLAMPO,2018-12-31,2018-12-31,,MAMC-004248,,,MAMC-004248,,0,4.282000,0.000000,1244.7337692666978048,0,5329.9500000000000001536000,-0.0000000000000001536000,0,"",241101 - Mineral Aurifero sin Procesar,,"",14199,,,,
Ubicaciones virtuales / Produccion,Physical Locations / AMCAQ / Existencias,/ AMCAQ / Existencias,08,Mineral con Contenido Aurifero y Argentifero sin Procesar,M0002,t,LLAMPO,2018-12-31,2018-12-31,,PAMC004254,,,PAMC004254,,4.282000,0,4.282000,1450.0985653152732368,6209.32205668,0,6209.32205668,1450.0985653152732368,"",241101 - Mineral Aurifero sin Procesar,,"",14199,,,,
Partner Locations / Suppliers,Physical Locations / AQP M / Existencias,/ AQP M / Existencias,03,Mineral con Contenido Aurifero y Argentifero sin Procesar,M0001,t,MINERAL AURIFERO Y ARGENTIFERO SIN PROCESAR,2018-12-23,2018-12-23,12/2018,AQP M\IN\04625,01,E001,0000093,SAUL JOSE GROVAS QUISPE,28.595000,0,28.595000,1442.8819723727924462,41259.21,0,41259.21,1442.8819723727924462,602101 - Mineral Aurifero sin Procesar,241101 - Mineral Aurifero sin Procesar,,"",14200,18PO06773,,2018-12-23,
Physical Locations / AQP M / Existencias,Ubicaciones virtuales / Produccion,/ AQP M / Existencias,07,Mineral con Contenido Aurifero y Argentifero sin Procesar,M0001,t,MINERAL AURIFERO Y ARGENTIFERO SIN PROCESAR,2018-12-31,2018-12-31,,MAMC-004248,,,MAMC-004248,,0,28.595000,0.000000,1442.8819723727924462,0,41259.2099999999999990890000,0.0000000000000009110000,0,"",241101 - Mineral Aurifero sin Procesar,,"",14200,,,,
Ubicaciones virtuales / Produccion,Physical Locations / AMCAQ / Existencias,/ AMCAQ / Existencias,08,Mineral con Contenido Aurifero y Argentifero sin Procesar,M0001,t,MINERAL AURIFERO Y ARGENTIFERO SIN PROCESAR,2018-12-31,2018-12-31,,PAMC004254,,,PAMC004254,,28.595000,0,28.595000,1713.3021922717258262,48991.87618801,0,48991.87618801,1713.3021922717258262,"",241101 - Mineral Aurifero sin Procesar,,"",14200,,,,
Ubicaciones virtuales / Transformacion Lote Trujillo,Physical Locations / AMCAQ / Existencias,/ AMCAQ / Existencias,06,Mineral con Contenido Aurifero y Argentifero sin Procesar,M0001,t,MINERAL AURIFERO Y ARGENTIFERO SIN PROCESAR,2018-12-23,2018-12-23,,ILT-000336,,,ILT-000336,MASIAS ROGELIO HUERTA  ALVARADO,24.634000,0,24.634000,390.0972168709913128,9609.6548404,0,9609.6548404,390.0972168709913128,"",241101 - Mineral Aurifero sin Procesar,,"",14201,,,2018-12-23,
Physical Locations / AMCTJ / Existencias,Ubicaciones virtuales / Transformacion Lote Trujillo,/ AMCTJ / Existencias,06,Mineral con Contenido Aurifero y Argentifero sin Procesar,M0001,t,MINERAL AURIFERO Y ARGENTIFERO SIN PROCESAR,2018-12-23,2018-12-23,,CLT-000321,,,CLT-000321,MASIAS ROGELIO HUERTA  ALVARADO,0,24.634000,-24.634000,0,0,0.000000,0.000000,0,"",241101 - Mineral Aurifero sin Procesar,0000 LOTES TRUJILLO,"",14201,,,2018-12-23,
Ubicaciones virtuales / Transformacion Lote Trujillo,Physical Locations / AMCAQ / Existencias,/ AMCAQ / Existencias,06,Mineral con Contenido Aurifero y Argentifero sin Procesar,M0001,t,MINERAL AURIFERO Y ARGENTIFERO SIN PROCESAR,2018-12-23,2018-12-23,,ILT-000338,,,ILT-000338,MASIAS ROGELIO HUERTA  ALVARADO,1.720000,0,1.720000,10159.2553667151162791,17473.91923075,0,17473.91923075,10159.2553667151162791,"",241101 - Mineral Aurifero sin Procesar,,"",14202,,,2018-12-23,
Physical Locations / AMCTJ / Existencias,Ubicaciones virtuales / Transformacion Lote Trujillo,/ AMCTJ / Existencias,06,Mineral con Contenido Aurifero y Argentifero sin Procesar,M0001,t,MINERAL AURIFERO Y ARGENTIFERO SIN PROCESAR,2018-12-23,2018-12-23,,CLT-000322,,,CLT-000322,MASIAS ROGELIO HUERTA  ALVARADO,0,1.720000,-1.720000,0,0,0.000000,0.000000,0,"",241101 - Mineral Aurifero sin Procesar,0000 LOTES TRUJILLO,"",14202,,,2018-12-23,
Ubicaciones virtuales / Transformacion Lote Trujillo,Physical Locations / AMCAQ / Existencias,/ AMCAQ / Existencias,06,Mineral con Contenido Aurifero y Argentifero sin Procesar,M0001,t,MINERAL AURIFERO Y ARGENTIFERO SIN PROCESAR,2018-12-23,2018-12-23,,ILT-000338,,,ILT-000338,MASIAS ROGELIO HUERTA  ALVARADO,2.888000,0,2.888000,10159.2554776108033241,29339.92981934,0,29339.92981934,10159.2554776108033241,"",241101 - Mineral Aurifero sin Procesar,,"",14203,,,2018-12-23,
Physical Locations / AMCTJ / Existencias,Ubicaciones virtuales / Transformacion Lote Trujillo,/ AMCTJ / Existencias,06,Mineral con Contenido Aurifero y Argentifero sin Procesar,M0001,t,MINERAL AURIFERO Y ARGENTIFERO SIN PROCESAR,2018-12-23,2018-12-23,,CLT-000322,,,CLT-000322,MASIAS ROGELIO HUERTA  ALVARADO,0,2.888000,-2.888000,0,0,0.000000,0.000000,0,"",241101 - Mineral Aurifero sin Procesar,0000 LOTES TRUJILLO,"",14203,,,2018-12-23,
Ubicaciones virtuales / Transformacion Lote Trujillo,Physical Locations / AMCAQ / Existencias,/ AMCAQ / Existencias,06,Mineral con Contenido Aurifero y Argentifero sin Procesar,M0001,t,MINERAL AURIFERO Y ARGENTIFERO SIN PROCESAR,2018-12-23,2018-12-23,,ILT-000338,,,ILT-000338,MASIAS ROGELIO HUERTA  ALVARADO,3.749000,0,3.749000,1881.3570720298746332,7053.20766304,0,7053.20766304,1881.3570720298746332,"",241101 - Mineral Aurifero sin Procesar,,"",14204,,,2018-12-23,
Physical Locations / AMCTJ / Existencias,Ubicaciones virtuales / Transformacion Lote Trujillo,/ AMCTJ / Existencias,06,Mineral con Contenido Aurifero y Argentifero sin Procesar,M0001,t,MINERAL AURIFERO Y ARGENTIFERO SIN PROCESAR,2018-12-23,2018-12-23,,CLT-000322,,,CLT-000322,MASIAS ROGELIO HUERTA  ALVARADO,0,3.749000,-3.749000,0,0,0.000000,0.000000,0,"",241101 - Mineral Aurifero sin Procesar,0000 LOTES TRUJILLO,"",14204,,,2018-12-23,
Virtual Locations / Compras sin factura,Physical Locations / AQP M / Existencias,/ AQP M / Existencias,03,Mineral con Contenido Aurifero y Argentifero sin Procesar,M0001,t,MINERAL AURIFERO Y ARGENTIFERO SIN PROCESAR,2018-12-23,2018-12-23,,AQP M\IN\04742,,,AQP M\IN\04742,COMUNIDAD CAMPESINA CHILLOROYA,2.451000,0,2.451000,407.9355365157078743,999.85,0,999.85,407.9355365157078743,"",241101 - Mineral Aurifero sin Procesar,,"",14205,,,2018-12-23,
Physical Locations / AQP M / Existencias,Ubicaciones virtuales / Produccion,/ AQP M / Existencias,07,Mineral con Contenido Aurifero y Argentifero sin Procesar,M0001,t,MINERAL AURIFERO Y ARGENTIFERO SIN PROCESAR,2018-12-31,2018-12-31,,MAMC-004248,,,MAMC-004248,,0,2.451000,0.000000,407.9355365157078743,0,999.8499999999999999093000,0.0000000000000000907000,0,"",241101 - Mineral Aurifero sin Procesar,,"",14205,,,,
Ubicaciones virtuales / Produccion,Physical Locations / AMCAQ / Existencias,/ AMCAQ / Existencias,08,Mineral con Contenido Aurifero y Argentifero sin Procesar,M0001,t,MINERAL AURIFERO Y ARGENTIFERO SIN PROCESAR,2018-12-31,2018-12-31,,PAMC004254,,,PAMC004254,,2.451000,0,2.451000,678.3552238800489596,1662.64865373,0,1662.64865373,678.3552238800489596,"",241101 - Mineral Aurifero sin Procesar,,"",14205,,,,
Ubicaciones virtuales / Transformacion Lote Trujillo,Physical Locations / AMCAQ / Existencias,/ AMCAQ / Existencias,06,Mineral con Contenido Aurifero y Argentifero sin Procesar,M0001,t,MINERAL AURIFERO Y ARGENTIFERO SIN PROCESAR,2018-12-23,2018-12-23,,ILT-000338,,,ILT-000338,MASIAS ROGELIO HUERTA  ALVARADO,30.559000,0,30.559000,10159.255366714552,310456.68475143,0,310456.68475143,10159.255366714552,"",241101 - Mineral Aurifero sin Procesar,,"",14206,,,2018-12-23,
Physical Locations / AMCTJ / Existencias,Ubicaciones virtuales / Transformacion Lote Trujillo,/ AMCTJ / Existencias,06,Mineral con Contenido Aurifero y Argentifero sin Procesar,M0001,t,MINERAL AURIFERO Y ARGENTIFERO SIN PROCESAR,2018-12-23,2018-12-23,,CLT-000322,,,CLT-000322,MASIAS ROGELIO HUERTA  ALVARADO,0,30.559000,-30.559000,0,0,0.000000,0.000000,0,"",241101 - Mineral Aurifero sin Procesar,0000 LOTES TRUJILLO,"",14206,,,2018-12-23,
Virtual Locations / Compras sin factura,Physical Locations / AQP M / Existencias,/ AQP M / Existencias,03,Mineral con Contenido Aurifero y Argentifero sin Procesar,M0001,t,MINERAL AURIFERO Y ARGENTIFERO SIN PROCESAR,2018-12-23,2018-12-23,,AQP M\IN\04742,,,AQP M\IN\04742,COMUNIDAD CAMPESINA CHILLOROYA,2.777000,0,2.777000,538.8620813827871804,1496.42,0,1496.42,538.8620813827871804,"",241101 - Mineral Aurifero sin Procesar,,"",14207,,,2018-12-23,
Physical Locations / AQP M / Existencias,Ubicaciones virtuales / Produccion,/ AQP M / Existencias,07,Mineral con Contenido Aurifero y Argentifero sin Procesar,M0001,t,MINERAL AURIFERO Y ARGENTIFERO SIN PROCESAR,2018-12-31,2018-12-31,,MAMC-004248,,,MAMC-004248,,0,2.777000,0.000000,538.8620813827871804,0,1496.4199999999999999708000,0.0000000000000000292000,0,"",241101 - Mineral Aurifero sin Procesar,,"",14207,,,,
Ubicaciones virtuales / Produccion,Physical Locations / AMCAQ / Existencias,/ AMCAQ / Existencias,08,Mineral con Contenido Aurifero y Argentifero sin Procesar,M0001,t,MINERAL AURIFERO Y ARGENTIFERO SIN PROCESAR,2018-12-31,2018-12-31,,PAMC004254,,,PAMC004254,,2.777000,0,2.777000,809.2823781382787180,2247.37716409,0,2247.37716409,809.2823781382787180,"",241101 - Mineral Aurifero sin Procesar,,"",14207,,,,
Virtual Locations / Compras sin factura,Physical Locations / AQP M / Existencias,/ AQP M / Existencias,03,Mineral con Contenido Aurifero y Argentifero sin Procesar,M0001,t,MINERAL AURIFERO Y ARGENTIFERO SIN PROCESAR,2018-12-23,2018-12-23,,AQP M\IN\04742,,,AQP M\IN\04742,COMUNIDAD CAMPESINA CHILLOROYA,4.676000,0,4.676000,246.3130881094952951,1151.76,0,1151.76,246.3130881094952951,"",241101 - Mineral Aurifero sin Procesar,,"",14208,,,2018-12-23,
Physical Locations / AQP M / Existencias,Ubicaciones virtuales / Produccion,/ AQP M / Existencias,07,Mineral con Contenido Aurifero y Argentifero sin Procesar,M0001,t,MINERAL AURIFERO Y ARGENTIFERO SIN PROCESAR,2018-12-31,2018-12-31,,MAMC-004248,,,MAMC-004248,,0,4.676000,0.000000,246.3130881094952951,0,1151.7599999999999998876000,0.0000000000000001124000,0,"",241101 - Mineral Aurifero sin Procesar,,"",14208,,,,
Ubicaciones virtuales / Produccion,Physical Locations / AMCAQ / Existencias,/ AMCAQ / Existencias,08,Mineral con Contenido Aurifero y Argentifero sin Procesar,M0001,t,MINERAL AURIFERO Y ARGENTIFERO SIN PROCESAR,2018-12-31,2018-12-31,,PAMC004254,,,PAMC004254,,4.676000,0,4.676000,516.7333226881950385,2416.24501689,0,2416.24501689,516.7333226881950385,"",241101 - Mineral Aurifero sin Procesar,,"",14208,,,,
Virtual Locations / Compras sin factura,Physical Locations / AQP M / Existencias,/ AQP M / Existencias,03,Mineral con Contenido Aurifero y Argentifero sin Procesar,M0001,t,MINERAL AURIFERO Y ARGENTIFERO SIN PROCESAR,2018-12-23,2018-12-23,,AQP M\IN\04742,,,AQP M\IN\04742,COMUNIDAD CAMPESINA CHILLOROYA,2.507000,0,2.507000,1562.9716792979656961,3918.37,0,3918.37,1562.9716792979656961,"",241101 - Mineral Aurifero sin Procesar,,"",14209,,,2018-12-23,
Physical Locations / AQP M / Existencias,Ubicaciones virtuales / Produccion,/ AQP M / Existencias,07,Mineral con Contenido Aurifero y Argentifero sin Procesar,M0001,t,MINERAL AURIFERO Y ARGENTIFERO SIN PROCESAR,2018-12-31,2018-12-31,,MAMC-004248,,,MAMC-004248,,0,2.507000,0.000000,1562.9716792979656961,0,3918.3700000000000001227000,-0.0000000000000001227000,0,"",241101 - Mineral Aurifero sin Procesar,,"",14209,,,,
Ubicaciones virtuales / Produccion,Physical Locations / AMCAQ / Existencias,/ AMCAQ / Existencias,08,Mineral con Contenido Aurifero y Argentifero sin Procesar,M0001,t,MINERAL AURIFERO Y ARGENTIFERO SIN PROCESAR,2018-12-31,2018-12-31,,PAMC004254,,,PAMC004254,,2.507000,0,2.507000,1833.3918310889509374,4596.31332054,0,4596.31332054,1833.3918310889509374,"",241101 - Mineral Aurifero sin Procesar,,"",14209,,,,
Ubicaciones virtuales / Transformacion Lote Trujillo,Physical Locations / AMCAQ / Existencias,/ AMCAQ / Existencias,06,Mineral con Contenido Aurifero y Argentifero sin Procesar,M0001,t,MINERAL AURIFERO Y ARGENTIFERO SIN PROCESAR,2018-12-23,2018-12-23,,ILT-000336,,,ILT-000336,MASIAS ROGELIO HUERTA  ALVARADO,1.316000,0,1.316000,390.0972168693009119,513.3679374,0,513.3679374,390.0972168693009119,"",241101 - Mineral Aurifero sin Procesar,,"",14210,,,2018-12-23,
Physical Locations / AMCTJ / Existencias,Ubicaciones virtuales / Transformacion Lote Trujillo,/ AMCTJ / Existencias,06,Mineral con Contenido Aurifero y Argentifero sin Procesar,M0001,t,MINERAL AURIFERO Y ARGENTIFERO SIN PROCESAR,2018-12-23,2018-12-23,,CLT-000321,,,CLT-000321,MASIAS ROGELIO HUERTA  ALVARADO,0,1.316000,-1.316000,0,0,0.000000,0.000000,0,"",241101 - Mineral Aurifero sin Procesar,0000 LOTES TRUJILLO,"",14210,,,2018-12-23,
Virtual Locations / Compras sin factura,Physical Locations / AQP M / Existencias,/ AQP M / Existencias,03,Mineral con Contenido Aurifero y Argentifero sin Procesar,M0001,t,MINERAL AURIFERO Y ARGENTIFERO SIN PROCESAR,2018-12-23,2018-12-23,,AQP M\IN\04742,,,AQP M\IN\04742,COMUNIDAD CAMPESINA CHILLOROYA,1.897000,0,1.897000,981.5814443858724302,1862.06,0,1862.06,981.5814443858724302,"",241101 - Mineral Aurifero sin Procesar,,"",14211,,,2018-12-23,
Physical Locations / AQP M / Existencias,Ubicaciones virtuales / Produccion,/ AQP M / Existencias,07,Mineral con Contenido Aurifero y Argentifero sin Procesar,M0001,t,MINERAL AURIFERO Y ARGENTIFERO SIN PROCESAR,2018-12-31,2018-12-31,,MAMC-004249,,,MAMC-004249,,0,1.897000,0.000000,981.5814443858724302,0,1862.0600000000000000894000,-0.0000000000000000894000,0,"",241101 - Mineral Aurifero sin Procesar,,"",14211,,,,
Ubicaciones virtuales / Produccion,Physical Locations / AMCAQ / Existencias,/ AMCAQ / Existencias,08,Mineral con Contenido Aurifero y Argentifero sin Procesar,M0001,t,MINERAL AURIFERO Y ARGENTIFERO SIN PROCESAR,2018-12-31,2018-12-31,,PAMC004255,,,PAMC004255,,1.897000,0,1.897000,1252.0016544491302056,2375.04713849,0,2375.04713849,1252.0016544491302056,"",241101 - Mineral Aurifero sin Procesar,,"",14211,,,,
Ubicaciones virtuales / Transformacion Lote Trujillo,Physical Locations / AMCAQ / Existencias,/ AMCAQ / Existencias,06,Mineral con Contenido Aurifero y Argentifero sin Procesar,M0001,t,MINERAL AURIFERO Y ARGENTIFERO SIN PROCESAR,2018-12-23,2018-12-23,,ILT-000338,,,ILT-000338,MASIAS ROGELIO HUERTA  ALVARADO,34.432000,0,34.432000,1609.2622223086082714,55410.11683853,0,55410.11683853,1609.2622223086082714,"",241101 - Mineral Aurifero sin Procesar,,"",14212,,,2018-12-23,
Physical Locations / AMCTJ / Existencias,Ubicaciones virtuales / Transformacion Lote Trujillo,/ AMCTJ / Existencias,06,Mineral con Contenido Aurifero y Argentifero sin Procesar,M0001,t,MINERAL AURIFERO Y ARGENTIFERO SIN PROCESAR,2018-12-23,2018-12-23,,CLT-000322,,,CLT-000322,MASIAS ROGELIO HUERTA  ALVARADO,0,34.432000,-34.432000,0,0,0.000000,0.000000,0,"",241101 - Mineral Aurifero sin Procesar,0000 LOTES TRUJILLO,"",14212,,,2018-12-23,
Virtual Locations / Compras sin factura,Physical Locations / AQP M / Existencias,/ AQP M / Existencias,03,Mineral con Contenido Aurifero y Argentifero sin Procesar,M0001,t,MINERAL AURIFERO Y ARGENTIFERO SIN PROCESAR,2018-12-23,2018-12-23,,AQP M\IN\04742,,,AQP M\IN\04742,COMUNIDAD CAMPESINA CHILLOROYA,5.315000,0,5.315000,1643.9190968955785513,8737.43,0,8737.43,1643.9190968955785513,"",241101 - Mineral Aurifero sin Procesar,,"",14213,,,2018-12-23,
Physical Locations / AQP M / Existencias,Ubicaciones virtuales / Produccion,/ AQP M / Existencias,07,Mineral con Contenido Aurifero y Argentifero sin Procesar,M0001,t,MINERAL AURIFERO Y ARGENTIFERO SIN PROCESAR,2018-12-31,2018-12-31,,MAMC-004249,,,MAMC-004249,,0,5.315000,0.000000,1643.9190968955785513,0,8737.4300000000000001595000,-0.0000000000000001595000,0,"",241101 - Mineral Aurifero sin Procesar,,"",14213,,,,
Ubicaciones virtuales / Produccion,Physical Locations / AMCAQ / Existencias,/ AMCAQ / Existencias,08,Mineral con Contenido Aurifero y Argentifero sin Procesar,M0001,t,MINERAL AURIFERO Y ARGENTIFERO SIN PROCESAR,2018-12-31,2018-12-31,,PAMC004255,,,PAMC004255,,5.315000,0,5.315000,1914.3391757328316087,10174.71271902,0,10174.71271902,1914.3391757328316087,"",241101 - Mineral Aurifero sin Procesar,,"",14213,,,,
Virtual Locations / Compras sin factura,Physical Locations / AQP M / Existencias,/ AQP M / Existencias,03,Mineral con Contenido Aurifero y Argentifero sin Procesar,M0001,t,MINERAL AURIFERO Y ARGENTIFERO SIN PROCESAR,2018-12-23,2018-12-23,,AQP M\IN\04742,,,AQP M\IN\04742,COMUNIDAD CAMPESINA CHILLOROYA,5.987000,0,5.987000,1689.9532320026724570,10117.75,0,10117.75,1689.9532320026724570,"",241101 - Mineral Aurifero sin Procesar,,"",14214,,,2018-12-23,
Physical Locations / AQP M / Existencias,Ubicaciones virtuales / Produccion,/ AQP M / Existencias,07,Mineral con Contenido Aurifero y Argentifero sin Procesar,M0001,t,MINERAL AURIFERO Y ARGENTIFERO SIN PROCESAR,2018-12-31,2018-12-31,,MAMC-004249,,,MAMC-004249,,0,5.987000,0.000000,1689.9532320026724570,0,10117.7500000000000000590000,-0.0000000000000000590000,0,"",241101 - Mineral Aurifero sin Procesar,,"",14214,,,,
Ubicaciones virtuales / Produccion,Physical Locations / AMCAQ / Existencias,/ AMCAQ / Existencias,08,Mineral con Contenido Aurifero y Argentifero sin Procesar,M0001,t,MINERAL AURIFERO Y ARGENTIFERO SIN PROCESAR,2018-12-31,2018-12-31,,PAMC004255,,,PAMC004255,,5.987000,0,5.987000,1960.3736165842659095,11736.75684249,0,11736.75684249,1960.3736165842659095,"",241101 - Mineral Aurifero sin Procesar,,"",14214,,,,
Virtual Locations / Compras sin factura,Physical Locations / AQP M / Existencias,/ AQP M / Existencias,03,Mineral con Contenido Aurifero y Argentifero sin Procesar,M0001,t,MINERAL AURIFERO Y ARGENTIFERO SIN PROCESAR,2018-12-23,2018-12-23,,AQP M\IN\04742,,,AQP M\IN\04742,COMUNIDAD CAMPESINA CHILLOROYA,2.366000,0,2.366000,419.4759087066779374,992.48,0,992.48,419.4759087066779374,"",241101 - Mineral Aurifero sin Procesar,,"",14215,,,2018-12-23,
Physical Locations / AQP M / Existencias,Ubicaciones virtuales / Produccion,/ AQP M / Existencias,07,Mineral con Contenido Aurifero y Argentifero sin Procesar,M0001,t,MINERAL AURIFERO Y ARGENTIFERO SIN PROCESAR,2018-12-31,2018-12-31,,MAMC-004249,,,MAMC-004249,,0,2.366000,0.000000,419.4759087066779374,0,992.4799999999999998884000,0.0000000000000001116000,0,"",241101 - Mineral Aurifero sin Procesar,,"",14215,,,,
Ubicaciones virtuales / Produccion,Physical Locations / AMCAQ / Existencias,/ AMCAQ / Existencias,08,Mineral con Contenido Aurifero y Argentifero sin Procesar,M0001,t,MINERAL AURIFERO Y ARGENTIFERO SIN PROCESAR,2018-12-31,2018-12-31,,PAMC004255,,,PAMC004255,,2.366000,0,2.366000,689.8963828613693998,1632.29484185,0,1632.29484185,689.8963828613693998,"",241101 - Mineral Aurifero sin Procesar,,"",14215,,,,
Virtual Locations / Compras sin factura,Physical Locations / AQP M / Existencias,/ AQP M / Existencias,03,Mineral con Contenido Aurifero y Argentifero sin Procesar,M0001,t,MINERAL AURIFERO Y ARGENTIFERO SIN PROCESAR,2018-12-23,2018-12-23,,AQP M\IN\04742,,,AQP M\IN\04742,COMUNIDAD CAMPESINA CHILLOROYA,2.423000,0,2.423000,1027.8497730086669418,2490.48,0,2490.48,1027.8497730086669418,"",241101 - Mineral Aurifero sin Procesar,,"",14216,,,2018-12-23,
Physical Locations / AQP M / Existencias,Ubicaciones virtuales / Produccion,/ AQP M / Existencias,07,Mineral con Contenido Aurifero y Argentifero sin Procesar,M0001,t,MINERAL AURIFERO Y ARGENTIFERO SIN PROCESAR,2018-12-31,2018-12-31,,MAMC-004249,,,MAMC-004249,,0,2.423000,0.000000,1027.8497730086669418,0,2490.4799999999999999814000,0.0000000000000000186000,0,"",241101 - Mineral Aurifero sin Procesar,,"",14216,,,,
Ubicaciones virtuales / Produccion,Physical Locations / AMCAQ / Existencias,/ AMCAQ / Existencias,08,Mineral con Contenido Aurifero y Argentifero sin Procesar,M0001,t,MINERAL AURIFERO Y ARGENTIFERO SIN PROCESAR,2018-12-31,2018-12-31,,PAMC004255,,,PAMC004255,,2.423000,0,2.423000,1298.2701856004952538,3145.70865971,0,3145.70865971,1298.2701856004952538,"",241101 - Mineral Aurifero sin Procesar,,"",14216,,,,
Ubicaciones virtuales / Transformacion Lote Trujillo,Physical Locations / AMCAQ / Existencias,/ AMCAQ / Existencias,06,Mineral con Contenido Aurifero y Argentifero sin Procesar,M0001,t,MINERAL AURIFERO Y ARGENTIFERO SIN PROCESAR,2018-12-23,2018-12-23,,ILT-000338,,,ILT-000338,MASIAS ROGELIO HUERTA  ALVARADO,33.767000,0,33.767000,10159.255477611573,343047.57971251,0,343047.57971251,10159.255477611573,"",241101 - Mineral Aurifero sin Procesar,,"",14217,,,2018-12-23,
Physical Locations / AMCTJ / Existencias,Ubicaciones virtuales / Transformacion Lote Trujillo,/ AMCTJ / Existencias,06,Mineral con Contenido Aurifero y Argentifero sin Procesar,M0001,t,MINERAL AURIFERO Y ARGENTIFERO SIN PROCESAR,2018-12-23,2018-12-23,,CLT-000322,,,CLT-000322,MASIAS ROGELIO HUERTA  ALVARADO,0,33.767000,-33.767000,0,0,0.000000,0.000000,0,"",241101 - Mineral Aurifero sin Procesar,0000 LOTES TRUJILLO,"",14217,,,2018-12-23,
Partner Locations / Suppliers,Physical Locations / AQP M / Existencias,/ AQP M / Existencias,03,Mineral con Contenido Aurifero y Argentifero sin Procesar,M0002,t,LLAMPO,2018-12-23,2018-12-23,12/2018,AQP M\IN\04645,01,0001,0000109,AMILCAR HUAYCANI  MOLINA,10.009000,0,10.009000,978.7671096013587771,9796.48,0,9796.48,978.7671096013587771,602101 - Mineral Aurifero sin Procesar,241101 - Mineral Aurifero sin Procesar,,"",14218,18PO06835,,2018-12-23,
Physical Locations / AQP M / Existencias,Ubicaciones virtuales / Produccion,/ AQP M / Existencias,07,Mineral con Contenido Aurifero y Argentifero sin Procesar,M0002,t,LLAMPO,2018-12-31,2018-12-31,,MAMC-004249,,,MAMC-004249,,0,10.009000,0.000000,978.7671096013587771,0,9796.4799999999999999939000,0.0000000000000000061000,0,"",241101 - Mineral Aurifero sin Procesar,,"",14218,,,,
Ubicaciones virtuales / Produccion,Physical Locations / AMCAQ / Existencias,/ AMCAQ / Existencias,08,Mineral con Contenido Aurifero y Argentifero sin Procesar,M0002,t,LLAMPO,2018-12-31,2018-12-31,,PAMC004255,,,PAMC004255,,10.009000,0,10.009000,1184.1318610400639425,11851.97579715,0,11851.97579715,1184.1318610400639425,"",241101 - Mineral Aurifero sin Procesar,,"",14218,,,,
Partner Locations / Suppliers,Physical Locations / AQP M / Existencias,/ AQP M / Existencias,03,Mineral con Contenido Aurifero y Argentifero sin Procesar,M0001,t,MINERAL AURIFERO Y ARGENTIFERO SIN PROCESAR,2018-12-23,2018-12-23,12/2018,AQP M\IN\04643,01,E001,0000392,APMINAC PULPERA CAYLLOMA,27.255000,0,27.255000,1073.8352595853971748,29267.38,0,29267.38,1073.8352595853971748,602101 - Mineral Aurifero sin Procesar,241101 - Mineral Aurifero sin Procesar,,"",14219,18PO06833,,2018-12-23,
Physical Locations / AQP M / Existencias,Ubicaciones virtuales / Produccion,/ AQP M / Existencias,07,Mineral con Contenido Aurifero y Argentifero sin Procesar,M0001,t,MINERAL AURIFERO Y ARGENTIFERO SIN PROCESAR,2018-12-31,2018-12-31,,MAMC-004249,,,MAMC-004249,,0,27.255000,0.000000,1073.8352595853971748,0,29267.3799999999999991740000,0.0000000000000008260000,0,"",241101 - Mineral Aurifero sin Procesar,,"",14219,,,,
Ubicaciones virtuales / Produccion,Physical Locations / AMCAQ / Existencias,/ AMCAQ / Existencias,08,Mineral con Contenido Aurifero y Argentifero sin Procesar,M0001,t,MINERAL AURIFERO Y ARGENTIFERO SIN PROCESAR,2018-12-31,2018-12-31,,PAMC004255,,,PAMC004255,,27.255000,0,27.255000,1344.2555131623555311,36637.68401124,0,36637.68401124,1344.2555131623555311,"",241101 - Mineral Aurifero sin Procesar,,"",14219,,,,
Partner Locations / Suppliers,Physical Locations / AQP M / Existencias,/ AQP M / Existencias,03,Mineral con Contenido Aurifero y Argentifero sin Procesar,M0001,t,MINERAL AURIFERO Y ARGENTIFERO SIN PROCESAR,2018-12-23,2018-12-23,12/2018,AQP M\IN\04644,01,E001,0000105,SOCIEDAD MINERA DE RESPONSABILIDAD LIMITADA PULPERA I,29.377000,0,29.377000,976.2348095448820506,28678.85,0,28678.85,976.2348095448820506,602101 - Mineral Aurifero sin Procesar,241101 - Mineral Aurifero sin Procesar,,"",14220,18PO06834,,2018-12-23,
Physical Locations / AQP M / Existencias,Ubicaciones virtuales / Produccion,/ AQP M / Existencias,07,Mineral con Contenido Aurifero y Argentifero sin Procesar,M0001,t,MINERAL AURIFERO Y ARGENTIFERO SIN PROCESAR,2018-12-31,2018-12-31,,MAMC-004249,,,MAMC-004249,,0,29.377000,0.000000,976.2348095448820506,0,28678.8500000000000004762000,-0.0000000000000004762000,0,"",241101 - Mineral Aurifero sin Procesar,,"",14220,,,,
Ubicaciones virtuales / Produccion,Physical Locations / AMCAQ / Existencias,/ AMCAQ / Existencias,08,Mineral con Contenido Aurifero y Argentifero sin Procesar,M0001,t,MINERAL AURIFERO Y ARGENTIFERO SIN PROCESAR,2018-12-31,2018-12-31,,PAMC004255,,,PAMC004255,,29.377000,0,29.377000,1246.6550120587534466,36622.98428925,0,36622.98428925,1246.6550120587534466,"",241101 - Mineral Aurifero sin Procesar,,"",14220,,,,
Partner Locations / Suppliers,Physical Locations / AQP M / Existencias,/ AQP M / Existencias,03,Mineral con Contenido Aurifero y Argentifero sin Procesar,M0002,t,LLAMPO,2018-12-23,2018-12-23,12/2018,AQP M\IN\04645,01,0001,0000109,AMILCAR HUAYCANI  MOLINA,9.606000,0,9.606000,868.8278159483656048,8345.96,0,8345.96,868.8278159483656048,602101 - Mineral Aurifero sin Procesar,241101 - Mineral Aurifero sin Procesar,,"",14221,18PO06835,,2018-12-23,
Physical Locations / AQP M / Existencias,Ubicaciones virtuales / Produccion,/ AQP M / Existencias,07,Mineral con Contenido Aurifero y Argentifero sin Procesar,M0002,t,LLAMPO,2018-12-31,2018-12-31,,MAMC-004249,,,MAMC-004249,,0,9.606000,0.000000,868.8278159483656048,0,8345.9599999999999997088000,0.0000000000000002912000,0,"",241101 - Mineral Aurifero sin Procesar,,"",14221,,,,
Ubicaciones virtuales / Produccion,Physical Locations / AMCAQ / Existencias,/ AMCAQ / Existencias,08,Mineral con Contenido Aurifero y Argentifero sin Procesar,M0002,t,LLAMPO,2018-12-31,2018-12-31,,PAMC004255,,,PAMC004255,,9.606000,0,9.606000,1074.1928026264834478,10318.69606203,0,10318.69606203,1074.1928026264834478,"",241101 - Mineral Aurifero sin Procesar,,"",14221,,,,
Partner Locations / Suppliers,Physical Locations / AQP M / Existencias,/ AQP M / Existencias,03,Mineral con Contenido Aurifero y Argentifero sin Procesar,M0001,t,MINERAL AURIFERO Y ARGENTIFERO SIN PROCESAR,2018-12-23,2018-12-23,12/2018,AQP M\IN\04643,01,E001,0000392,APMINAC PULPERA CAYLLOMA,21.900000,0,21.900000,839.5885844748858447,18386.99,0,18386.99,839.5885844748858447,602101 - Mineral Aurifero sin Procesar,241101 - Mineral Aurifero sin Procesar,,"",14222,18PO06833,,2018-12-23,
Physical Locations / AQP M / Existencias,Ubicaciones virtuales / Produccion,/ AQP M / Existencias,07,Mineral con Contenido Aurifero y Argentifero sin Procesar,M0001,t,MINERAL AURIFERO Y ARGENTIFERO SIN PROCESAR,2018-12-31,2018-12-31,,MAMC-004249,,,MAMC-004249,,0,21.900000,0.000000,839.5885844748858447,0,18386.9899999999999989300000,0.0000000000000010700000,0,"",241101 - Mineral Aurifero sin Procesar,,"",14222,,,,
Ubicaciones virtuales / Produccion,Physical Locations / AMCAQ / Existencias,/ AMCAQ / Existencias,08,Mineral con Contenido Aurifero y Argentifero sin Procesar,M0001,t,MINERAL AURIFERO Y ARGENTIFERO SIN PROCESAR,2018-12-31,2018-12-31,,PAMC004255,,,PAMC004255,,21.900000,0,21.900000,1110.0087323794520548,24309.19123911,0,24309.19123911,1110.0087323794520548,"",241101 - Mineral Aurifero sin Procesar,,"",14222,,,,
Partner Locations / Suppliers,Physical Locations / AQP M / Existencias,/ AQP M / Existencias,03,Mineral con Contenido Aurifero y Argentifero sin Procesar,M0001,t,MINERAL AURIFERO Y ARGENTIFERO SIN PROCESAR,2018-12-23,2018-12-23,12/2018,AQP M\IN\04637,01,0002,0000130,LUIS GONZAGA VALDIVIA RANILLA,1.128000,0,1.128000,2532.4645390070921986,2856.62,0,2856.62,2532.4645390070921986,602101 - Mineral Aurifero sin Procesar,241101 - Mineral Aurifero sin Procesar,,"",14223,18PO06802,,2018-12-23,
Physical Locations / AQP M / Existencias,Ubicaciones virtuales / Produccion,/ AQP M / Existencias,07,Mineral con Contenido Aurifero y Argentifero sin Procesar,M0001,t,MINERAL AURIFERO Y ARGENTIFERO SIN PROCESAR,2018-12-31,2018-12-31,,MAMC-004250,,,MAMC-004250,,0,1.128000,0.000000,2532.4645390070921986,0,2856.6200000000000000208000,-0.0000000000000000208000,0,"",241101 - Mineral Aurifero sin Procesar,,"",14223,,,,
Ubicaciones virtuales / Produccion,Physical Locations / AMCAQ / Existencias,/ AMCAQ / Existencias,08,Mineral con Contenido Aurifero y Argentifero sin Procesar,M0001,t,MINERAL AURIFERO Y ARGENTIFERO SIN PROCESAR,2018-12-31,2018-12-31,,PAMC004256,,,PAMC004256,,1.128000,0,1.128000,2802.8844985195035461,3161.65371433,0,3161.65371433,2802.8844985195035461,"",241101 - Mineral Aurifero sin Procesar,,"",14223,,,,
Partner Locations / Suppliers,Physical Locations / AQP M / Existencias,/ AQP M / Existencias,03,Mineral con Contenido Aurifero y Argentifero sin Procesar,M0001,t,MINERAL AURIFERO Y ARGENTIFERO SIN PROCESAR,2018-12-23,2018-12-23,12/2018,AQP M\IN\04646,01,E001,0000393,APMINAC PULPERA CAYLLOMA,30.905000,0,30.905000,886.4170846141401068,27394.72,0,27394.72,886.4170846141401068,602101 - Mineral Aurifero sin Procesar,241101 - Mineral Aurifero sin Procesar,,"",14224,18PO06837,,2018-12-23,
Physical Locations / AQP M / Existencias,Ubicaciones virtuales / Produccion,/ AQP M / Existencias,07,Mineral con Contenido Aurifero y Argentifero sin Procesar,M0001,t,MINERAL AURIFERO Y ARGENTIFERO SIN PROCESAR,2018-12-31,2018-12-31,,MAMC-004250,,,MAMC-004250,,0,30.905000,0.000000,886.4170846141401068,0,27394.7200000000000006540000,-0.0000000000000006540000,0,"",241101 - Mineral Aurifero sin Procesar,,"",14224,,,,
Ubicaciones virtuales / Produccion,Physical Locations / AMCAQ / Existencias,/ AMCAQ / Existencias,08,Mineral con Contenido Aurifero y Argentifero sin Procesar,M0001,t,MINERAL AURIFERO Y ARGENTIFERO SIN PROCESAR,2018-12-31,2018-12-31,,PAMC004256,,,PAMC004256,,30.905000,0,30.905000,1156.8372872690503155,35752.05636305,0,35752.05636305,1156.8372872690503155,"",241101 - Mineral Aurifero sin Procesar,,"",14224,,,,
Virtual Locations / Compras sin factura,Physical Locations / AQP M / Existencias,/ AQP M / Existencias,03,Mineral con Contenido Aurifero y Argentifero sin Procesar,M0002,t,LLAMPO,2018-12-23,2018-12-23,,AQP M\IN\04768,,,AQP M\IN\04768,PRUDENCIO QUISPE HUARACA,14.953000,0,14.953000,1172.2537283488263225,17528.71,0,17528.71,1172.2537283488263225,"",241101 - Mineral Aurifero sin Procesar,,"",14225,,,2018-12-23,
Physical Locations / AQP M / Existencias,Ubicaciones virtuales / Produccion,/ AQP M / Existencias,07,Mineral con Contenido Aurifero y Argentifero sin Procesar,M0002,t,LLAMPO,2018-12-31,2018-12-31,,MAMC-004250,,,MAMC-004250,,0,14.953000,0.000000,1172.2537283488263225,0,17528.7100000000000003425000,-0.0000000000000003425000,0,"",241101 - Mineral Aurifero sin Procesar,,"",14225,,,,
Ubicaciones virtuales / Produccion,Physical Locations / AMCAQ / Existencias,/ AMCAQ / Existencias,08,Mineral con Contenido Aurifero y Argentifero sin Procesar,M0002,t,LLAMPO,2018-12-31,2018-12-31,,PAMC004256,,,PAMC004256,,14.953000,0,14.953000,1377.6185614318197017,20599.53034909,0,20599.53034909,1377.6185614318197017,"",241101 - Mineral Aurifero sin Procesar,,"",14225,,,,
Virtual Locations / Compras sin factura,Physical Locations / AQP M / Existencias,/ AQP M / Existencias,03,Mineral con Contenido Aurifero y Argentifero sin Procesar,M0002,t,LLAMPO,2018-12-23,2018-12-23,,AQP M\IN\04768,,,AQP M\IN\04768,PRUDENCIO QUISPE HUARACA,9.109000,0,9.109000,590.5587880118564058,5379.4,0,5379.4,590.5587880118564058,"",241101 - Mineral Aurifero sin Procesar,,"",14226,,,2018-12-23,
Physical Locations / AQP M / Existencias,Ubicaciones virtuales / Produccion,/ AQP M / Existencias,07,Mineral con Contenido Aurifero y Argentifero sin Procesar,M0002,t,LLAMPO,2018-12-31,2018-12-31,,MAMC-004250,,,MAMC-004250,,0,9.109000,0.000000,590.5587880118564058,0,5379.4000000000000004322000,-0.0000000000000004322000,0,"",241101 - Mineral Aurifero sin Procesar,,"",14226,,,,
Ubicaciones virtuales / Produccion,Physical Locations / AMCAQ / Existencias,/ AMCAQ / Existencias,08,Mineral con Contenido Aurifero y Argentifero sin Procesar,M0002,t,LLAMPO,2018-12-31,2018-12-31,,PAMC004256,,,PAMC004256,,9.109000,0,9.109000,795.9239018640904600,7250.07082208,0,7250.07082208,795.9239018640904600,"",241101 - Mineral Aurifero sin Procesar,,"",14226,,,,
Virtual Locations / Compras sin factura,Physical Locations / AQP M / Existencias,/ AQP M / Existencias,03,Mineral con Contenido Aurifero y Argentifero sin Procesar,M0001,t,MINERAL AURIFERO Y ARGENTIFERO SIN PROCESAR,2018-12-24,2018-12-24,,AQP M\IN\04780,,,AQP M\IN\04780,COMUNIDAD CAMPESINA CHILLOROYA,2.163000,0,2.163000,430.0739713361072584,930.25,0,930.25,430.0739713361072584,"",241101 - Mineral Aurifero sin Procesar,,"",14227,,,2018-12-24,
Physical Locations / AQP M / Existencias,Ubicaciones virtuales / Produccion,/ AQP M / Existencias,07,Mineral con Contenido Aurifero y Argentifero sin Procesar,M0001,t,MINERAL AURIFERO Y ARGENTIFERO SIN PROCESAR,2018-12-31,2018-12-31,,MAMC-004250,,,MAMC-004250,,0,2.163000,0.000000,430.0739713361072584,0,930.2499999999999999192000,0.0000000000000000808000,0,"",241101 - Mineral Aurifero sin Procesar,,"",14227,,,,
Ubicaciones virtuales / Produccion,Physical Locations / AMCAQ / Existencias,/ AMCAQ / Existencias,08,Mineral con Contenido Aurifero y Argentifero sin Procesar,M0001,t,MINERAL AURIFERO Y ARGENTIFERO SIN PROCESAR,2018-12-31,2018-12-31,,PAMC004256,,,PAMC004256,,2.163000,0,2.163000,700.4933960379103098,1515.16721563,0,1515.16721563,700.4933960379103098,"",241101 - Mineral Aurifero sin Procesar,,"",14227,,,,
Virtual Locations / Compras sin factura,Physical Locations / AQP M / Existencias,/ AQP M / Existencias,03,Mineral con Contenido Aurifero y Argentifero sin Procesar,M0001,t,MINERAL AURIFERO Y ARGENTIFERO SIN PROCESAR,2018-12-24,2018-12-24,,AQP M\IN\04780,,,AQP M\IN\04780,COMUNIDAD CAMPESINA CHILLOROYA,2.394000,0,2.394000,190.6432748538011696,456.4,0,456.4,190.6432748538011696,"",241101 - Mineral Aurifero sin Procesar,,"",14228,,,2018-12-24,
Physical Locations / AQP M / Existencias,Ubicaciones virtuales / Produccion,/ AQP M / Existencias,07,Mineral con Contenido Aurifero y Argentifero sin Procesar,M0001,t,MINERAL AURIFERO Y ARGENTIFERO SIN PROCESAR,2018-12-31,2018-12-31,,MAMC-004250,,,MAMC-004250,,0,2.394000,0.000000,190.6432748538011696,0,456.4000000000000000224000,-0.0000000000000000224000,0,"",241101 - Mineral Aurifero sin Procesar,,"",14228,,,,
Ubicaciones virtuales / Produccion,Physical Locations / AMCAQ / Existencias,/ AMCAQ / Existencias,08,Mineral con Contenido Aurifero y Argentifero sin Procesar,M0001,t,MINERAL AURIFERO Y ARGENTIFERO SIN PROCESAR,2018-12-31,2018-12-31,,PAMC004256,,,PAMC004256,,2.394000,0,2.394000,461.0630057936507937,1103.78483587,0,1103.78483587,461.0630057936507937,"",241101 - Mineral Aurifero sin Procesar,,"",14228,,,,
Virtual Locations / Compras sin factura,Physical Locations / AQP M / Existencias,/ AQP M / Existencias,03,Mineral con Contenido Aurifero y Argentifero sin Procesar,M0001,t,MINERAL AURIFERO Y ARGENTIFERO SIN PROCESAR,2018-12-24,2018-12-24,,AQP M\IN\04780,,,AQP M\IN\04780,COMUNIDAD CAMPESINA CHILLOROYA,1.781000,0,1.781000,0.00000000000000000000,0,0,0,0.00000000000000000000,"",241101 - Mineral Aurifero sin Procesar,,"",14229,,,2018-12-24,
Physical Locations / AQP M / Existencias,Ubicaciones virtuales / Produccion,/ AQP M / Existencias,07,Mineral con Contenido Aurifero y Argentifero sin Procesar,M0001,t,MINERAL AURIFERO Y ARGENTIFERO SIN PROCESAR,2018-12-31,2018-12-31,,MAMC-004250,,,MAMC-004250,,0,1.781000,0.000000,0.00000000000000000000,0,0.00000000000000000000000000,0.00000000000000000000000000,0,"",241101 - Mineral Aurifero sin Procesar,,"",14229,,,,
Ubicaciones virtuales / Produccion,Physical Locations / AMCAQ / Existencias,/ AMCAQ / Existencias,08,Mineral con Contenido Aurifero y Argentifero sin Procesar,M0001,t,MINERAL AURIFERO Y ARGENTIFERO SIN PROCESAR,2018-12-31,2018-12-31,,PAMC004256,,,PAMC004256,,1.781000,0,1.781000,270.4210477877596856,481.61988611,0,481.61988611,270.4210477877596856,"",241101 - Mineral Aurifero sin Procesar,,"",14229,,,,
Virtual Locations / Compras sin factura,Physical Locations / AQP M / Existencias,/ AQP M / Existencias,03,Mineral con Contenido Aurifero y Argentifero sin Procesar,M0001,t,MINERAL AURIFERO Y ARGENTIFERO SIN PROCESAR,2018-12-24,2018-12-24,,AQP M\IN\04780,,,AQP M\IN\04780,COMUNIDAD CAMPESINA CHILLOROYA,3.248000,0,3.248000,4715.2001231527093596,15314.97,0,15314.97,4715.2001231527093596,"",241101 - Mineral Aurifero sin Procesar,,"",14230,,,2018-12-24,
Physical Locations / AQP M / Existencias,Ubicaciones virtuales / Produccion,/ AQP M / Existencias,07,Mineral con Contenido Aurifero y Argentifero sin Procesar,M0001,t,MINERAL AURIFERO Y ARGENTIFERO SIN PROCESAR,2018-12-31,2018-12-31,,MAMC-004250,,,MAMC-004250,,0,3.248000,0.000000,4715.2001231527093596,0,15314.9699999999999999808000,0.0000000000000000192000,0,"",241101 - Mineral Aurifero sin Procesar,,"",14230,,,,
Ubicaciones virtuales / Produccion,Physical Locations / AMCAQ / Existencias,/ AMCAQ / Existencias,08,Mineral con Contenido Aurifero y Argentifero sin Procesar,M0001,t,MINERAL AURIFERO Y ARGENTIFERO SIN PROCESAR,2018-12-31,2018-12-31,,PAMC004256,,,PAMC004256,,3.248000,0,3.248000,4985.6209207727832512,16193.29675067,0,16193.29675067,4985.6209207727832512,"",241101 - Mineral Aurifero sin Procesar,,"",14230,,,,
Virtual Locations / Compras sin factura,Physical Locations / AQP M / Existencias,/ AQP M / Existencias,03,Mineral con Contenido Aurifero y Argentifero sin Procesar,M0001,t,MINERAL AURIFERO Y ARGENTIFERO SIN PROCESAR,2018-12-24,2018-12-24,,AQP M\IN\04780,,,AQP M\IN\04780,COMUNIDAD CAMPESINA CHILLOROYA,3.817000,0,3.817000,5043.7070998166099031,19251.83,0,19251.83,5043.7070998166099031,"",241101 - Mineral Aurifero sin Procesar,,"",14231,,,2018-12-24,
Physical Locations / AQP M / Existencias,Ubicaciones virtuales / Produccion,/ AQP M / Existencias,07,Mineral con Contenido Aurifero y Argentifero sin Procesar,M0001,t,MINERAL AURIFERO Y ARGENTIFERO SIN PROCESAR,2018-12-31,2018-12-31,,MAMC-004250,,,MAMC-004250,,0,3.817000,0.000000,5043.7070998166099031,0,19251.8300000000000001327000,-0.0000000000000001327000,0,"",241101 - Mineral Aurifero sin Procesar,,"",14231,,,,
Ubicaciones virtuales / Produccion,Physical Locations / AMCAQ / Existencias,/ AMCAQ / Existencias,08,Mineral con Contenido Aurifero y Argentifero sin Procesar,M0001,t,MINERAL AURIFERO Y ARGENTIFERO SIN PROCESAR,2018-12-31,2018-12-31,,PAMC004256,,,PAMC004256,,3.817000,0,3.817000,5314.1272255881582395,20284.02362007,0,20284.02362007,5314.1272255881582395,"",241101 - Mineral Aurifero sin Procesar,,"",14231,,,,
Virtual Locations / Compras sin factura,Physical Locations / AQP M / Existencias,/ AQP M / Existencias,03,Mineral con Contenido Aurifero y Argentifero sin Procesar,M0001,t,MINERAL AURIFERO Y ARGENTIFERO SIN PROCESAR,2018-12-24,2018-12-24,,AQP M\IN\04780,,,AQP M\IN\04780,COMUNIDAD CAMPESINA CHILLOROYA,3.314000,0,3.314000,5113.1351840675920338,16944.93,0,16944.93,5113.1351840675920338,"",241101 - Mineral Aurifero sin Procesar,,"",14232,,,2018-12-24,
Physical Locations / AQP M / Existencias,Ubicaciones virtuales / Produccion,/ AQP M / Existencias,07,Mineral con Contenido Aurifero y Argentifero sin Procesar,M0001,t,MINERAL AURIFERO Y ARGENTIFERO SIN PROCESAR,2018-12-31,2018-12-31,,MAMC-004250,,,MAMC-004250,,0,3.314000,0.000000,5113.1351840675920338,0,16944.9300000000000000132000,-0.0000000000000000132000,0,"",241101 - Mineral Aurifero sin Procesar,,"",14232,,,,
Ubicaciones virtuales / Produccion,Physical Locations / AMCAQ / Existencias,/ AMCAQ / Existencias,08,Mineral con Contenido Aurifero y Argentifero sin Procesar,M0001,t,MINERAL AURIFERO Y ARGENTIFERO SIN PROCESAR,2018-12-31,2018-12-31,,PAMC004256,,,PAMC004256,,3.314000,0,3.314000,5383.5554158358479179,17841.10264808,0,17841.10264808,5383.5554158358479179,"",241101 - Mineral Aurifero sin Procesar,,"",14232,,,,
Partner Locations / Suppliers,Physical Locations / AQP M / Existencias,/ AQP M / Existencias,03,Mineral con Contenido Aurifero y Argentifero sin Procesar,M0001,t,MINERAL AURIFERO Y ARGENTIFERO SIN PROCESAR,2018-12-24,2018-12-24,12/2018,AQP M\IN\04657,01,E001,0000094,SAUL JOSE GROVAS QUISPE,3.326000,0,3.326000,22915.228502705953,76216.05,0,76216.05,22915.228502705953,602101 - Mineral Aurifero sin Procesar,241101 - Mineral Aurifero sin Procesar,,"",14233,18PO06937,,2018-12-24,
Physical Locations / AQP M / Existencias,Ubicaciones virtuales / Produccion,/ AQP M / Existencias,07,Mineral con Contenido Aurifero y Argentifero sin Procesar,M0001,t,MINERAL AURIFERO Y ARGENTIFERO SIN PROCESAR,2018-12-31,2018-12-31,,MAMC-004251,,,MAMC-004251,,0,3.326000,0.000000,22915.228502705953,0,76216.049999999999678000,0.000000000000322000,0,"",241101 - Mineral Aurifero sin Procesar,,"",14233,,,,
Ubicaciones virtuales / Produccion,Physical Locations / AMCAQ / Existencias,/ AMCAQ / Existencias,08,Mineral con Contenido Aurifero y Argentifero sin Procesar,M0001,t,MINERAL AURIFERO Y ARGENTIFERO SIN PROCESAR,2018-12-31,2018-12-31,,PAMC004257,,,PAMC004257,,3.326000,0,3.326000,23185.648505944077,77115.46693077,0,77115.46693077,23185.648505944077,"",241101 - Mineral Aurifero sin Procesar,,"",14233,,,,
Partner Locations / Suppliers,Physical Locations / AQP M / Existencias,/ AQP M / Existencias,03,Mineral con Contenido Aurifero y Argentifero sin Procesar,M0002,t,LLAMPO,2018-12-24,2018-12-24,12/2018,AQP M\IN\04641,01,0001,0000286,E&F INVERSIONES MINERAS E.I.R.L.,0.458000,0,0.458000,686.7467248908296943,314.53,0,314.53,686.7467248908296943,602101 - Mineral Aurifero sin Procesar,241101 - Mineral Aurifero sin Procesar,,"",14234,18PO06823,,2018-12-24,
Physical Locations / AQP M / Existencias,Ubicaciones virtuales / Produccion,/ AQP M / Existencias,07,Mineral con Contenido Aurifero y Argentifero sin Procesar,M0002,t,LLAMPO,2018-12-31,2018-12-31,,MAMC-004251,,,MAMC-004251,,0,0.458000,0.000000,686.7467248908296943,0,314.5299999999999999894000,0.0000000000000000106000,0,"",241101 - Mineral Aurifero sin Procesar,,"",14234,,,,
Ubicaciones virtuales / Produccion,Physical Locations / AMCAQ / Existencias,/ AMCAQ / Existencias,08,Mineral con Contenido Aurifero y Argentifero sin Procesar,M0002,t,LLAMPO,2018-12-31,2018-12-31,,PAMC004257,,,PAMC004257,,0.458000,0,0.458000,892.1080499781659389,408.58548689,0,408.58548689,892.1080499781659389,"",241101 - Mineral Aurifero sin Procesar,,"",14234,,,,
Partner Locations / Suppliers,Physical Locations / AQP M / Existencias,/ AQP M / Existencias,03,Mineral con Contenido Aurifero y Argentifero sin Procesar,M0002,t,LLAMPO,2018-12-24,2018-12-24,12/2018,AQP M\IN\04641,01,0001,0000286,E&F INVERSIONES MINERAS E.I.R.L.,1.505000,0,1.505000,410.0132890365448505,617.07,0,617.07,410.0132890365448505,602101 - Mineral Aurifero sin Procesar,241101 - Mineral Aurifero sin Procesar,,"",14235,18PO06823,,2018-12-24,
Physical Locations / AQP M / Existencias,Ubicaciones virtuales / Produccion,/ AQP M / Existencias,07,Mineral con Contenido Aurifero y Argentifero sin Procesar,M0002,t,LLAMPO,2018-12-31,2018-12-31,,MAMC-004251,,,MAMC-004251,,0,1.505000,0.000000,410.0132890365448505,0,617.0700000000000000025000,-0.0000000000000000025000,0,"",241101 - Mineral Aurifero sin Procesar,,"",14235,,,,
Ubicaciones virtuales / Produccion,Physical Locations / AMCAQ / Existencias,/ AMCAQ / Existencias,08,Mineral con Contenido Aurifero y Argentifero sin Procesar,M0002,t,LLAMPO,2018-12-31,2018-12-31,,PAMC004257,,,PAMC004257,,1.505000,0,1.505000,615.3785633554817276,926.14473785,0,926.14473785,615.3785633554817276,"",241101 - Mineral Aurifero sin Procesar,,"",14235,,,,
Partner Locations / Suppliers,Physical Locations / AQP M / Existencias,/ AQP M / Existencias,03,Mineral con Contenido Aurifero y Argentifero sin Procesar,M0002,t,LLAMPO,2018-12-24,2018-12-24,12/2018,AQP M\IN\04641,01,0001,0000286,E&F INVERSIONES MINERAS E.I.R.L.,1.446000,0,1.446000,1058.6929460580912863,1530.87,0,1530.87,1058.6929460580912863,602101 - Mineral Aurifero sin Procesar,241101 - Mineral Aurifero sin Procesar,,"",14236,18PO06823,,2018-12-24,
Physical Locations / AQP M / Existencias,Ubicaciones virtuales / Produccion,/ AQP M / Existencias,07,Mineral con Contenido Aurifero y Argentifero sin Procesar,M0002,t,LLAMPO,2018-12-31,2018-12-31,,MAMC-004251,,,MAMC-004251,,0,1.446000,0.000000,1058.6929460580912863,0,1530.8699999999999999898000,0.0000000000000000102000,0,"",241101 - Mineral Aurifero sin Procesar,,"",14236,,,,
Ubicaciones virtuales / Produccion,Physical Locations / AMCAQ / Existencias,/ AMCAQ / Existencias,08,Mineral con Contenido Aurifero y Argentifero sin Procesar,M0002,t,LLAMPO,2018-12-31,2018-12-31,,PAMC004257,,,PAMC004257,,1.446000,0,1.446000,1264.0573378008298755,1827.82691046,0,1827.82691046,1264.0573378008298755,"",241101 - Mineral Aurifero sin Procesar,,"",14236,,,,
Virtual Locations / Compras sin factura,Physical Locations / AQP M / Existencias,/ AQP M / Existencias,03,Mineral con Contenido Aurifero y Argentifero sin Procesar,M0001,t,MINERAL AURIFERO Y ARGENTIFERO SIN PROCESAR,2018-12-25,2018-12-25,,AQP M\IN\04754,,,AQP M\IN\04754,EDISON SALCEDO PACHECO,3.180000,0,3.180000,2371.6415094339622642,7541.82,0,7541.82,2371.6415094339622642,"",241101 - Mineral Aurifero sin Procesar,,"",14237,,,2018-12-25,
Physical Locations / AQP M / Existencias,Ubicaciones virtuales / Produccion,/ AQP M / Existencias,07,Mineral con Contenido Aurifero y Argentifero sin Procesar,M0001,t,MINERAL AURIFERO Y ARGENTIFERO SIN PROCESAR,2018-12-31,2018-12-31,,MAMC-004251,,,MAMC-004251,,0,3.180000,0.000000,2371.6415094339622642,0,7541.8200000000000001560000,-0.0000000000000001560000,0,"",241101 - Mineral Aurifero sin Procesar,,"",14237,,,,
Ubicaciones virtuales / Produccion,Physical Locations / AMCAQ / Existencias,/ AMCAQ / Existencias,08,Mineral con Contenido Aurifero y Argentifero sin Procesar,M0001,t,MINERAL AURIFERO Y ARGENTIFERO SIN PROCESAR,2018-12-31,2018-12-31,,PAMC004257,,,PAMC004257,,3.180000,0,3.180000,2642.0611095974842767,8401.75432852,0,8401.75432852,2642.0611095974842767,"",241101 - Mineral Aurifero sin Procesar,,"",14237,,,,
Virtual Locations / Compras sin factura,Physical Locations / AQP M / Existencias,/ AQP M / Existencias,03,Mineral con Contenido Aurifero y Argentifero sin Procesar,M0001,t,MINERAL AURIFERO Y ARGENTIFERO SIN PROCESAR,2018-12-25,2018-12-25,,AQP M\IN\04754,,,AQP M\IN\04754,EDISON SALCEDO PACHECO,3.251000,0,3.251000,2493.9864657028606583,8107.95,0,8107.95,2493.9864657028606583,"",241101 - Mineral Aurifero sin Procesar,,"",14238,,,2018-12-25,
Physical Locations / AQP M / Existencias,Ubicaciones virtuales / Produccion,/ AQP M / Existencias,07,Mineral con Contenido Aurifero y Argentifero sin Procesar,M0001,t,MINERAL AURIFERO Y ARGENTIFERO SIN PROCESAR,2018-12-31,2018-12-31,,MAMC-004251,,,MAMC-004251,,0,3.251000,0.000000,2493.9864657028606583,0,8107.9500000000000001333000,-0.0000000000000001333000,0,"",241101 - Mineral Aurifero sin Procesar,,"",14238,,,,
Ubicaciones virtuales / Produccion,Physical Locations / AMCAQ / Existencias,/ AMCAQ / Existencias,08,Mineral con Contenido Aurifero y Argentifero sin Procesar,M0001,t,MINERAL AURIFERO Y ARGENTIFERO SIN PROCESAR,2018-12-31,2018-12-31,,PAMC004257,,,PAMC004257,,3.251000,0,3.251000,2764.4071931436481083,8987.08778491,0,8987.08778491,2764.4071931436481083,"",241101 - Mineral Aurifero sin Procesar,,"",14238,,,,
Partner Locations / Suppliers,Physical Locations / AQP M / Existencias,/ AQP M / Existencias,03,Mineral con Contenido Aurifero y Argentifero sin Procesar,M0001,t,MINERAL AURIFERO Y ARGENTIFERO SIN PROCESAR,2018-12-25,2018-12-25,12/2018,AQP M\IN\04654,01,0003,0000022,LALO ZENON APAZA PFOCCORI,2.620000,0,2.620000,4824.8320610687022901,12641.06,0,12641.06,4824.8320610687022901,602101 - Mineral Aurifero sin Procesar,241101 - Mineral Aurifero sin Procesar,,"",14239,18PO06929,,2018-12-25,
,,/ AQP M / Existencias,"",Mineral con Contenido Aurifero y Argentifero sin Procesar,"","",MINERAL AURIFERO Y ARGENTIFERO SIN PROCESAR,,2018-12-27,12/2018,,01,0003,0000025,LALO ZENON APAZA PFOCCORI,0,0,2.620000,4824.8816793893129771,0.13,0,12641.19,4824.8816793893129771,609201,241101 - Mineral Aurifero sin Procesar,"",,14239,,,,t
Physical Locations / AQP M / Existencias,Ubicaciones virtuales / Produccion,/ AQP M / Existencias,07,Mineral con Contenido Aurifero y Argentifero sin Procesar,M0001,t,MINERAL AURIFERO Y ARGENTIFERO SIN PROCESAR,2018-12-31,2018-12-31,,MAMC-004251,,,MAMC-004251,,0,2.620000,0.000000,4824.8816793893129771,0,12641.1900000000000000020000,-0.0000000000000000020000,0,"",241101 - Mineral Aurifero sin Procesar,,"",14239,,,,
Ubicaciones virtuales / Produccion,Physical Locations / AMCAQ / Existencias,/ AMCAQ / Existencias,08,Mineral con Contenido Aurifero y Argentifero sin Procesar,M0001,t,MINERAL AURIFERO Y ARGENTIFERO SIN PROCESAR,2018-12-31,2018-12-31,,PAMC004257,,,PAMC004257,,2.620000,0,2.620000,5095.3022157213740458,13349.69180519,0,13349.69180519,5095.3022157213740458,"",241101 - Mineral Aurifero sin Procesar,,"",14239,,,,
Partner Locations / Suppliers,Physical Locations / AQP M / Existencias,/ AQP M / Existencias,03,Mineral con Contenido Aurifero y Argentifero sin Procesar,M0001,t,MINERAL AURIFERO Y ARGENTIFERO SIN PROCESAR,2018-12-25,2018-12-25,12/2018,AQP M\IN\04654,01,0003,0000022,LALO ZENON APAZA PFOCCORI,4.748000,0,4.748000,1716.3374052232518955,8149.17,0,8149.17,1716.3374052232518955,602101 - Mineral Aurifero sin Procesar,241101 - Mineral Aurifero sin Procesar,,"",14240,18PO06929,,2018-12-25,
Physical Locations / AQP M / Existencias,Ubicaciones virtuales / Produccion,/ AQP M / Existencias,07,Mineral con Contenido Aurifero y Argentifero sin Procesar,M0001,t,MINERAL AURIFERO Y ARGENTIFERO SIN PROCESAR,2018-12-31,2018-12-31,,MAMC-004251,,,MAMC-004251,,0,4.748000,0.000000,1716.3374052232518955,0,8149.1699999999999998340000,0.0000000000000001660000,0,"",241101 - Mineral Aurifero sin Procesar,,"",14240,,,,
Ubicaciones virtuales / Produccion,Physical Locations / AMCAQ / Existencias,/ AMCAQ / Existencias,08,Mineral con Contenido Aurifero y Argentifero sin Procesar,M0001,t,MINERAL AURIFERO Y ARGENTIFERO SIN PROCESAR,2018-12-31,2018-12-31,,PAMC004257,,,PAMC004257,,4.748000,0,4.748000,1986.7576575021061500,9433.12535782,0,9433.12535782,1986.7576575021061500,"",241101 - Mineral Aurifero sin Procesar,,"",14240,,,,
Partner Locations / Suppliers,Physical Locations / AQP M / Existencias,/ AQP M / Existencias,03,Mineral con Contenido Aurifero y Argentifero sin Procesar,M0001,t,MINERAL AURIFERO Y ARGENTIFERO SIN PROCESAR,2018-12-25,2018-12-25,12/2018,AQP M\IN\04655,01,0003,0000019,LALO ZENON APAZA PFOCCORI,6.626000,0,6.626000,3009.3118019921521280,19939.7,0,19939.7,3009.3118019921521280,602101 - Mineral Aurifero sin Procesar,241101 - Mineral Aurifero sin Procesar,,"",14241,18PO06930,,2018-12-25,
,,/ AQP M / Existencias,"",Mineral con Contenido Aurifero y Argentifero sin Procesar,"","",MINERAL AURIFERO Y ARGENTIFERO SIN PROCESAR,,2018-12-27,12/2018,,01,0003,0000020,LALO ZENON APAZA PFOCCORI,0,0,6.626000,3097.7467552067612436,585.97,0,20525.67,3097.7467552067612436,609201,241101 - Mineral Aurifero sin Procesar,"",,14241,,,,t
Physical Locations / AQP M / Existencias,Ubicaciones virtuales / Produccion,/ AQP M / Existencias,07,Mineral con Contenido Aurifero y Argentifero sin Procesar,M0001,t,MINERAL AURIFERO Y ARGENTIFERO SIN PROCESAR,2018-12-31,2018-12-31,,MAMC-004251,,,MAMC-004251,,0,6.626000,0.000000,3097.7467552067612436,0,20525.6700000000000000936000,-0.0000000000000000936000,0,"",241101 - Mineral Aurifero sin Procesar,,"",14241,,,,
Ubicaciones virtuales / Produccion,Physical Locations / AMCAQ / Existencias,/ AMCAQ / Existencias,08,Mineral con Contenido Aurifero y Argentifero sin Procesar,M0001,t,MINERAL AURIFERO Y ARGENTIFERO SIN PROCESAR,2018-12-31,2018-12-31,,PAMC004257,,,PAMC004257,,6.626000,0,6.626000,3368.1668239827950498,22317.47337571,0,22317.47337571,3368.1668239827950498,"",241101 - Mineral Aurifero sin Procesar,,"",14241,,,,
Partner Locations / Suppliers,Physical Locations / AQP M / Existencias,/ AQP M / Existencias,03,Mineral con Contenido Aurifero y Argentifero sin Procesar,M0001,t,MINERAL AURIFERO Y ARGENTIFERO SIN PROCESAR,2018-12-25,2018-12-25,12/2018,AQP M\IN\04655,01,0003,0000019,LALO ZENON APAZA PFOCCORI,8.318000,0,8.318000,3675.8391440250060111,30575.63,0,30575.63,3675.8391440250060111,602101 - Mineral Aurifero sin Procesar,241101 - Mineral Aurifero sin Procesar,,"",14242,18PO06930,,2018-12-25,
,,/ AQP M / Existencias,"",Mineral con Contenido Aurifero y Argentifero sin Procesar,"","",MINERAL AURIFERO Y ARGENTIFERO SIN PROCESAR,,2018-12-27,12/2018,,01,0003,0000020,LALO ZENON APAZA PFOCCORI,0,0,8.318000,3748.9781197403221928,608.37,0,31184.00,3748.9781197403221928,609201,241101 - Mineral Aurifero sin Procesar,"",,14242,,,,t
Physical Locations / AQP M / Existencias,Ubicaciones virtuales / Produccion,/ AQP M / Existencias,07,Mineral con Contenido Aurifero y Argentifero sin Procesar,M0001,t,MINERAL AURIFERO Y ARGENTIFERO SIN PROCESAR,2018-12-31,2018-12-31,,MAMC-004251,,,MAMC-004251,,0,8.318000,0.000000,3748.9781197403221928,0,31183.9999999999999997104000,0.0000000000000002896000,0,"",241101 - Mineral Aurifero sin Procesar,,"",14242,,,,
Ubicaciones virtuales / Produccion,Physical Locations / AMCAQ / Existencias,/ AMCAQ / Existencias,08,Mineral con Contenido Aurifero y Argentifero sin Procesar,M0001,t,MINERAL AURIFERO Y ARGENTIFERO SIN PROCESAR,2018-12-31,2018-12-31,,PAMC004257,,,PAMC004257,,8.318000,0,8.318000,4019.3985155602308247,33433.35685243,0,33433.35685243,4019.3985155602308247,"",241101 - Mineral Aurifero sin Procesar,,"",14242,,,,
Partner Locations / Suppliers,Physical Locations / AQP M / Existencias,/ AQP M / Existencias,03,Mineral con Contenido Aurifero y Argentifero sin Procesar,M0001,t,MINERAL AURIFERO Y ARGENTIFERO SIN PROCESAR,2018-12-25,2018-12-25,12/2018,AQP M\IN\04647,01,E001,0000932,COMUNIDAD CAMPESINA DE UNTUCA,4.954000,0,4.954000,545.6661283811061768,2703.23,0,2703.23,545.6661283811061768,602101 - Mineral Aurifero sin Procesar,241101 - Mineral Aurifero sin Procesar,,"",14243,18PO06919,,2018-12-25,
Physical Locations / AQP M / Existencias,Ubicaciones virtuales / Produccion,/ AQP M / Existencias,07,Mineral con Contenido Aurifero y Argentifero sin Procesar,M0001,t,MINERAL AURIFERO Y ARGENTIFERO SIN PROCESAR,2018-12-31,2018-12-31,,MAMC-004252,,,MAMC-004252,,0,4.954000,0.000000,545.6661283811061768,0,2703.2299999999999998672000,0.0000000000000001328000,0,"",241101 - Mineral Aurifero sin Procesar,,"",14243,,,,
Ubicaciones virtuales / Produccion,Physical Locations / AMCAQ / Existencias,/ AMCAQ / Existencias,08,Mineral con Contenido Aurifero y Argentifero sin Procesar,M0001,t,MINERAL AURIFERO Y ARGENTIFERO SIN PROCESAR,2018-12-31,2018-12-31,,PAMC004258,,,PAMC004258,,4.954000,0,4.954000,816.0858653088413403,4042.88937674,0,4042.88937674,816.0858653088413403,"",241101 - Mineral Aurifero sin Procesar,,"",14243,,,,
Partner Locations / Suppliers,Physical Locations / AQP M / Existencias,/ AQP M / Existencias,03,Mineral con Contenido Aurifero y Argentifero sin Procesar,M0001,t,MINERAL AURIFERO Y ARGENTIFERO SIN PROCESAR,2018-12-25,2018-12-25,12/2018,AQP M\IN\04647,01,E001,0000932,COMUNIDAD CAMPESINA DE UNTUCA,4.966000,0,4.966000,631.4800644381796214,3135.93,0,3135.93,631.4800644381796214,602101 - Mineral Aurifero sin Procesar,241101 - Mineral Aurifero sin Procesar,,"",14244,18PO06919,,2018-12-25,
Physical Locations / AQP M / Existencias,Ubicaciones virtuales / Produccion,/ AQP M / Existencias,07,Mineral con Contenido Aurifero y Argentifero sin Procesar,M0001,t,MINERAL AURIFERO Y ARGENTIFERO SIN PROCESAR,2018-12-31,2018-12-31,,MAMC-004252,,,MAMC-004252,,0,4.966000,0.000000,631.4800644381796214,0,3135.9299999999999998724000,0.0000000000000001276000,0,"",241101 - Mineral Aurifero sin Procesar,,"",14244,,,,
Ubicaciones virtuales / Produccion,Physical Locations / AMCAQ / Existencias,/ AMCAQ / Existencias,08,Mineral con Contenido Aurifero y Argentifero sin Procesar,M0001,t,MINERAL AURIFERO Y ARGENTIFERO SIN PROCESAR,2018-12-31,2018-12-31,,PAMC004258,,,PAMC004258,,4.966000,0,4.966000,901.9005916633105115,4478.8383382,0,4478.8383382,901.9005916633105115,"",241101 - Mineral Aurifero sin Procesar,,"",14244,,,,
Partner Locations / Suppliers,Physical Locations / AQP M / Existencias,/ AQP M / Existencias,03,Mineral con Contenido Aurifero y Argentifero sin Procesar,M0001,t,MINERAL AURIFERO Y ARGENTIFERO SIN PROCESAR,2018-12-25,2018-12-25,12/2018,AQP M\IN\04649,01,E001,0000933,COMUNIDAD CAMPESINA DE UNTUCA,4.819000,0,4.819000,4182.1560489728159369,20153.81,0,20153.81,4182.1560489728159369,602101 - Mineral Aurifero sin Procesar,241101 - Mineral Aurifero sin Procesar,,"",14245,18PO06921,,2018-12-25,
Physical Locations / AQP M / Existencias,Ubicaciones virtuales / Produccion,/ AQP M / Existencias,07,Mineral con Contenido Aurifero y Argentifero sin Procesar,M0001,t,MINERAL AURIFERO Y ARGENTIFERO SIN PROCESAR,2018-12-31,2018-12-31,,MAMC-004252,,,MAMC-004252,,0,4.819000,0.000000,4182.1560489728159369,0,20153.8099999999999999211000,0.0000000000000000789000,0,"",241101 - Mineral Aurifero sin Procesar,,"",14245,,,,
Ubicaciones virtuales / Produccion,Physical Locations / AMCAQ / Existencias,/ AMCAQ / Existencias,08,Mineral con Contenido Aurifero y Argentifero sin Procesar,M0001,t,MINERAL AURIFERO Y ARGENTIFERO SIN PROCESAR,2018-12-31,2018-12-31,,PAMC004258,,,PAMC004258,,4.819000,0,4.819000,4452.5763392405063291,21456.9653788,0,21456.9653788,4452.5763392405063291,"",241101 - Mineral Aurifero sin Procesar,,"",14245,,,,
Partner Locations / Suppliers,Physical Locations / AQP M / Existencias,/ AQP M / Existencias,03,Mineral con Contenido Aurifero y Argentifero sin Procesar,M0001,t,MINERAL AURIFERO Y ARGENTIFERO SIN PROCESAR,2018-12-25,2018-12-25,12/2018,AQP M\IN\04649,01,E001,0000933,COMUNIDAD CAMPESINA DE UNTUCA,5.410000,0,5.410000,565.1774491682070240,3057.61,0,3057.61,565.1774491682070240,602101 - Mineral Aurifero sin Procesar,241101 - Mineral Aurifero sin Procesar,,"",14246,18PO06921,,2018-12-25,
Physical Locations / AQP M / Existencias,Ubicaciones virtuales / Produccion,/ AQP M / Existencias,07,Mineral con Contenido Aurifero y Argentifero sin Procesar,M0001,t,MINERAL AURIFERO Y ARGENTIFERO SIN PROCESAR,2018-12-31,2018-12-31,,MAMC-004252,,,MAMC-004252,,0,5.410000,0.000000,565.1774491682070240,0,3057.6099999999999998400000,0.0000000000000001600000,0,"",241101 - Mineral Aurifero sin Procesar,,"",14246,,,,
Ubicaciones virtuales / Produccion,Physical Locations / AMCAQ / Existencias,/ AMCAQ / Existencias,08,Mineral con Contenido Aurifero y Argentifero sin Procesar,M0001,t,MINERAL AURIFERO Y ARGENTIFERO SIN PROCESAR,2018-12-31,2018-12-31,,PAMC004258,,,PAMC004258,,5.410000,0,5.410000,835.5977096377079482,4520.58360914,0,4520.58360914,835.5977096377079482,"",241101 - Mineral Aurifero sin Procesar,,"",14246,,,,
Partner Locations / Suppliers,Physical Locations / AQP M / Existencias,/ AQP M / Existencias,03,Mineral con Contenido Aurifero y Argentifero sin Procesar,M0001,t,MINERAL AURIFERO Y ARGENTIFERO SIN PROCESAR,2018-12-25,2018-12-25,12/2018,AQP M\IN\04647,01,E001,0000932,COMUNIDAD CAMPESINA DE UNTUCA,5.123000,0,5.123000,617.5053679484676947,3163.48,0,3163.48,617.5053679484676947,602101 - Mineral Aurifero sin Procesar,241101 - Mineral Aurifero sin Procesar,,"",14247,18PO06919,,2018-12-25,
Physical Locations / AQP M / Existencias,Ubicaciones virtuales / Produccion,/ AQP M / Existencias,07,Mineral con Contenido Aurifero y Argentifero sin Procesar,M0001,t,MINERAL AURIFERO Y ARGENTIFERO SIN PROCESAR,2018-12-31,2018-12-31,,MAMC-004252,,,MAMC-004252,,0,5.123000,0.000000,617.5053679484676947,0,3163.4799999999999999481000,0.0000000000000000519000,0,"",241101 - Mineral Aurifero sin Procesar,,"",14247,,,,
Ubicaciones virtuales / Produccion,Physical Locations / AMCAQ / Existencias,/ AMCAQ / Existencias,08,Mineral con Contenido Aurifero y Argentifero sin Procesar,M0001,t,MINERAL AURIFERO Y ARGENTIFERO SIN PROCESAR,2018-12-31,2018-12-31,,PAMC004258,,,PAMC004258,,5.123000,0,5.123000,887.9255374214327542,4548.84252821,0,4548.84252821,887.9255374214327542,"",241101 - Mineral Aurifero sin Procesar,,"",14247,,,,
Partner Locations / Suppliers,Physical Locations / AQP M / Existencias,/ AQP M / Existencias,03,Mineral con Contenido Aurifero y Argentifero sin Procesar,M0001,t,MINERAL AURIFERO Y ARGENTIFERO SIN PROCESAR,2018-12-25,2018-12-25,12/2018,AQP M\IN\04647,01,E001,0000932,COMUNIDAD CAMPESINA DE UNTUCA,5.033000,0,5.033000,6790.1470296046095768,34174.81,0,34174.81,6790.1470296046095768,602101 - Mineral Aurifero sin Procesar,241101 - Mineral Aurifero sin Procesar,,"",14248,18PO06919,,2018-12-25,
Physical Locations / AQP M / Existencias,Ubicaciones virtuales / Produccion,/ AQP M / Existencias,07,Mineral con Contenido Aurifero y Argentifero sin Procesar,M0001,t,MINERAL AURIFERO Y ARGENTIFERO SIN PROCESAR,2018-12-31,2018-12-31,,MAMC-004252,,,MAMC-004252,,0,5.033000,0.000000,6790.1470296046095768,0,34174.8100000000000000344000,-0.0000000000000000344000,0,"",241101 - Mineral Aurifero sin Procesar,,"",14248,,,,
Ubicaciones virtuales / Produccion,Physical Locations / AMCAQ / Existencias,/ AMCAQ / Existencias,08,Mineral con Contenido Aurifero y Argentifero sin Procesar,M0001,t,MINERAL AURIFERO Y ARGENTIFERO SIN PROCESAR,2018-12-31,2018-12-31,,PAMC004258,,,PAMC004258,,5.033000,0,5.033000,7060.5671678005165905,35535.83455554,0,35535.83455554,7060.5671678005165905,"",241101 - Mineral Aurifero sin Procesar,,"",14248,,,,
Virtual Locations / Compras sin factura,Physical Locations / AQP M / Existencias,/ AQP M / Existencias,03,Mineral con Contenido Aurifero y Argentifero sin Procesar,M0001,t,MINERAL AURIFERO Y ARGENTIFERO SIN PROCESAR,2018-12-26,2018-12-26,,AQP M\IN\04744,,,AQP M\IN\04744,OSCAR EMERSON CASTILLO VILELA,28.145000,0,28.145000,663.5192751820927341,18674.75,0,18674.75,663.5192751820927341,"",241101 - Mineral Aurifero sin Procesar,,"",14249,,,2018-12-26,
Physical Locations / AQP M / Existencias,Ubicaciones virtuales / Produccion,/ AQP M / Existencias,07,Mineral con Contenido Aurifero y Argentifero sin Procesar,M0001,t,MINERAL AURIFERO Y ARGENTIFERO SIN PROCESAR,2018-12-31,2018-12-31,,MAMC-004252,,,MAMC-004252,,0,28.145000,0.000000,663.5192751820927341,0,18674.7500000000000012445000,-0.0000000000000012445000,0,"",241101 - Mineral Aurifero sin Procesar,,"",14249,,,,
Ubicaciones virtuales / Produccion,Physical Locations / AMCAQ / Existencias,/ AMCAQ / Existencias,08,Mineral con Contenido Aurifero y Argentifero sin Procesar,M0001,t,MINERAL AURIFERO Y ARGENTIFERO SIN PROCESAR,2018-12-31,2018-12-31,,PAMC004258,,,PAMC004258,,28.145000,0,28.145000,865.6525052329010481,24363.78975978,0,24363.78975978,865.6525052329010481,"",241101 - Mineral Aurifero sin Procesar,,"",14249,,,,
Virtual Locations / Compras sin factura,Physical Locations / AQP M / Existencias,/ AQP M / Existencias,03,Mineral con Contenido Aurifero y Argentifero sin Procesar,M0001,t,MINERAL AURIFERO Y ARGENTIFERO SIN PROCESAR,2018-12-26,2018-12-26,,AQP M\IN\04744,,,AQP M\IN\04744,OSCAR EMERSON CASTILLO VILELA,32.063000,0,32.063000,490.1999189096466332,15717.28,0,15717.28,490.1999189096466332,"",241101 - Mineral Aurifero sin Procesar,,"",14250,,,2018-12-26,
Physical Locations / AQP M / Existencias,Ubicaciones virtuales / Produccion,/ AQP M / Existencias,07,Mineral con Contenido Aurifero y Argentifero sin Procesar,M0001,t,MINERAL AURIFERO Y ARGENTIFERO SIN PROCESAR,2018-12-31,2018-12-31,,MAMC-004252,,,MAMC-004252,,0,32.063000,0.000000,490.1999189096466332,0,15717.2800000000000002916000,-0.0000000000000002916000,0,"",241101 - Mineral Aurifero sin Procesar,,"",14250,,,,
Ubicaciones virtuales / Produccion,Physical Locations / AMCAQ / Existencias,/ AMCAQ / Existencias,08,Mineral con Contenido Aurifero y Argentifero sin Procesar,M0001,t,MINERAL AURIFERO Y ARGENTIFERO SIN PROCESAR,2018-12-31,2018-12-31,,PAMC004258,,,PAMC004258,,32.063000,0,32.063000,692.3331613255153916,22198.27815158,0,22198.27815158,692.3331613255153916,"",241101 - Mineral Aurifero sin Procesar,,"",14250,,,,
Virtual Locations / Compras sin factura,Physical Locations / AQP M / Existencias,/ AQP M / Existencias,03,Mineral con Contenido Aurifero y Argentifero sin Procesar,M0001,t,MINERAL AURIFERO Y ARGENTIFERO SIN PROCESAR,2018-12-26,2018-12-26,,AQP M\IN\04745,,,AQP M\IN\04745,VICENTE OSCAR CASTILLO  ZAVALETA,29.944000,0,29.944000,506.8821800694629976,15178.08,0,15178.08,506.8821800694629976,"",241101 - Mineral Aurifero sin Procesar,,"",14251,,,2018-12-26,
Physical Locations / AQP M / Existencias,Ubicaciones virtuales / Produccion,/ AQP M / Existencias,07,Mineral con Contenido Aurifero y Argentifero sin Procesar,M0001,t,MINERAL AURIFERO Y ARGENTIFERO SIN PROCESAR,2018-12-31,2018-12-31,,MAMC-004252,,,MAMC-004252,,0,29.944000,0.000000,506.8821800694629976,0,15178.0800000000000001344000,-0.0000000000000001344000,0,"",241101 - Mineral Aurifero sin Procesar,,"",14251,,,,
Ubicaciones virtuales / Produccion,Physical Locations / AMCAQ / Existencias,/ AMCAQ / Existencias,08,Mineral con Contenido Aurifero y Argentifero sin Procesar,M0001,t,MINERAL AURIFERO Y ARGENTIFERO SIN PROCESAR,2018-12-31,2018-12-31,,PAMC004258,,,PAMC004258,,29.944000,0,29.944000,709.0154021346513492,21230.75720152,0,21230.75720152,709.0154021346513492,"",241101 - Mineral Aurifero sin Procesar,,"",14251,,,,
Virtual Locations / Compras sin factura,Physical Locations / AQP M / Existencias,/ AQP M / Existencias,03,Mineral con Contenido Aurifero y Argentifero sin Procesar,M0001,t,MINERAL AURIFERO Y ARGENTIFERO SIN PROCESAR,2018-12-26,2018-12-26,,AQP M\IN\04744,,,AQP M\IN\04744,OSCAR EMERSON CASTILLO VILELA,30.536000,0,30.536000,1152.1014540214828399,35180.57,0,35180.57,1152.1014540214828399,"",241101 - Mineral Aurifero sin Procesar,,"",14252,,,2018-12-26,
Physical Locations / AQP M / Existencias,Ubicaciones virtuales / Produccion,/ AQP M / Existencias,07,Mineral con Contenido Aurifero y Argentifero sin Procesar,M0001,t,MINERAL AURIFERO Y ARGENTIFERO SIN PROCESAR,2018-12-31,2018-12-31,,MAMC-004252,,,MAMC-004252,,0,30.536000,0.000000,1152.1014540214828399,0,35180.5699999999999991864000,0.0000000000000008136000,0,"",241101 - Mineral Aurifero sin Procesar,,"",14252,,,,
Ubicaciones virtuales / Produccion,Physical Locations / AMCAQ / Existencias,/ AMCAQ / Existencias,08,Mineral con Contenido Aurifero y Argentifero sin Procesar,M0001,t,MINERAL AURIFERO Y ARGENTIFERO SIN PROCESAR,2018-12-31,2018-12-31,,PAMC004258,,,PAMC004258,,30.536000,0,30.536000,1354.2346592716793293,41352.90955552,0,41352.90955552,1354.2346592716793293,"",241101 - Mineral Aurifero sin Procesar,,"",14252,,,,
Virtual Locations / Compras sin factura,Physical Locations / AQP M / Existencias,/ AQP M / Existencias,03,Mineral con Contenido Aurifero y Argentifero sin Procesar,M0001,t,MINERAL AURIFERO Y ARGENTIFERO SIN PROCESAR,2018-12-26,2018-12-26,,AQP M\IN\04744,,,AQP M\IN\04744,OSCAR EMERSON CASTILLO VILELA,29.195000,0,29.195000,352.1654392875492379,10281.47,0,10281.47,352.1654392875492379,"",241101 - Mineral Aurifero sin Procesar,,"",14253,,,2018-12-26,
Physical Locations / AQP M / Existencias,Ubicaciones virtuales / Produccion,/ AQP M / Existencias,07,Mineral con Contenido Aurifero y Argentifero sin Procesar,M0001,t,MINERAL AURIFERO Y ARGENTIFERO SIN PROCESAR,2018-12-31,2018-12-31,,MAMC-004253,,,MAMC-004253,,0,29.195000,0.000000,352.1654392875492379,0,10281.4700000000000004905000,-0.0000000000000004905000,0,"",241101 - Mineral Aurifero sin Procesar,,"",14253,,,,
Ubicaciones virtuales / Produccion,Physical Locations / AMCAQ / Existencias,/ AMCAQ / Existencias,08,Mineral con Contenido Aurifero y Argentifero sin Procesar,M0001,t,MINERAL AURIFERO Y ARGENTIFERO SIN PROCESAR,2018-12-31,2018-12-31,,PAMC004259,,,PAMC004259,,29.195000,0,29.195000,554.2986615029970885,16182.74942258,0,16182.74942258,554.2986615029970885,"",241101 - Mineral Aurifero sin Procesar,,"",14253,,,,
Virtual Locations / Compras sin factura,Physical Locations / AQP M / Existencias,/ AQP M / Existencias,03,Mineral con Contenido Aurifero y Argentifero sin Procesar,M0001,t,MINERAL AURIFERO Y ARGENTIFERO SIN PROCESAR,2018-12-27,2018-12-27,,AQP M\IN\04734,,,AQP M\IN\04734,BEATRIZ VERONICA AGUIRRE GUEVARA,3.308000,0,3.308000,149.9183796856106409,495.93,0,495.93,149.9183796856106409,"",241101 - Mineral Aurifero sin Procesar,,"",14254,,,2018-12-27,
Physical Locations / AQP M / Existencias,Ubicaciones virtuales / Produccion,/ AQP M / Existencias,07,Mineral con Contenido Aurifero y Argentifero sin Procesar,M0001,t,MINERAL AURIFERO Y ARGENTIFERO SIN PROCESAR,2018-12-31,2018-12-31,,MAMC-004253,,,MAMC-004253,,0,3.308000,0.000000,149.9183796856106409,0,495.9300000000000000972000,-0.0000000000000000972000,0,"",241101 - Mineral Aurifero sin Procesar,,"",14254,,,,
Ubicaciones virtuales / Produccion,Physical Locations / AMCAQ / Existencias,/ AMCAQ / Existencias,08,Mineral con Contenido Aurifero y Argentifero sin Procesar,M0001,t,MINERAL AURIFERO Y ARGENTIFERO SIN PROCESAR,2018-12-31,2018-12-31,,PAMC004259,,,PAMC004259,,3.308000,0,3.308000,420.3383725030229746,1390.47933624,0,1390.47933624,420.3383725030229746,"",241101 - Mineral Aurifero sin Procesar,,"",14254,,,,
Virtual Locations / Compras sin factura,Physical Locations / AQP M / Existencias,/ AQP M / Existencias,03,Mineral con Contenido Aurifero y Argentifero sin Procesar,M0001,t,MINERAL AURIFERO Y ARGENTIFERO SIN PROCESAR,2018-12-27,2018-12-27,,AQP M\IN\04757,,,AQP M\IN\04757,EFRAIN QUISPE CALDERON,9.863000,0,9.863000,1396.4229950319375444,13772.92,0,13772.92,1396.4229950319375444,"",241101 - Mineral Aurifero sin Procesar,,"",14255,,,2018-12-27,
Physical Locations / AQP M / Existencias,Ubicaciones virtuales / Produccion,/ AQP M / Existencias,07,Mineral con Contenido Aurifero y Argentifero sin Procesar,M0001,t,MINERAL AURIFERO Y ARGENTIFERO SIN PROCESAR,2018-12-31,2018-12-31,,MAMC-004253,,,MAMC-004253,,0,9.863000,0.000000,1396.4229950319375444,0,13772.9200000000000004172000,-0.0000000000000004172000,0,"",241101 - Mineral Aurifero sin Procesar,,"",14255,,,,
Ubicaciones virtuales / Produccion,Physical Locations / AMCAQ / Existencias,/ AMCAQ / Existencias,08,Mineral con Contenido Aurifero y Argentifero sin Procesar,M0001,t,MINERAL AURIFERO Y ARGENTIFERO SIN PROCESAR,2018-12-31,2018-12-31,,PAMC004259,,,PAMC004259,,9.863000,0,9.863000,1666.8430184497617358,16440.07269097,0,16440.07269097,1666.8430184497617358,"",241101 - Mineral Aurifero sin Procesar,,"",14255,,,,
Partner Locations / Suppliers,Physical Locations / AQP M / Existencias,/ AQP M / Existencias,03,Mineral con Contenido Aurifero y Argentifero sin Procesar,M0002,t,LLAMPO,2018-12-27,2018-12-27,12/2018,AQP M\IN\04660,01,E001,0000377,INVERSIONES VALEDANA E.I.R.L.,6.835000,0,6.835000,1217.6664228237015362,8322.75,0,8322.75,1217.6664228237015362,602101 - Mineral Aurifero sin Procesar,241101 - Mineral Aurifero sin Procesar,,"",14256,18PO06944,,2018-12-24,
Physical Locations / AQP M / Existencias,Ubicaciones virtuales / Produccion,/ AQP M / Existencias,07,Mineral con Contenido Aurifero y Argentifero sin Procesar,M0002,t,LLAMPO,2018-12-31,2018-12-31,,MAMC-004253,,,MAMC-004253,,0,6.835000,0.000000,1217.6664228237015362,0,8322.7499999999999999270000,0.0000000000000000730000,0,"",241101 - Mineral Aurifero sin Procesar,,"",14256,,,,
Ubicaciones virtuales / Produccion,Physical Locations / AMCAQ / Existencias,/ AMCAQ / Existencias,08,Mineral con Contenido Aurifero y Argentifero sin Procesar,M0002,t,LLAMPO,2018-12-31,2018-12-31,,PAMC004259,,,PAMC004259,,6.835000,0,6.835000,1423.0311337995610827,9726.41779952,0,9726.41779952,1423.0311337995610827,"",241101 - Mineral Aurifero sin Procesar,,"",14256,,,,
Partner Locations / Suppliers,Physical Locations / AQP M / Existencias,/ AQP M / Existencias,03,Mineral con Contenido Aurifero y Argentifero sin Procesar,M0002,t,LLAMPO,2018-12-27,2018-12-27,12/2018,AQP M\IN\04660,01,E001,0000377,INVERSIONES VALEDANA E.I.R.L.,9.280000,0,9.280000,786.1648706896551724,7295.61,0,7295.61,786.1648706896551724,602101 - Mineral Aurifero sin Procesar,241101 - Mineral Aurifero sin Procesar,,"",14257,18PO06944,,2018-12-24,
Physical Locations / AQP M / Existencias,Ubicaciones virtuales / Produccion,/ AQP M / Existencias,07,Mineral con Contenido Aurifero y Argentifero sin Procesar,M0002,t,LLAMPO,2018-12-31,2018-12-31,,MAMC-004253,,,MAMC-004253,,0,9.280000,0.000000,786.1648706896551724,0,7295.6099999999999998720000,0.0000000000000001280000,0,"",241101 - Mineral Aurifero sin Procesar,,"",14257,,,,
Ubicaciones virtuales / Produccion,Physical Locations / AMCAQ / Existencias,/ AMCAQ / Existencias,08,Mineral con Contenido Aurifero y Argentifero sin Procesar,M0002,t,LLAMPO,2018-12-31,2018-12-31,,PAMC004259,,,PAMC004259,,9.280000,0,9.280000,991.5297375883620690,9201.39596482,0,9201.39596482,991.5297375883620690,"",241101 - Mineral Aurifero sin Procesar,,"",14257,,,,
,,/ AQP M / Existencias,"",Mineral con Contenido Aurifero y Argentifero sin Procesar,"","",MINERAL AURIFERO Y ARGENTIFERO SIN PROCESAR,,2018-12-29,12/2018,,01,0004,0000388,WALTER YARASCA HERRERA,0,0,0,0,139.48,0,139.48,0,609201,241101 - Mineral Aurifero sin Procesar,"",,14258,,,,t
Partner Locations / Suppliers,Physical Locations / AQP M / Existencias,/ AQP M / Existencias,03,Mineral con Contenido Aurifero y Argentifero sin Procesar,M0002,t,LLAMPO,2018-12-27,2018-12-27,12/2018,AQP M\IN\04670,01,0004,0000387,WALTER YARASCA HERRERA,0.305000,0,0.305000,4767.6065573770491803,1454.12,0,1593.60,5224.9180327868852459,602101 - Mineral Aurifero sin Procesar,241101 - Mineral Aurifero sin Procesar,,"",14258,19PO00021,,2018-12-27,
Physical Locations / AQP M / Existencias,Ubicaciones virtuales / Produccion,/ AQP M / Existencias,07,Mineral con Contenido Aurifero y Argentifero sin Procesar,M0002,t,LLAMPO,2018-12-31,2018-12-31,,MAMC-004253,,,MAMC-004253,,0,0.300000,0.005000,5224.9180327868852459,0,1567.4754098360655737700000,26.1245901639344262300000,5224.9180327868852459,"",241101 - Mineral Aurifero sin Procesar,,"",14258,,,,
Ubicaciones virtuales / Produccion,Physical Locations / AMCAQ / Existencias,/ AMCAQ / Existencias,08,Mineral con Contenido Aurifero y Argentifero sin Procesar,M0002,t,LLAMPO,2018-12-31,2018-12-31,,PAMC004259,,,PAMC004259,,0.300000,0,0.300000,5347.3982322666666667,1604.21946968,0,1604.21946968,5347.3982322666666667,"",241101 - Mineral Aurifero sin Procesar,,"",14258,,,,
,,/ AQP M / Existencias,"",Mineral con Contenido Aurifero y Argentifero sin Procesar,"","",MINERAL AURIFERO Y ARGENTIFERO SIN PROCESAR,,2018-12-29,12/2018,,01,0004,0000388,WALTER YARASCA HERRERA,0,0,0,0,153.07,0,153.07,0,609201,241101 - Mineral Aurifero sin Procesar,"",,14259,,,,t
Partner Locations / Suppliers,Physical Locations / AQP M / Existencias,/ AQP M / Existencias,03,Mineral con Contenido Aurifero y Argentifero sin Procesar,M0002,t,LLAMPO,2018-12-27,2018-12-27,12/2018,AQP M\IN\04670,01,0004,0000387,WALTER YARASCA HERRERA,0.283000,0,0.283000,3675.0883392226148410,1040.05,0,1193.12,4215.9717314487632509,602101 - Mineral Aurifero sin Procesar,241101 - Mineral Aurifero sin Procesar,,"",14259,19PO00021,,2018-12-27,
Physical Locations / AQP M / Existencias,Ubicaciones virtuales / Produccion,/ AQP M / Existencias,07,Mineral con Contenido Aurifero y Argentifero sin Procesar,M0002,t,LLAMPO,2018-12-31,2018-12-31,,MAMC-004253,,,MAMC-004253,,0,0.283000,0.000000,4215.9717314487632509,0,1193.1200000000000000047000,-0.0000000000000000047000,0,"",241101 - Mineral Aurifero sin Procesar,,"",14259,,,,
Ubicaciones virtuales / Produccion,Physical Locations / AMCAQ / Existencias,/ AMCAQ / Existencias,08,Mineral con Contenido Aurifero y Argentifero sin Procesar,M0002,t,LLAMPO,2018-12-31,2018-12-31,,PAMC004259,,,PAMC004259,,0.283000,0,0.283000,4251.3692064664310954,1203.13748543,0,1203.13748543,4251.3692064664310954,"",241101 - Mineral Aurifero sin Procesar,,"",14259,,,,
Virtual Locations / Compras sin factura,Physical Locations / AQP M / Existencias,/ AQP M / Existencias,03,Mineral con Contenido Aurifero y Argentifero sin Procesar,M0001,t,MINERAL AURIFERO Y ARGENTIFERO SIN PROCESAR,2018-12-30,2018-12-30,,AQP M\IN\04758,,,AQP M\IN\04758,BERNARDO PROVINCIA  INCA,26.429000,0,26.429000,260.4752355367210261,6884.1,0,6884.1,260.4752355367210261,"",241101 - Mineral Aurifero sin Procesar,,"",14260,,,2018-12-30,
Physical Locations / AQP M / Existencias,Ubicaciones virtuales / Produccion,/ AQP M / Existencias,07,Mineral con Contenido Aurifero y Argentifero sin Procesar,M0001,t,MINERAL AURIFERO Y ARGENTIFERO SIN PROCESAR,2018-12-31,2018-12-31,,MAMC-004253,,,MAMC-004253,,0,26.429000,0.000000,260.4752355367210261,0,6884.0999999999999987969000,0.0000000000000012031000,0,"",241101 - Mineral Aurifero sin Procesar,,"",14260,,,,
Ubicaciones virtuales / Produccion,Physical Locations / AMCAQ / Existencias,/ AMCAQ / Existencias,08,Mineral con Contenido Aurifero y Argentifero sin Procesar,M0001,t,MINERAL AURIFERO Y ARGENTIFERO SIN PROCESAR,2018-12-31,2018-12-31,,PAMC004259,,,PAMC004259,,26.429000,0,26.429000,530.8954834469711302,14031.03673202,0,14031.03673202,530.8954834469711302,"",241101 - Mineral Aurifero sin Procesar,,"",14260,,,,
Virtual Locations / Compras sin factura,Physical Locations / AQP M / Existencias,/ AQP M / Existencias,03,Mineral con Contenido Aurifero y Argentifero sin Procesar,M0002,t,LLAMPO,2018-12-28,2018-12-28,,AQP M\IN\04781,,,AQP M\IN\04781,E&F INVERSIONES MINERAS E.I.R.L.,6.875000,0,6.875000,0.00000000000000000000,0,0,0,0.00000000000000000000,"",241101 - Mineral Aurifero sin Procesar,,"",14261,,,2018-12-28,
Physical Locations / AQP M / Existencias,Ubicaciones virtuales / Produccion,/ AQP M / Existencias,07,Mineral con Contenido Aurifero y Argentifero sin Procesar,M0002,t,LLAMPO,2018-12-31,2018-12-31,,MAMC-004253,,,MAMC-004253,,0,6.875000,0.000000,0.00000000000000000000,0,0.00000000000000000000000000,0.00000000000000000000000000,0,"",241101 - Mineral Aurifero sin Procesar,,"",14261,,,,
Ubicaciones virtuales / Produccion,Physical Locations / AMCAQ / Existencias,/ AMCAQ / Existencias,08,Mineral con Contenido Aurifero y Argentifero sin Procesar,M0002,t,LLAMPO,2018-12-31,2018-12-31,,PAMC004259,,,PAMC004259,,6.875000,0,6.875000,205.3647678923636364,1411.88277926,0,1411.88277926,205.3647678923636364,"",241101 - Mineral Aurifero sin Procesar,,"",14261,,,,
Virtual Locations / Compras sin factura,Physical Locations / AQP M / Existencias,/ AQP M / Existencias,03,Mineral con Contenido Aurifero y Argentifero sin Procesar,M0002,t,LLAMPO,2018-12-28,2018-12-28,,AQP M\IN\04781,,,AQP M\IN\04781,E&F INVERSIONES MINERAS E.I.R.L.,8.106000,0,8.106000,0.00000000000000000000,0,0,0,0.00000000000000000000,"",241101 - Mineral Aurifero sin Procesar,,"",14262,,,2018-12-28,
Physical Locations / AQP M / Existencias,Ubicaciones virtuales / Produccion,/ AQP M / Existencias,07,Mineral con Contenido Aurifero y Argentifero sin Procesar,M0002,t,LLAMPO,2018-12-31,2018-12-31,,MAMC-004253,,,MAMC-004253,,0,8.106000,0.000000,0.00000000000000000000,0,0.00000000000000000000000000,0.00000000000000000000000000,0,"",241101 - Mineral Aurifero sin Procesar,,"",14262,,,,
Ubicaciones virtuales / Produccion,Physical Locations / AMCAQ / Existencias,/ AMCAQ / Existencias,08,Mineral con Contenido Aurifero y Argentifero sin Procesar,M0002,t,LLAMPO,2018-12-31,2018-12-31,,PAMC004259,,,PAMC004259,,8.106000,0,8.106000,205.3647079607698001,1664.68632273,0,1664.68632273,205.3647079607698001,"",241101 - Mineral Aurifero sin Procesar,,"",14262,,,,
Virtual Locations / Compras sin factura,Physical Locations / AQP M / Existencias,/ AQP M / Existencias,03,Mineral con Contenido Aurifero y Argentifero sin Procesar,M0002,t,LLAMPO,2018-12-28,2018-12-28,,AQP M\IN\04781,,,AQP M\IN\04781,E&F INVERSIONES MINERAS E.I.R.L.,8.311000,0,8.311000,0.00000000000000000000,0,0,0,0.00000000000000000000,"",241101 - Mineral Aurifero sin Procesar,,"",14263,,,2018-12-28,
Physical Locations / AQP M / Existencias,Ubicaciones virtuales / Produccion,/ AQP M / Existencias,07,Mineral con Contenido Aurifero y Argentifero sin Procesar,M0002,t,LLAMPO,2018-12-31,2018-12-31,,MAMC-004254,,,MAMC-004254,,0,8.311000,0.000000,0.00000000000000000000,0,0.00000000000000000000000000,0.00000000000000000000000000,0,"",241101 - Mineral Aurifero sin Procesar,,"",14263,,,,
Ubicaciones virtuales / Produccion,Physical Locations / AMCAQ / Existencias,/ AMCAQ / Existencias,08,Mineral con Contenido Aurifero y Argentifero sin Procesar,M0002,t,LLAMPO,2018-12-31,2018-12-31,,PAMC004260,,,PAMC004260,,8.311000,0,8.311000,205.3648645036698352,1706.78738889,0,1706.78738889,205.3648645036698352,"",241101 - Mineral Aurifero sin Procesar,,"",14263,,,,
Virtual Locations / Compras sin factura,Physical Locations / AQP M / Existencias,/ AQP M / Existencias,03,Mineral con Contenido Aurifero y Argentifero sin Procesar,M0002,t,LLAMPO,2018-12-28,2018-12-28,,AQP M\IN\04781,,,AQP M\IN\04781,E&F INVERSIONES MINERAS E.I.R.L.,10.212000,0,10.212000,0.00000000000000000000,0,0,0,0.00000000000000000000,"",241101 - Mineral Aurifero sin Procesar,,"",14264,,,2018-12-28,
Physical Locations / AQP M / Existencias,Ubicaciones virtuales / Produccion,/ AQP M / Existencias,07,Mineral con Contenido Aurifero y Argentifero sin Procesar,M0002,t,LLAMPO,2018-12-31,2018-12-31,,MAMC-004254,,,MAMC-004254,,0,10.212000,0.000000,0.00000000000000000000,0,0.00000000000000000000000000,0.00000000000000000000000000,0,"",241101 - Mineral Aurifero sin Procesar,,"",14264,,,,
Ubicaciones virtuales / Produccion,Physical Locations / AMCAQ / Existencias,/ AMCAQ / Existencias,08,Mineral con Contenido Aurifero y Argentifero sin Procesar,M0002,t,LLAMPO,2018-12-31,2018-12-31,,PAMC004260,,,PAMC004260,,10.212000,0,10.212000,205.3649050078339209,2097.18640994,0,2097.18640994,205.3649050078339209,"",241101 - Mineral Aurifero sin Procesar,,"",14264,,,,
Virtual Locations / Compras sin factura,Physical Locations / AQP M / Existencias,/ AQP M / Existencias,03,Mineral con Contenido Aurifero y Argentifero sin Procesar,M0002,t,LLAMPO,2018-12-28,2018-12-28,,AQP M\IN\04781,,,AQP M\IN\04781,E&F INVERSIONES MINERAS E.I.R.L.,13.414000,0,13.414000,0.00000000000000000000,0,0,0,0.00000000000000000000,"",241101 - Mineral Aurifero sin Procesar,,"",14265,,,2018-12-28,
Physical Locations / AQP M / Existencias,Ubicaciones virtuales / Produccion,/ AQP M / Existencias,07,Mineral con Contenido Aurifero y Argentifero sin Procesar,M0002,t,LLAMPO,2018-12-31,2018-12-31,,MAMC-004254,,,MAMC-004254,,0,13.414000,0.000000,0.00000000000000000000,0,0.00000000000000000000000000,0.00000000000000000000000000,0,"",241101 - Mineral Aurifero sin Procesar,,"",14265,,,,
Ubicaciones virtuales / Produccion,Physical Locations / AMCAQ / Existencias,/ AMCAQ / Existencias,08,Mineral con Contenido Aurifero y Argentifero sin Procesar,M0002,t,LLAMPO,2018-12-31,2018-12-31,,PAMC004260,,,PAMC004260,,13.414000,0,13.414000,205.3648672565975846,2754.76432938,0,2754.76432938,205.3648672565975846,"",241101 - Mineral Aurifero sin Procesar,,"",14265,,,,
Ubicaciones virtuales / Transformacion Lote Trujillo,Physical Locations / AMCAQ / Existencias,/ AMCAQ / Existencias,06,Mineral con Contenido Aurifero y Argentifero sin Procesar,M0001,t,MINERAL AURIFERO Y ARGENTIFERO SIN PROCESAR,2018-12-29,2018-12-29,,ILT-000331,,,ILT-000331,NEGOCIOS ARGOS E.I.R.L.,27.614000,0,27.614000,12239.658203872673,337985.92164174,0,337985.92164174,12239.658203872673,"",241101 - Mineral Aurifero sin Procesar,,"",14266,,,2018-12-29,
Physical Locations / AMCTJ / Existencias,Ubicaciones virtuales / Transformacion Lote Trujillo,/ AMCTJ / Existencias,06,Mineral con Contenido Aurifero y Argentifero sin Procesar,M0001,t,MINERAL AURIFERO Y ARGENTIFERO SIN PROCESAR,2018-12-29,2018-12-29,,CLT-000316,,,CLT-000316,NEGOCIOS ARGOS E.I.R.L.,0,27.614000,-27.614000,0,0,0.000000,0.000000,0,"",241101 - Mineral Aurifero sin Procesar,0000 LOTES TRUJILLO,"",14266,,,2018-12-29,
Ubicaciones virtuales / Transformacion Lote Trujillo,Physical Locations / AMCAQ / Existencias,/ AMCAQ / Existencias,06,Mineral con Contenido Aurifero y Argentifero sin Procesar,M0001,t,MINERAL AURIFERO Y ARGENTIFERO SIN PROCESAR,2018-12-29,2018-12-29,,ILT-000333,,,ILT-000333,FERMINA MARGARITA SALIRROSAS BACA,7.023000,0,7.023000,3045.4218060444254592,21387.99734385,0,21387.99734385,3045.4218060444254592,"",241101 - Mineral Aurifero sin Procesar,,"",14267,,,2018-12-29,
Physical Locations / AMCTJ / Existencias,Ubicaciones virtuales / Transformacion Lote Trujillo,/ AMCTJ / Existencias,06,Mineral con Contenido Aurifero y Argentifero sin Procesar,M0001,t,MINERAL AURIFERO Y ARGENTIFERO SIN PROCESAR,2018-12-29,2018-12-29,,CLT-000318,,,CLT-000318,FERMINA MARGARITA SALIRROSAS BACA,0,7.023000,-7.023000,0,0,0.000000,0.000000,0,"",241101 - Mineral Aurifero sin Procesar,0000 LOTES TRUJILLO,"",14267,,,2018-12-29,
Ubicaciones virtuales / Transformacion Lote Trujillo,Physical Locations / AMCAQ / Existencias,/ AMCAQ / Existencias,06,Mineral con Contenido Aurifero y Argentifero sin Procesar,M0001,t,MINERAL AURIFERO Y ARGENTIFERO SIN PROCESAR,2018-12-29,2018-12-29,,ILT-000333,,,ILT-000333,FERMINA MARGARITA SALIRROSAS BACA,23.757000,0,23.757000,3045.4218060436923854,72350.08584618,0,72350.08584618,3045.4218060436923854,"",241101 - Mineral Aurifero sin Procesar,,"",14268,,,2018-12-29,
Physical Locations / AMCTJ / Existencias,Ubicaciones virtuales / Transformacion Lote Trujillo,/ AMCTJ / Existencias,06,Mineral con Contenido Aurifero y Argentifero sin Procesar,M0001,t,MINERAL AURIFERO Y ARGENTIFERO SIN PROCESAR,2018-12-29,2018-12-29,,CLT-000318,,,CLT-000318,FERMINA MARGARITA SALIRROSAS BACA,0,23.757000,-23.757000,0,0,0.000000,0.000000,0,"",241101 - Mineral Aurifero sin Procesar,0000 LOTES TRUJILLO,"",14268,,,2018-12-29,
Ubicaciones virtuales / Transformacion Lote Trujillo,Physical Locations / AMCAQ / Existencias,/ AMCAQ / Existencias,06,Mineral con Contenido Aurifero y Argentifero sin Procesar,M0001,t,MINERAL AURIFERO Y ARGENTIFERO SIN PROCESAR,2018-12-29,2018-12-29,,ILT-000339,,,ILT-000339,MASIAS ROGELIO HUERTA  ALVARADO,6.688000,0,6.688000,351.7136843151913876,2352.2611207,0,2352.2611207,351.7136843151913876,"",241101 - Mineral Aurifero sin Procesar,,"",14269,,,2018-12-29,
Physical Locations / AMCTJ / Existencias,Ubicaciones virtuales / Transformacion Lote Trujillo,/ AMCTJ / Existencias,06,Mineral con Contenido Aurifero y Argentifero sin Procesar,M0001,t,MINERAL AURIFERO Y ARGENTIFERO SIN PROCESAR,2018-12-29,2018-12-29,,CLT-000324,,,CLT-000324,MASIAS ROGELIO HUERTA  ALVARADO,0,6.688000,-6.688000,0,0,0.000000,0.000000,0,"",241101 - Mineral Aurifero sin Procesar,0000 LOTES TRUJILLO,"",14269,,,2018-12-29,
Ubicaciones virtuales / Transformacion Lote Trujillo,Physical Locations / AMCAQ / Existencias,/ AMCAQ / Existencias,06,Mineral con Contenido Aurifero y Argentifero sin Procesar,M0001,t,MINERAL AURIFERO Y ARGENTIFERO SIN PROCESAR,2018-12-29,2018-12-29,,ILT-000339,,,ILT-000339,MASIAS ROGELIO HUERTA  ALVARADO,29.606000,0,29.606000,351.7136843150037155,10412.83533783,0,10412.83533783,351.7136843150037155,"",241101 - Mineral Aurifero sin Procesar,,"",14270,,,2018-12-29,
Physical Locations / AMCTJ / Existencias,Ubicaciones virtuales / Transformacion Lote Trujillo,/ AMCTJ / Existencias,06,Mineral con Contenido Aurifero y Argentifero sin Procesar,M0001,t,MINERAL AURIFERO Y ARGENTIFERO SIN PROCESAR,2018-12-29,2018-12-29,,CLT-000324,,,CLT-000324,MASIAS ROGELIO HUERTA  ALVARADO,0,29.606000,-29.606000,0,0,0.000000,0.000000,0,"",241101 - Mineral Aurifero sin Procesar,0000 LOTES TRUJILLO,"",14270,,,2018-12-29,
Ubicaciones virtuales / Transformacion Lote Trujillo,Physical Locations / AMCAQ / Existencias,/ AMCAQ / Existencias,06,Mineral con Contenido Aurifero y Argentifero sin Procesar,M0001,t,MINERAL AURIFERO Y ARGENTIFERO SIN PROCESAR,2018-12-29,2018-12-29,,ILT-000334,,,ILT-000334,LEYDEN VEGA CASTAÑEDA,1.594000,0,1.594000,2950.6571841028858218,4703.34755146,0,4703.34755146,2950.6571841028858218,"",241101 - Mineral Aurifero sin Procesar,,"",14271,,,2018-12-29,
Physical Locations / AMCTJ / Existencias,Ubicaciones virtuales / Transformacion Lote Trujillo,/ AMCTJ / Existencias,06,Mineral con Contenido Aurifero y Argentifero sin Procesar,M0001,t,MINERAL AURIFERO Y ARGENTIFERO SIN PROCESAR,2018-12-29,2018-12-29,,CLT-000319,,,CLT-000319,LEYDEN VEGA CASTAÑEDA,0,1.594000,-1.594000,0,0,0.000000,0.000000,0,"",241101 - Mineral Aurifero sin Procesar,0000 LOTES TRUJILLO,"",14271,,,2018-12-29,
Virtual Locations / Compras sin factura,Physical Locations / AQP M / Existencias,/ AQP M / Existencias,03,Mineral con Contenido Aurifero y Argentifero sin Procesar,M0002,t,LLAMPO,2018-12-29,2018-12-29,,AQP M\IN\04759,,,AQP M\IN\04759,RAUL HUALLPA CHACO,2.619000,0,2.619000,842.8102329133256968,2207.32,0,2207.32,842.8102329133256968,"",241101 - Mineral Aurifero sin Procesar,,"",14272,,,2018-12-29,
Physical Locations / AQP M / Existencias,Ubicaciones virtuales / Produccion,/ AQP M / Existencias,07,Mineral con Contenido Aurifero y Argentifero sin Procesar,M0002,t,LLAMPO,2018-12-31,2018-12-31,,MAMC-004254,,,MAMC-004254,,0,2.619000,0.000000,842.8102329133256968,0,2207.3199999999999999192000,0.0000000000000000808000,0,"",241101 - Mineral Aurifero sin Procesar,,"",14272,,,,
Ubicaciones virtuales / Produccion,Physical Locations / AMCAQ / Existencias,/ AMCAQ / Existencias,08,Mineral con Contenido Aurifero y Argentifero sin Procesar,M0002,t,LLAMPO,2018-12-31,2018-12-31,,PAMC004260,,,PAMC004260,,2.619000,0,2.619000,1048.1753821573119511,2745.17132587,0,2745.17132587,1048.1753821573119511,"",241101 - Mineral Aurifero sin Procesar,,"",14272,,,,
Virtual Locations / Compras sin factura,Physical Locations / AQP M / Existencias,/ AQP M / Existencias,03,Mineral con Contenido Aurifero y Argentifero sin Procesar,M0002,t,LLAMPO,2018-12-30,2018-12-30,,AQP M\IN\04743,,,AQP M\IN\04743,VALENTIN CHOQQUE MAQUI,17.028000,0,17.028000,747.3314540756401222,12725.56,0,12725.56,747.3314540756401222,"",241101 - Mineral Aurifero sin Procesar,,"",14273,,,2018-12-30,
Physical Locations / AQP M / Existencias,Ubicaciones virtuales / Produccion,/ AQP M / Existencias,07,Mineral con Contenido Aurifero y Argentifero sin Procesar,M0002,t,LLAMPO,2018-12-31,2018-12-31,,MAMC-004254,,,MAMC-004254,,0,17.028000,0.000000,747.3314540756401222,0,12725.5600000000000008216000,-0.0000000000000008216000,0,"",241101 - Mineral Aurifero sin Procesar,,"",14273,,,,
Ubicaciones virtuales / Produccion,Physical Locations / AMCAQ / Existencias,/ AMCAQ / Existencias,08,Mineral con Contenido Aurifero y Argentifero sin Procesar,M0002,t,LLAMPO,2018-12-31,2018-12-31,,PAMC004260,,,PAMC004260,,17.028000,0,17.028000,952.6962274970636599,16222.51136182,0,16222.51136182,952.6962274970636599,"",241101 - Mineral Aurifero sin Procesar,,"",14273,,,,
Ubicaciones virtuales / Transformacion Lote Trujillo,Physical Locations / AMCAQ / Existencias,/ AMCAQ / Existencias,06,Mineral con Contenido Aurifero y Argentifero sin Procesar,M0001,t,MINERAL AURIFERO Y ARGENTIFERO SIN PROCESAR,2018-12-29,2018-12-29,,ILT-000339,,,ILT-000339,MASIAS ROGELIO HUERTA  ALVARADO,1.393000,0,1.393000,1206.4799960732232592,1680.62663453,0,1680.62663453,1206.4799960732232592,"",241101 - Mineral Aurifero sin Procesar,,"",14274,,,2018-12-29,
Physical Locations / AMCTJ / Existencias,Ubicaciones virtuales / Transformacion Lote Trujillo,/ AMCTJ / Existencias,06,Mineral con Contenido Aurifero y Argentifero sin Procesar,M0001,t,MINERAL AURIFERO Y ARGENTIFERO SIN PROCESAR,2018-12-29,2018-12-29,,CLT-000324,,,CLT-000324,MASIAS ROGELIO HUERTA  ALVARADO,0,1.393000,-1.393000,0,0,0.000000,0.000000,0,"",241101 - Mineral Aurifero sin Procesar,0000 LOTES TRUJILLO,"",14274,,,2018-12-29,
Ubicaciones virtuales / Transformacion Lote Trujillo,Physical Locations / AMCAQ / Existencias,/ AMCAQ / Existencias,06,Mineral con Contenido Aurifero y Argentifero sin Procesar,M0001,t,MINERAL AURIFERO Y ARGENTIFERO SIN PROCESAR,2018-12-29,2018-12-29,,ILT-000334,,,ILT-000334,LEYDEN VEGA CASTAÑEDA,28.948000,0,28.948000,2950.6571841018377781,85415.62416538,0,85415.62416538,2950.6571841018377781,"",241101 - Mineral Aurifero sin Procesar,,"",14275,,,2018-12-29,
Physical Locations / AMCTJ / Existencias,Ubicaciones virtuales / Transformacion Lote Trujillo,/ AMCTJ / Existencias,06,Mineral con Contenido Aurifero y Argentifero sin Procesar,M0001,t,MINERAL AURIFERO Y ARGENTIFERO SIN PROCESAR,2018-12-29,2018-12-29,,CLT-000319,,,CLT-000319,LEYDEN VEGA CASTAÑEDA,0,28.948000,-28.948000,0,0,0.000000,0.000000,0,"",241101 - Mineral Aurifero sin Procesar,0000 LOTES TRUJILLO,"",14275,,,2018-12-29,
Virtual Locations / Compras sin factura,Physical Locations / AQP M / Existencias,/ AQP M / Existencias,03,Mineral con Contenido Aurifero y Argentifero sin Procesar,M0001,t,MINERAL AURIFERO Y ARGENTIFERO SIN PROCESAR,2018-12-30,2018-12-30,,AQP M\IN\04758,,,AQP M\IN\04758,BERNARDO PROVINCIA  INCA,25.457000,0,25.457000,283.4190988726087127,7215,0,7215,283.4190988726087127,"",241101 - Mineral Aurifero sin Procesar,,"",14276,,,2018-12-30,
Physical Locations / AQP M / Existencias,Ubicaciones virtuales / Produccion,/ AQP M / Existencias,07,Mineral con Contenido Aurifero y Argentifero sin Procesar,M0001,t,MINERAL AURIFERO Y ARGENTIFERO SIN PROCESAR,2018-12-31,2018-12-31,,MAMC-004254,,,MAMC-004254,,0,25.457000,0.000000,283.4190988726087127,0,7214.9999999999999992039000,0.0000000000000007961000,0,"",241101 - Mineral Aurifero sin Procesar,,"",14276,,,,
Ubicaciones virtuales / Produccion,Physical Locations / AMCAQ / Existencias,/ AMCAQ / Existencias,08,Mineral con Contenido Aurifero y Argentifero sin Procesar,M0001,t,MINERAL AURIFERO Y ARGENTIFERO SIN PROCESAR,2018-12-31,2018-12-31,,PAMC004260,,,PAMC004260,,25.457000,0,25.457000,553.8393391464037396,14099.08805665,0,14099.08805665,553.8393391464037396,"",241101 - Mineral Aurifero sin Procesar,,"",14276,,,,
Ubicaciones virtuales / Transformacion Lote Trujillo,Physical Locations / AMCAQ / Existencias,/ AMCAQ / Existencias,06,Mineral con Contenido Aurifero y Argentifero sin Procesar,M0001,t,MINERAL AURIFERO Y ARGENTIFERO SIN PROCESAR,2018-12-29,2018-12-29,,ILT-000334,,,ILT-000334,LEYDEN VEGA CASTAÑEDA,5.096000,0,5.096000,8550.7209048037676609,43574.47373088,0,43574.47373088,8550.7209048037676609,"",241101 - Mineral Aurifero sin Procesar,,"",14277,,,2018-12-29,
Physical Locations / AMCTJ / Existencias,Ubicaciones virtuales / Transformacion Lote Trujillo,/ AMCTJ / Existencias,06,Mineral con Contenido Aurifero y Argentifero sin Procesar,M0001,t,MINERAL AURIFERO Y ARGENTIFERO SIN PROCESAR,2018-12-29,2018-12-29,,CLT-000319,,,CLT-000319,LEYDEN VEGA CASTAÑEDA,0,5.096000,-5.096000,0,0,0.000000,0.000000,0,"",241101 - Mineral Aurifero sin Procesar,0000 LOTES TRUJILLO,"",14277,,,2018-12-29,
Ubicaciones virtuales / Transformacion Lote Trujillo,Physical Locations / AMCAQ / Existencias,/ AMCAQ / Existencias,06,Mineral con Contenido Aurifero y Argentifero sin Procesar,M0001,t,MINERAL AURIFERO Y ARGENTIFERO SIN PROCESAR,2018-12-29,2018-12-29,,ILT-000339,,,ILT-000339,MASIAS ROGELIO HUERTA  ALVARADO,36.006000,0,36.006000,1206.4799960748208632,43440.51873867,0,43440.51873867,1206.4799960748208632,"",241101 - Mineral Aurifero sin Procesar,,"",14278,,,2018-12-29,
Physical Locations / AMCTJ / Existencias,Ubicaciones virtuales / Transformacion Lote Trujillo,/ AMCTJ / Existencias,06,Mineral con Contenido Aurifero y Argentifero sin Procesar,M0001,t,MINERAL AURIFERO Y ARGENTIFERO SIN PROCESAR,2018-12-29,2018-12-29,,CLT-000324,,,CLT-000324,MASIAS ROGELIO HUERTA  ALVARADO,0,36.006000,-36.006000,0,0,0.000000,0.000000,0,"",241101 - Mineral Aurifero sin Procesar,0000 LOTES TRUJILLO,"",14278,,,2018-12-29,
Virtual Locations / Compras sin factura,Physical Locations / AQP M / Existencias,/ AQP M / Existencias,03,Mineral con Contenido Aurifero y Argentifero sin Procesar,M0002,t,LLAMPO,2018-12-29,2018-12-29,,AQP M\IN\04760,,,AQP M\IN\04760,KELER EDGAR TORRES CARHUAS,5.435000,0,5.435000,1615.3063477460901564,8779.19,0,8779.19,1615.3063477460901564,"",241101 - Mineral Aurifero sin Procesar,,"",14279,,,2018-12-29,
Physical Locations / AQP M / Existencias,Ubicaciones virtuales / Produccion,/ AQP M / Existencias,07,Mineral con Contenido Aurifero y Argentifero sin Procesar,M0002,t,LLAMPO,2018-12-31,2018-12-31,,MAMC-004254,,,MAMC-004254,,0,5.435000,0.000000,1615.3063477460901564,0,8779.1900000000000000340000,-0.0000000000000000340000,0,"",241101 - Mineral Aurifero sin Procesar,,"",14279,,,,
Ubicaciones virtuales / Produccion,Physical Locations / AMCAQ / Existencias,/ AMCAQ / Existencias,08,Mineral con Contenido Aurifero y Argentifero sin Procesar,M0002,t,LLAMPO,2018-12-31,2018-12-31,,PAMC004260,,,PAMC004260,,5.435000,0,5.435000,1820.6714934075436983,9895.34956667,0,9895.34956667,1820.6714934075436983,"",241101 - Mineral Aurifero sin Procesar,,"",14279,,,,
Virtual Locations / Compras sin factura,Physical Locations / AQP M / Existencias,/ AQP M / Existencias,03,Mineral con Contenido Aurifero y Argentifero sin Procesar,M0001,t,MINERAL AURIFERO Y ARGENTIFERO SIN PROCESAR,2018-12-29,2018-12-29,,AQP M\IN\04782,,,AQP M\IN\04782,HELARD MANUEL BELLIDO PERLACIO,1.947000,0,1.947000,716.2865947611710324,1394.61,0,1394.61,716.2865947611710324,"",241101 - Mineral Aurifero sin Procesar,,"",14280,,,2018-12-29,
Physical Locations / AQP M / Existencias,Ubicaciones virtuales / Produccion,/ AQP M / Existencias,07,Mineral con Contenido Aurifero y Argentifero sin Procesar,M0001,t,MINERAL AURIFERO Y ARGENTIFERO SIN PROCESAR,2018-12-31,2018-12-31,,MAMC-004254,,,MAMC-004254,,0,1.947000,0.000000,716.2865947611710324,0,1394.6100000000000000828000,-0.0000000000000000828000,0,"",241101 - Mineral Aurifero sin Procesar,,"",14280,,,,
Ubicaciones virtuales / Produccion,Physical Locations / AMCAQ / Existencias,/ AMCAQ / Existencias,08,Mineral con Contenido Aurifero y Argentifero sin Procesar,M0001,t,MINERAL AURIFERO Y ARGENTIFERO SIN PROCESAR,2018-12-31,2018-12-31,,PAMC004260,,,PAMC004260,,1.947000,0,1.947000,986.7063813918849512,1921.11732457,0,1921.11732457,986.7063813918849512,"",241101 - Mineral Aurifero sin Procesar,,"",14280,,,,
Virtual Locations / Compras sin factura,Physical Locations / AQP M / Existencias,/ AQP M / Existencias,03,Mineral con Contenido Aurifero y Argentifero sin Procesar,M0001,t,MINERAL AURIFERO Y ARGENTIFERO SIN PROCESAR,2018-12-29,2018-12-29,,AQP M\IN\04762,,,AQP M\IN\04762,NAYDA ALICIA OSCCO HUACCALLO,4.437000,0,4.437000,368.9159341897678612,1636.88,0,1636.88,368.9159341897678612,"",241101 - Mineral Aurifero sin Procesar,,"",14281,,,2018-12-29,
Physical Locations / AQP M / Existencias,Ubicaciones virtuales / Produccion,/ AQP M / Existencias,07,Mineral con Contenido Aurifero y Argentifero sin Procesar,M0001,t,MINERAL AURIFERO Y ARGENTIFERO SIN PROCESAR,2018-12-31,2018-12-31,,MAMC-004254,,,MAMC-004254,,0,4.437000,0.000000,368.9159341897678612,0,1636.8800000000000001444000,-0.0000000000000001444000,0,"",241101 - Mineral Aurifero sin Procesar,,"",14281,,,,
Ubicaciones virtuales / Produccion,Physical Locations / AMCAQ / Existencias,/ AMCAQ / Existencias,08,Mineral con Contenido Aurifero y Argentifero sin Procesar,M0001,t,MINERAL AURIFERO Y ARGENTIFERO SIN PROCESAR,2018-12-31,2018-12-31,,PAMC004260,,,PAMC004260,,4.437000,0,4.437000,639.3359043790849673,2836.73340773,0,2836.73340773,639.3359043790849673,"",241101 - Mineral Aurifero sin Procesar,,"",14281,,,,
Virtual Locations / Compras sin factura,Physical Locations / AQP M / Existencias,/ AQP M / Existencias,03,Mineral con Contenido Aurifero y Argentifero sin Procesar,M0002,t,LLAMPO,2018-12-29,2018-12-29,,AQP M\IN\04783,,,AQP M\IN\04783,WILLIAM GUEVARA INGA,8.470000,0,8.470000,1790.6162927981109799,15166.52,0,15166.52,1790.6162927981109799,"",241101 - Mineral Aurifero sin Procesar,,"",14282,,,2018-12-29,
Physical Locations / AQP M / Existencias,Ubicaciones virtuales / Produccion,/ AQP M / Existencias,07,Mineral con Contenido Aurifero y Argentifero sin Procesar,M0002,t,LLAMPO,2018-12-31,2018-12-31,,MAMC-004254,,,MAMC-004254,,0,8.470000,0.000000,1790.6162927981109799,0,15166.5199999999999997530000,0.0000000000000002470000,0,"",241101 - Mineral Aurifero sin Procesar,,"",14282,,,,
Ubicaciones virtuales / Produccion,Physical Locations / AMCAQ / Existencias,/ AMCAQ / Existencias,08,Mineral con Contenido Aurifero y Argentifero sin Procesar,M0002,t,LLAMPO,2018-12-31,2018-12-31,,PAMC004260,,,PAMC004260,,8.470000,0,8.470000,1995.9810835218417946,16905.95977743,0,16905.95977743,1995.9810835218417946,"",241101 - Mineral Aurifero sin Procesar,,"",14282,,,,
Virtual Locations / Compras sin factura,Physical Locations / AQP M / Existencias,/ AQP M / Existencias,03,Mineral con Contenido Aurifero y Argentifero sin Procesar,M0002,t,LLAMPO,2018-12-30,2018-12-30,,AQP M\IN\04763,,,AQP M\IN\04763,LUIS GONZAGA VALDIVIA RANILLA,0.987000,0,0.987000,1188.8247213779128673,1173.37,0,1173.37,1188.8247213779128673,"",241101 - Mineral Aurifero sin Procesar,,"",14283,,,2018-12-30,
Physical Locations / AQP M / Existencias,Ubicaciones virtuales / Produccion,/ AQP M / Existencias,07,Mineral con Contenido Aurifero y Argentifero sin Procesar,M0002,t,LLAMPO,2018-12-31,2018-12-31,,MAMC-004255,,,MAMC-004255,,0,0.987000,0.000000,1188.8247213779128673,0,1173.3700000000000000251000,-0.0000000000000000251000,0,"",241101 - Mineral Aurifero sin Procesar,,"",14283,,,,
Ubicaciones virtuales / Produccion,Physical Locations / AMCAQ / Existencias,/ AMCAQ / Existencias,08,Mineral con Contenido Aurifero y Argentifero sin Procesar,M0002,t,LLAMPO,2018-12-31,2018-12-31,,PAMC004261,,,PAMC004261,,0.987000,0,0.987000,1394.1894913779128673,1376.06502799,0,1376.06502799,1394.1894913779128673,"",241101 - Mineral Aurifero sin Procesar,,"",14283,,,,
Virtual Locations / Compras sin factura,Physical Locations / AQP M / Existencias,/ AQP M / Existencias,03,Mineral con Contenido Aurifero y Argentifero sin Procesar,M0002,t,LLAMPO,2018-12-29,2018-12-29,,AQP M\IN\04783,,,AQP M\IN\04783,WILLIAM GUEVARA INGA,14.098000,0,14.098000,1796.9527592566321464,25333.44,0,25333.44,1796.9527592566321464,"",241101 - Mineral Aurifero sin Procesar,,"",14284,,,2018-12-29,
Physical Locations / AQP M / Existencias,Ubicaciones virtuales / Produccion,/ AQP M / Existencias,07,Mineral con Contenido Aurifero y Argentifero sin Procesar,M0002,t,LLAMPO,2018-12-31,2018-12-31,,MAMC-004255,,,MAMC-004255,,0,14.098000,0.000000,1796.9527592566321464,0,25333.4399999999999999472000,0.0000000000000000528000,0,"",241101 - Mineral Aurifero sin Procesar,,"",14284,,,,
Ubicaciones virtuales / Produccion,Physical Locations / AMCAQ / Existencias,/ AMCAQ / Existencias,08,Mineral con Contenido Aurifero y Argentifero sin Procesar,M0002,t,LLAMPO,2018-12-31,2018-12-31,,PAMC004261,,,PAMC004261,,14.098000,0,14.098000,2002.3176467165555398,28228.67418341,0,28228.67418341,2002.3176467165555398,"",241101 - Mineral Aurifero sin Procesar,,"",14284,,,,
Virtual Locations / Compras sin factura,Physical Locations / AQP M / Existencias,/ AQP M / Existencias,03,Mineral con Contenido Aurifero y Argentifero sin Procesar,M0001,t,MINERAL AURIFERO Y ARGENTIFERO SIN PROCESAR,2018-12-30,2018-12-30,,AQP M\IN\04763,,,AQP M\IN\04763,LUIS GONZAGA VALDIVIA RANILLA,0.679000,0,0.679000,784.4771723122238586,532.66,0,532.66,784.4771723122238586,"",241101 - Mineral Aurifero sin Procesar,,"",14285,,,2018-12-30,
Physical Locations / AQP M / Existencias,Ubicaciones virtuales / Produccion,/ AQP M / Existencias,07,Mineral con Contenido Aurifero y Argentifero sin Procesar,M0001,t,MINERAL AURIFERO Y ARGENTIFERO SIN PROCESAR,2018-12-31,2018-12-31,,MAMC-004255,,,MAMC-004255,,0,0.679000,0.000000,784.4771723122238586,0,532.6599999999999999894000,0.0000000000000000106000,0,"",241101 - Mineral Aurifero sin Procesar,,"",14285,,,,
Ubicaciones virtuales / Produccion,Physical Locations / AMCAQ / Existencias,/ AMCAQ / Existencias,08,Mineral con Contenido Aurifero y Argentifero sin Procesar,M0001,t,MINERAL AURIFERO Y ARGENTIFERO SIN PROCESAR,2018-12-31,2018-12-31,,PAMC004261,,,PAMC004261,,0.679000,0,0.679000,1054.8976269513991163,716.2754887,0,716.2754887,1054.8976269513991163,"",241101 - Mineral Aurifero sin Procesar,,"",14285,,,,
Virtual Locations / Compras sin factura,Physical Locations / AQP M / Existencias,/ AQP M / Existencias,03,Mineral con Contenido Aurifero y Argentifero sin Procesar,M0002,t,LLAMPO,2018-12-30,2018-12-30,,AQP M\IN\04743,,,AQP M\IN\04743,VALENTIN CHOQQUE MAQUI,21.109000,0,21.109000,965.5052347339997158,20380.85,0,20380.85,965.5052347339997158,"",241101 - Mineral Aurifero sin Procesar,,"",14286,,,2018-12-30,
Physical Locations / AQP M / Existencias,Ubicaciones virtuales / Produccion,/ AQP M / Existencias,07,Mineral con Contenido Aurifero y Argentifero sin Procesar,M0002,t,LLAMPO,2018-12-31,2018-12-31,,MAMC-004255,,,MAMC-004255,,0,21.109000,0.000000,965.5052347339997158,0,20380.8500000000000008222000,-0.0000000000000008222000,0,"",241101 - Mineral Aurifero sin Procesar,,"",14286,,,,
Ubicaciones virtuales / Produccion,Physical Locations / AMCAQ / Existencias,/ AMCAQ / Existencias,08,Mineral con Contenido Aurifero y Argentifero sin Procesar,M0002,t,LLAMPO,2018-12-31,2018-12-31,,PAMC004261,,,PAMC004261,,21.109000,0,21.109000,1170.8701454640200862,24715.8979006,0,24715.8979006,1170.8701454640200862,"",241101 - Mineral Aurifero sin Procesar,,"",14286,,,,
Virtual Locations / Compras sin factura,Physical Locations / AQP M / Existencias,/ AQP M / Existencias,03,Mineral con Contenido Aurifero y Argentifero sin Procesar,M0002,t,LLAMPO,2018-12-30,2018-12-30,,AQP M\IN\04784,,,AQP M\IN\04784,CARDENAS CARPIO EDWIN CARLOS,7.825000,0,7.825000,357.1514376996805112,2794.71,0,2794.71,357.1514376996805112,"",241101 - Mineral Aurifero sin Procesar,,"",14287,,,2018-12-30,
Physical Locations / AQP M / Existencias,Ubicaciones virtuales / Produccion,/ AQP M / Existencias,07,Mineral con Contenido Aurifero y Argentifero sin Procesar,M0002,t,LLAMPO,2018-12-31,2018-12-31,,MAMC-004255,,,MAMC-004255,,0,7.825000,0.000000,357.1514376996805112,0,2794.7100000000000001400000,-0.0000000000000001400000,0,"",241101 - Mineral Aurifero sin Procesar,,"",14287,,,,
Ubicaciones virtuales / Produccion,Physical Locations / AMCAQ / Existencias,/ AMCAQ / Existencias,08,Mineral con Contenido Aurifero y Argentifero sin Procesar,M0002,t,LLAMPO,2018-12-31,2018-12-31,,PAMC004261,,,PAMC004261,,7.825000,0,7.825000,562.5162525814696486,4401.68967645,0,4401.68967645,562.5162525814696486,"",241101 - Mineral Aurifero sin Procesar,,"",14287,,,,
Virtual Locations / Compras sin factura,Physical Locations / AQP M / Existencias,/ AQP M / Existencias,03,Mineral con Contenido Aurifero y Argentifero sin Procesar,M0001,t,MINERAL AURIFERO Y ARGENTIFERO SIN PROCESAR,2018-12-30,2018-12-30,,AQP M\IN\04784,,,AQP M\IN\04784,CARDENAS CARPIO EDWIN CARLOS,1.573000,0,1.573000,697.3935155753337572,1097,0,1097,697.3935155753337572,"",241101 - Mineral Aurifero sin Procesar,,"",14288,,,2018-12-30,
Physical Locations / AQP M / Existencias,Ubicaciones virtuales / Produccion,/ AQP M / Existencias,07,Mineral con Contenido Aurifero y Argentifero sin Procesar,M0001,t,MINERAL AURIFERO Y ARGENTIFERO SIN PROCESAR,2018-12-31,2018-12-31,,MAMC-004255,,,MAMC-004255,,0,1.573000,0.000000,697.3935155753337572,0,1097.0000000000000000756000,-0.0000000000000000756000,0,"",241101 - Mineral Aurifero sin Procesar,,"",14288,,,,
Ubicaciones virtuales / Produccion,Physical Locations / AMCAQ / Existencias,/ AMCAQ / Existencias,08,Mineral con Contenido Aurifero y Argentifero sin Procesar,M0001,t,MINERAL AURIFERO Y ARGENTIFERO SIN PROCESAR,2018-12-31,2018-12-31,,PAMC004261,,,PAMC004261,,1.573000,0,1.573000,967.8134210616656071,1522.37051133,0,1522.37051133,967.8134210616656071,"",241101 - Mineral Aurifero sin Procesar,,"",14288,,,,
Virtual Locations / Compras sin factura,Physical Locations / AQP M / Existencias,/ AQP M / Existencias,03,Mineral con Contenido Aurifero y Argentifero sin Procesar,M0001,t,MINERAL AURIFERO Y ARGENTIFERO SIN PROCESAR,2018-12-30,2018-12-30,,AQP M\IN\04758,,,AQP M\IN\04758,BERNARDO PROVINCIA  INCA,1.091000,0,1.091000,435.3345554537121907,474.95,0,474.95,435.3345554537121907,"",241101 - Mineral Aurifero sin Procesar,,"",14289,,,2018-12-30,
Physical Locations / AQP M / Existencias,Ubicaciones virtuales / Produccion,/ AQP M / Existencias,07,Mineral con Contenido Aurifero y Argentifero sin Procesar,M0001,t,MINERAL AURIFERO Y ARGENTIFERO SIN PROCESAR,2018-12-31,2018-12-31,,MAMC-004255,,,MAMC-004255,,0,1.091000,0.000000,435.3345554537121907,0,474.9500000000000000537000,-0.0000000000000000537000,0,"",241101 - Mineral Aurifero sin Procesar,,"",14289,,,,
Ubicaciones virtuales / Produccion,Physical Locations / AMCAQ / Existencias,/ AMCAQ / Existencias,08,Mineral con Contenido Aurifero y Argentifero sin Procesar,M0001,t,MINERAL AURIFERO Y ARGENTIFERO SIN PROCESAR,2018-12-31,2018-12-31,,PAMC004261,,,PAMC004261,,1.091000,0,1.091000,705.7545078918423465,769.97816811,0,769.97816811,705.7545078918423465,"",241101 - Mineral Aurifero sin Procesar,,"",14289,,,,
Virtual Locations / Compras sin factura,Physical Locations / AQP M / Existencias,/ AQP M / Existencias,03,Mineral con Contenido Aurifero y Argentifero sin Procesar,M0001,t,MINERAL AURIFERO Y ARGENTIFERO SIN PROCESAR,2018-12-30,2018-12-30,,AQP M\IN\04758,,,AQP M\IN\04758,BERNARDO PROVINCIA  INCA,18.792000,0,18.792000,317.2232865048957003,5961.26,0,5961.26,317.2232865048957003,"",241101 - Mineral Aurifero sin Procesar,,"",14290,,,2018-12-30,
Physical Locations / AQP M / Existencias,Ubicaciones virtuales / Produccion,/ AQP M / Existencias,07,Mineral con Contenido Aurifero y Argentifero sin Procesar,M0001,t,MINERAL AURIFERO Y ARGENTIFERO SIN PROCESAR,2018-12-31,2018-12-31,,MAMC-004255,,,MAMC-004255,,0,18.792000,0.000000,317.2232865048957003,0,5961.2600000000000000376000,-0.0000000000000000376000,0,"",241101 - Mineral Aurifero sin Procesar,,"",14290,,,,
Ubicaciones virtuales / Produccion,Physical Locations / AMCAQ / Existencias,/ AMCAQ / Existencias,08,Mineral con Contenido Aurifero y Argentifero sin Procesar,M0001,t,MINERAL AURIFERO Y ARGENTIFERO SIN PROCESAR,2018-12-31,2018-12-31,,PAMC004261,,,PAMC004261,,18.792000,0,18.792000,587.6434697004044274,11042.99608261,0,11042.99608261,587.6434697004044274,"",241101 - Mineral Aurifero sin Procesar,,"",14290,,,,
Virtual Locations / Compras sin factura,Physical Locations / AQP M / Existencias,/ AQP M / Existencias,03,Mineral con Contenido Aurifero y Argentifero sin Procesar,M0001,t,MINERAL AURIFERO Y ARGENTIFERO SIN PROCESAR,2018-12-30,2018-12-30,,AQP M\IN\04758,,,AQP M\IN\04758,BERNARDO PROVINCIA  INCA,5.994000,0,5.994000,260.4554554554554555,1561.17,0,1561.17,260.4554554554554555,"",241101 - Mineral Aurifero sin Procesar,,"",14291,,,2018-12-30,
Physical Locations / AQP M / Existencias,Ubicaciones virtuales / Produccion,/ AQP M / Existencias,07,Mineral con Contenido Aurifero y Argentifero sin Procesar,M0001,t,MINERAL AURIFERO Y ARGENTIFERO SIN PROCESAR,2018-12-31,2018-12-31,,MAMC-004255,,,MAMC-004255,,0,5.994000,0.000000,260.4554554554554555,0,1561.1700000000000002670000,-0.0000000000000002670000,0,"",241101 - Mineral Aurifero sin Procesar,,"",14291,,,,
Ubicaciones virtuales / Produccion,Physical Locations / AMCAQ / Existencias,/ AMCAQ / Existencias,08,Mineral con Contenido Aurifero y Argentifero sin Procesar,M0001,t,MINERAL AURIFERO Y ARGENTIFERO SIN PROCESAR,2018-12-31,2018-12-31,,PAMC004261,,,PAMC004261,,5.994000,0,5.994000,530.8755768668668669,3182.06820774,0,3182.06820774,530.8755768668668669,"",241101 - Mineral Aurifero sin Procesar,,"",14291,,,,
Virtual Locations / Compras sin factura,Physical Locations / AQP M / Existencias,/ AQP M / Existencias,03,Mineral con Contenido Aurifero y Argentifero sin Procesar,M0002,t,LLAMPO,2018-12-30,2018-12-30,,AQP M\IN\04763,,,AQP M\IN\04763,LUIS GONZAGA VALDIVIA RANILLA,1.473000,0,1.473000,0.00000000000000000000,0,0,0,0.00000000000000000000,"",241101 - Mineral Aurifero sin Procesar,,"",14292,,,2018-12-30,
Physical Locations / AQP M / Existencias,Ubicaciones virtuales / Produccion,/ AQP M / Existencias,07,Mineral con Contenido Aurifero y Argentifero sin Procesar,M0002,t,LLAMPO,2018-12-31,2018-12-31,,MAMC-004255,,,MAMC-004255,,0,1.473000,0.000000,0.00000000000000000000,0,0.00000000000000000000000000,0.00000000000000000000000000,0,"",241101 - Mineral Aurifero sin Procesar,,"",14292,,,,
Ubicaciones virtuales / Produccion,Physical Locations / AMCAQ / Existencias,/ AMCAQ / Existencias,08,Mineral con Contenido Aurifero y Argentifero sin Procesar,M0002,t,LLAMPO,2018-12-31,2018-12-31,,PAMC004261,,,PAMC004261,,1.473000,0,1.473000,205.3650647861507128,302.50274043,0,302.50274043,205.3650647861507128,"",241101 - Mineral Aurifero sin Procesar,,"",14292,,,,
Virtual Locations / Compras sin factura,Physical Locations / AQP M / Existencias,/ AQP M / Existencias,03,Mineral con Contenido Aurifero y Argentifero sin Procesar,M0002,t,LLAMPO,2018-12-30,2018-12-30,,AQP M\IN\04763,,,AQP M\IN\04763,LUIS GONZAGA VALDIVIA RANILLA,3.451000,0,3.451000,0.00000000000000000000,0,0,0,0.00000000000000000000,"",241101 - Mineral Aurifero sin Procesar,,"",14293,,,2018-12-30,
Physical Locations / AQP M / Existencias,Ubicaciones virtuales / Produccion,/ AQP M / Existencias,07,Mineral con Contenido Aurifero y Argentifero sin Procesar,M0002,t,LLAMPO,2018-12-31,2018-12-31,,MAMC-004256,,,MAMC-004256,,0,3.451000,0.000000,0.00000000000000000000,0,0.00000000000000000000000000,0.00000000000000000000000000,0,"",241101 - Mineral Aurifero sin Procesar,,"",14293,,,,
Ubicaciones virtuales / Produccion,Physical Locations / AMCAQ / Existencias,/ AMCAQ / Existencias,08,Mineral con Contenido Aurifero y Argentifero sin Procesar,M0002,t,LLAMPO,2018-12-31,2018-12-31,,PAMC004262,,,PAMC004262,,3.451000,0,3.451000,205.3644069226311214,708.71256829,0,708.71256829,205.3644069226311214,"",241101 - Mineral Aurifero sin Procesar,,"",14293,,,,
Virtual Locations / Compras sin factura,Physical Locations / AQP M / Existencias,/ AQP M / Existencias,03,Mineral con Contenido Aurifero y Argentifero sin Procesar,M0001,t,MINERAL AURIFERO Y ARGENTIFERO SIN PROCESAR,2018-12-30,2018-12-30,,AQP M\IN\04761,,,AQP M\IN\04761,ROGELIO HENRY ALFARO FLORES,0.757000,0,0.757000,515.0858652575957728,389.92,0,389.92,515.0858652575957728,"",241101 - Mineral Aurifero sin Procesar,,"",14294,,,2018-12-30,
Physical Locations / AQP M / Existencias,Ubicaciones virtuales / Produccion,/ AQP M / Existencias,07,Mineral con Contenido Aurifero y Argentifero sin Procesar,M0001,t,MINERAL AURIFERO Y ARGENTIFERO SIN PROCESAR,2018-12-31,2018-12-31,,MAMC-004256,,,MAMC-004256,,0,0.757000,0.000000,515.0858652575957728,0,389.9200000000000000096000,-0.0000000000000000096000,0,"",241101 - Mineral Aurifero sin Procesar,,"",14294,,,,
Ubicaciones virtuales / Produccion,Physical Locations / AMCAQ / Existencias,/ AMCAQ / Existencias,08,Mineral con Contenido Aurifero y Argentifero sin Procesar,M0001,t,MINERAL AURIFERO Y ARGENTIFERO SIN PROCESAR,2018-12-31,2018-12-31,,PAMC004262,,,PAMC004262,,0.757000,0,0.757000,785.5074523910171731,594.62914146,0,594.62914146,785.5074523910171731,"",241101 - Mineral Aurifero sin Procesar,,"",14294,,,,
Virtual Locations / Compras sin factura,Physical Locations / AQP M / Existencias,/ AQP M / Existencias,03,Mineral con Contenido Aurifero y Argentifero sin Procesar,M0001,t,MINERAL AURIFERO Y ARGENTIFERO SIN PROCESAR,2018-12-30,2018-12-30,,AQP M\IN\04761,,,AQP M\IN\04761,ROGELIO HENRY ALFARO FLORES,0.508000,0,0.508000,3850.0787401574803150,1955.84,0,1955.84,3850.0787401574803150,"",241101 - Mineral Aurifero sin Procesar,,"",14295,,,2018-12-30,
Physical Locations / AQP M / Existencias,Ubicaciones virtuales / Produccion,/ AQP M / Existencias,07,Mineral con Contenido Aurifero y Argentifero sin Procesar,M0001,t,MINERAL AURIFERO Y ARGENTIFERO SIN PROCESAR,2018-12-31,2018-12-31,,MAMC-004256,,,MAMC-004256,,0,0.508000,0.000000,3850.0787401574803150,0,1955.8400000000000000200000,-0.0000000000000000200000,0,"",241101 - Mineral Aurifero sin Procesar,,"",14295,,,,
Ubicaciones virtuales / Produccion,Physical Locations / AMCAQ / Existencias,/ AMCAQ / Existencias,08,Mineral con Contenido Aurifero y Argentifero sin Procesar,M0001,t,MINERAL AURIFERO Y ARGENTIFERO SIN PROCESAR,2018-12-31,2018-12-31,,PAMC004262,,,PAMC004262,,0.508000,0,0.508000,4120.4998556692913386,2093.21392668,0,2093.21392668,4120.4998556692913386,"",241101 - Mineral Aurifero sin Procesar,,"",14295,,,,
Virtual Locations / Compras sin factura,Physical Locations / AQP M / Existencias,/ AQP M / Existencias,03,Mineral con Contenido Aurifero y Argentifero sin Procesar,M0001,t,MINERAL AURIFERO Y ARGENTIFERO SIN PROCESAR,2018-12-31,2018-12-31,,AQP M\IN\04764,,,AQP M\IN\04764,GILBERTO SALCEDO COLQUE,3.680000,0,3.680000,1471.6277173913043478,5415.59,0,5415.59,1471.6277173913043478,"",241101 - Mineral Aurifero sin Procesar,,"",14296,,,2018-12-31,
Physical Locations / AQP M / Existencias,Ubicaciones virtuales / Produccion,/ AQP M / Existencias,07,Mineral con Contenido Aurifero y Argentifero sin Procesar,M0001,t,MINERAL AURIFERO Y ARGENTIFERO SIN PROCESAR,2018-12-31,2018-12-31,,MAMC-004256,,,MAMC-004256,,0,3.680000,0.000000,1471.6277173913043478,0,5415.5899999999999999040000,0.0000000000000000960000,0,"",241101 - Mineral Aurifero sin Procesar,,"",14296,,,,
Ubicaciones virtuales / Produccion,Physical Locations / AMCAQ / Existencias,/ AMCAQ / Existencias,08,Mineral con Contenido Aurifero y Argentifero sin Procesar,M0001,t,MINERAL AURIFERO Y ARGENTIFERO SIN PROCESAR,2018-12-31,2018-12-31,,PAMC004262,,,PAMC004262,,3.680000,0,3.680000,1742.0482986168478261,6410.73773891,0,6410.73773891,1742.0482986168478261,"",241101 - Mineral Aurifero sin Procesar,,"",14296,,,,
Virtual Locations / Compras sin factura,Physical Locations / AQP M / Existencias,/ AQP M / Existencias,03,Mineral con Contenido Aurifero y Argentifero sin Procesar,M0001,t,MINERAL AURIFERO Y ARGENTIFERO SIN PROCESAR,2018-12-31,2018-12-31,,AQP M\IN\04764,,,AQP M\IN\04764,GILBERTO SALCEDO COLQUE,1.532000,0,1.532000,5444.9020887728459530,8341.59,0,8341.59,5444.9020887728459530,"",241101 - Mineral Aurifero sin Procesar,,"",14297,,,2018-12-31,
Physical Locations / AQP M / Existencias,Ubicaciones virtuales / Produccion,/ AQP M / Existencias,07,Mineral con Contenido Aurifero y Argentifero sin Procesar,M0001,t,MINERAL AURIFERO Y ARGENTIFERO SIN PROCESAR,2018-12-31,2018-12-31,,MAMC-004256,,,MAMC-004256,,0,1.532000,0.000000,5444.9020887728459530,0,8341.5899999999999999960000,0.0000000000000000040000,0,"",241101 - Mineral Aurifero sin Procesar,,"",14297,,,,
Ubicaciones virtuales / Produccion,Physical Locations / AMCAQ / Existencias,/ AMCAQ / Existencias,08,Mineral con Contenido Aurifero y Argentifero sin Procesar,M0001,t,MINERAL AURIFERO Y ARGENTIFERO SIN PROCESAR,2018-12-31,2018-12-31,,PAMC004262,,,PAMC004262,,1.532000,0,1.532000,5715.3214130613577023,8755.87240481,0,8755.87240481,5715.3214130613577023,"",241101 - Mineral Aurifero sin Procesar,,"",14297,,,,
Virtual Locations / Compras sin factura,Physical Locations / AQP M / Existencias,/ AQP M / Existencias,03,Mineral con Contenido Aurifero y Argentifero sin Procesar,M0001,t,MINERAL AURIFERO Y ARGENTIFERO SIN PROCESAR,2018-12-31,2018-12-31,,AQP M\IN\04766,,,AQP M\IN\04766,EDISON SALCEDO PACHECO,2.250000,0,2.250000,2401.4444444444444444,5403.25,0,5403.25,2401.4444444444444444,"",241101 - Mineral Aurifero sin Procesar,,"",14298,,,2018-12-31,
Physical Locations / AQP M / Existencias,Ubicaciones virtuales / Produccion,/ AQP M / Existencias,07,Mineral con Contenido Aurifero y Argentifero sin Procesar,M0001,t,MINERAL AURIFERO Y ARGENTIFERO SIN PROCESAR,2018-12-31,2018-12-31,,MAMC-004256,,,MAMC-004256,,0,2.250000,0.000000,2401.4444444444444444,0,5403.2499999999999999000000,0.0000000000000001000000,0,"",241101 - Mineral Aurifero sin Procesar,,"",14298,,,,
Ubicaciones virtuales / Produccion,Physical Locations / AMCAQ / Existencias,/ AMCAQ / Existencias,08,Mineral con Contenido Aurifero y Argentifero sin Procesar,M0001,t,MINERAL AURIFERO Y ARGENTIFERO SIN PROCESAR,2018-12-31,2018-12-31,,PAMC004262,,,PAMC004262,,2.250000,0,2.250000,2671.8640519244444444,6011.69411683,0,6011.69411683,2671.8640519244444444,"",241101 - Mineral Aurifero sin Procesar,,"",14298,,,,
Virtual Locations / Compras sin factura,Physical Locations / AQP M / Existencias,/ AQP M / Existencias,03,Mineral con Contenido Aurifero y Argentifero sin Procesar,M0001,t,MINERAL AURIFERO Y ARGENTIFERO SIN PROCESAR,2018-12-31,2018-12-31,,AQP M\IN\04766,,,AQP M\IN\04766,EDISON SALCEDO PACHECO,2.202000,0,2.202000,1476.2488646684831971,3250.7,0,3250.7,1476.2488646684831971,"",241101 - Mineral Aurifero sin Procesar,,"",14299,,,2018-12-31,
Physical Locations / AQP M / Existencias,Ubicaciones virtuales / Produccion,/ AQP M / Existencias,07,Mineral con Contenido Aurifero y Argentifero sin Procesar,M0001,t,MINERAL AURIFERO Y ARGENTIFERO SIN PROCESAR,2018-12-31,2018-12-31,,MAMC-004256,,,MAMC-004256,,0,2.202000,0.000000,1476.2488646684831971,0,3250.7000000000000000142000,-0.0000000000000000142000,0,"",241101 - Mineral Aurifero sin Procesar,,"",14299,,,,
Ubicaciones virtuales / Produccion,Physical Locations / AMCAQ / Existencias,/ AMCAQ / Existencias,08,Mineral con Contenido Aurifero y Argentifero sin Procesar,M0001,t,MINERAL AURIFERO Y ARGENTIFERO SIN PROCESAR,2018-12-31,2018-12-31,,PAMC004262,,,PAMC004262,,2.202000,0,2.202000,1746.6693069754768392,3846.16581396,0,3846.16581396,1746.6693069754768392,"",241101 - Mineral Aurifero sin Procesar,,"",14299,,,,
Virtual Locations / Compras sin factura,Physical Locations / AQP M / Existencias,/ AQP M / Existencias,03,Mineral con Contenido Aurifero y Argentifero sin Procesar,M0001,t,MINERAL AURIFERO Y ARGENTIFERO SIN PROCESAR,2018-12-31,2018-12-31,,AQP M\IN\04766,,,AQP M\IN\04766,EDISON SALCEDO PACHECO,2.586000,0,2.586000,1067.1152358855375097,2759.56,0,2759.56,1067.1152358855375097,"",241101 - Mineral Aurifero sin Procesar,,"",14300,,,2018-12-31,
Physical Locations / AQP M / Existencias,Ubicaciones virtuales / Produccion,/ AQP M / Existencias,07,Mineral con Contenido Aurifero y Argentifero sin Procesar,M0001,t,MINERAL AURIFERO Y ARGENTIFERO SIN PROCESAR,2018-12-31,2018-12-31,,MAMC-004256,,,MAMC-004256,,0,2.586000,0.000000,1067.1152358855375097,0,2759.5600000000000000842000,-0.0000000000000000842000,0,"",241101 - Mineral Aurifero sin Procesar,,"",14300,,,,
Ubicaciones virtuales / Produccion,Physical Locations / AMCAQ / Existencias,/ AMCAQ / Existencias,08,Mineral con Contenido Aurifero y Argentifero sin Procesar,M0001,t,MINERAL AURIFERO Y ARGENTIFERO SIN PROCESAR,2018-12-31,2018-12-31,,PAMC004262,,,PAMC004262,,2.586000,0,2.586000,1337.5361559706109822,3458.86849934,0,3458.86849934,1337.5361559706109822,"",241101 - Mineral Aurifero sin Procesar,,"",14300,,,,
Virtual Locations / Compras sin factura,Physical Locations / AQP M / Existencias,/ AQP M / Existencias,03,Mineral con Contenido Aurifero y Argentifero sin Procesar,M0001,t,MINERAL AURIFERO Y ARGENTIFERO SIN PROCESAR,2018-12-31,2018-12-31,,AQP M\IN\04766,,,AQP M\IN\04766,EDISON SALCEDO PACHECO,2.400000,0,2.400000,825.9875000000000000,1982.37,0,1982.37,825.9875000000000000,"",241101 - Mineral Aurifero sin Procesar,,"",14301,,,2018-12-31,
Physical Locations / AQP M / Existencias,Ubicaciones virtuales / Produccion,/ AQP M / Existencias,07,Mineral con Contenido Aurifero y Argentifero sin Procesar,M0001,t,MINERAL AURIFERO Y ARGENTIFERO SIN PROCESAR,2018-12-31,2018-12-31,,MAMC-004256,,,MAMC-004256,,0,2.400000,0.000000,825.9875000000000000,0,1982.3700000000000000000000,0.0000000000000000000000,0,"",241101 - Mineral Aurifero sin Procesar,,"",14301,,,,
Ubicaciones virtuales / Produccion,Physical Locations / AMCAQ / Existencias,/ AMCAQ / Existencias,08,Mineral con Contenido Aurifero y Argentifero sin Procesar,M0001,t,MINERAL AURIFERO Y ARGENTIFERO SIN PROCESAR,2018-12-31,2018-12-31,,PAMC004262,,,PAMC004262,,2.400000,0,2.400000,1096.4075460416666667,2631.3781105,0,2631.3781105,1096.4075460416666667,"",241101 - Mineral Aurifero sin Procesar,,"",14301,,,,
Virtual Locations / Compras sin factura,Physical Locations / AQP M / Existencias,/ AQP M / Existencias,03,Mineral con Contenido Aurifero y Argentifero sin Procesar,M0001,t,MINERAL AURIFERO Y ARGENTIFERO SIN PROCESAR,2018-12-31,2018-12-31,,AQP M\IN\04767,,,AQP M\IN\04767,MINERA ARTESANAL ALENAY S.A.C.,1.369000,0,1.369000,3163.7399561723886048,4331.16,0,4331.16,3163.7399561723886048,"",241101 - Mineral Aurifero sin Procesar,,"",14302,,,2018-12-31,
Physical Locations / AQP M / Existencias,Ubicaciones virtuales / Produccion,/ AQP M / Existencias,07,Mineral con Contenido Aurifero y Argentifero sin Procesar,M0001,t,MINERAL AURIFERO Y ARGENTIFERO SIN PROCESAR,2018-12-31,2018-12-31,,MAMC-004256,,,MAMC-004256,,0,1.369000,0.000000,3163.7399561723886048,0,4331.1599999999999999712000,0.0000000000000000288000,0,"",241101 - Mineral Aurifero sin Procesar,,"",14302,,,,
Ubicaciones virtuales / Produccion,Physical Locations / AMCAQ / Existencias,/ AMCAQ / Existencias,08,Mineral con Contenido Aurifero y Argentifero sin Procesar,M0001,t,MINERAL AURIFERO Y ARGENTIFERO SIN PROCESAR,2018-12-31,2018-12-31,,PAMC004262,,,PAMC004262,,1.369000,0,1.369000,3434.1615827027027027,4701.36720672,0,4701.36720672,3434.1615827027027027,"",241101 - Mineral Aurifero sin Procesar,,"",14302,,,,
Partner Locations / Suppliers,Ubicaciones físicas / TR M / Existencias, / TR M / Existencias,03,Mineral con Contenido Aurifero y Argentifero sin Procesar,M0001,t,MINERAL AURIFERO Y ARGENTIFERO SIN PROCESAR,2018-12-03,2018-12-03,12/2018,TR M/IN/00208,01,0003,0000045,MASIAS ROGELIO HUERTA  ALVARADO,17.808000,0,17.808000,2473.9661949685534591,44056.39,0,44056.39,2473.9661949685534591,602101 - Mineral Aurifero sin Procesar,241101 - Mineral Aurifero sin Procesar,,"",AS-372,18PO06533,,2018-12-03,
Ubicaciones físicas / TR M / Existencias,Ubicaciones virtuales / Produccion, / TR M / Existencias,07,Mineral con Contenido Aurifero y Argentifero sin Procesar,M0001,t,MINERAL AURIFERO Y ARGENTIFERO SIN PROCESAR,2018-12-31,2018-12-31,,CMT-000240,,,CMT-000240,,0,17.808000,0.000000,2473.9661949685534591,0,44056.3899999999999996528000,0.0000000000000003472000,0,"",241101 - Mineral Aurifero sin Procesar,,"",AS-372,,,,
Ubicaciones virtuales / Produccion,Physical Locations / AMCTJ / Existencias,/ AMCTJ / Existencias,08,Mineral con Contenido Aurifero y Argentifero sin Procesar,M0001,t,MINERAL AURIFERO Y ARGENTIFERO SIN PROCESAR,2018-12-31,2018-12-31,,AMCTJ000247,,,AMCTJ000247,,17.808000,0,17.808000,2611.0441284624887691,46497.47383966,0,46497.47383966,2611.0441284624887691,"",241101 - Mineral Aurifero sin Procesar,,"",AS-372,,,,
Partner Locations / Suppliers,Ubicaciones físicas / TR M / Existencias, / TR M / Existencias,03,Mineral con Contenido Aurifero y Argentifero sin Procesar,M0001,t,MINERAL AURIFERO Y ARGENTIFERO SIN PROCESAR,2018-12-03,2018-12-03,12/2018,TR M/IN/00208,01,0003,0000045,MASIAS ROGELIO HUERTA  ALVARADO,37.072000,0,37.072000,2454.9263595166163142,91009.03,0,91009.03,2454.9263595166163142,602101 - Mineral Aurifero sin Procesar,241101 - Mineral Aurifero sin Procesar,,"",AS-373,18PO06533,,2018-12-03,
Ubicaciones físicas / TR M / Existencias,Ubicaciones virtuales / Produccion, / TR M / Existencias,07,Mineral con Contenido Aurifero y Argentifero sin Procesar,M0001,t,MINERAL AURIFERO Y ARGENTIFERO SIN PROCESAR,2018-12-31,2018-12-31,,CMT-000240,,,CMT-000240,,0,37.072000,0.000000,2454.9263595166163142,0,91009.0300000000000000224000,-0.0000000000000000224000,0,"",241101 - Mineral Aurifero sin Procesar,,"",AS-373,,,,
Ubicaciones virtuales / Produccion,Physical Locations / AMCTJ / Existencias,/ AMCTJ / Existencias,08,Mineral con Contenido Aurifero y Argentifero sin Procesar,M0001,t,MINERAL AURIFERO Y ARGENTIFERO SIN PROCESAR,2018-12-31,2018-12-31,,AMCTJ000247,,,AMCTJ000247,,37.072000,0,37.072000,2592.0042699242015537,96090.78229463,0,96090.78229463,2592.0042699242015537,"",241101 - Mineral Aurifero sin Procesar,,"",AS-373,,,,
Virtual Locations / Compras sin factura,Ubicaciones físicas / TR M / Existencias, / TR M / Existencias,03,Mineral con Contenido Aurifero y Argentifero sin Procesar,M0001,t,MINERAL AURIFERO Y ARGENTIFERO SIN PROCESAR,2018-12-07,2018-12-07,,TR M/IN/00244,,,TR M/IN/00244,NEGOCIOS ARGOS E.I.R.L.,32.302000,0,32.302000,4561.0894062287164881,147332.31,0,147332.31,4561.0894062287164881,"",241101 - Mineral Aurifero sin Procesar,,"",AS-374,,,2018-12-07,
Ubicaciones físicas / TR M / Existencias,Ubicaciones virtuales / Produccion, / TR M / Existencias,07,Mineral con Contenido Aurifero y Argentifero sin Procesar,M0001,t,MINERAL AURIFERO Y ARGENTIFERO SIN PROCESAR,2018-12-31,2018-12-31,,CMT-000240,,,CMT-000240,,0,32.302000,0.000000,4561.0894062287164881,0,147332.3099999999999986062000,0.0000000000000013938000,0,"",241101 - Mineral Aurifero sin Procesar,,"",AS-374,,,,
Ubicaciones virtuales / Produccion,Physical Locations / AMCTJ / Existencias,/ AMCTJ / Existencias,08,Mineral con Contenido Aurifero y Argentifero sin Procesar,M0001,t,MINERAL AURIFERO Y ARGENTIFERO SIN PROCESAR,2018-12-31,2018-12-31,,AMCTJ000247,,,AMCTJ000247,,32.302000,0,32.302000,4698.1673228236641694,151760.20086185,0,151760.20086185,4698.1673228236641694,"",241101 - Mineral Aurifero sin Procesar,,"",AS-374,,,,
Virtual Locations / Compras sin factura,Ubicaciones físicas / TR M / Existencias, / TR M / Existencias,03,Mineral con Contenido Aurifero y Argentifero sin Procesar,M0001,t,MINERAL AURIFERO Y ARGENTIFERO SIN PROCESAR,2018-12-07,2018-12-07,,TR M/IN/00250,,,TR M/IN/00250,NEGOCIOS ARGOS E.I.R.L.,20.490000,0,20.490000,5489.8199121522693997,112486.41,0,112486.41,5489.8199121522693997,"",241101 - Mineral Aurifero sin Procesar,,"",AS-375,,,2018-12-07,
,, / TR M / Existencias,"",Mineral con Contenido Aurifero y Argentifero sin Procesar,"","",MINERAL AURIFERO Y ARGENTIFERO SIN PROCESAR,,2018-12-17,12/2018,,01,E001,0000009,NEGOCIOS ARGOS E.I.R.L.,0,0,20.490000,5522.7657393850658858,675.06,0,113161.47,5522.7657393850658858,609201,241101 - Mineral Aurifero sin Procesar,"",,AS-375,,,,t
Ubicaciones físicas / TR M / Existencias,Ubicaciones virtuales / Produccion, / TR M / Existencias,07,Mineral con Contenido Aurifero y Argentifero sin Procesar,M0001,t,MINERAL AURIFERO Y ARGENTIFERO SIN PROCESAR,2018-12-31,2018-12-31,,CMT-000240,,,CMT-000240,,0,20.490000,0.000000,5522.7657393850658858,0,113161.4700000000000000420000,-0.0000000000000000420000,0,"",241101 - Mineral Aurifero sin Procesar,,"",AS-375,,,,
Ubicaciones virtuales / Produccion,Physical Locations / AMCTJ / Existencias,/ AMCTJ / Existencias,08,Mineral con Contenido Aurifero y Argentifero sin Procesar,M0001,t,MINERAL AURIFERO Y ARGENTIFERO SIN PROCESAR,2018-12-31,2018-12-31,,AMCTJ000247,,,AMCTJ000247,,20.490000,0,20.490000,5659.8436697867252318,115970.19679393,0,115970.19679393,5659.8436697867252318,"",241101 - Mineral Aurifero sin Procesar,,"",AS-375,,,,
Partner Locations / Suppliers,Ubicaciones físicas / TR M / Existencias, / TR M / Existencias,03,Mineral con Contenido Aurifero y Argentifero sin Procesar,M0001,t,MINERAL AURIFERO Y ARGENTIFERO SIN PROCESAR,2018-12-07,2018-12-07,12/2018,TR M/IN/00213,01,E001,0000018,RAUL CELIN CASTILLO JARA,20.860000,0,20.860000,4947.0148609779482263,103194.73,0,103194.73,4947.0148609779482263,602101 - Mineral Aurifero sin Procesar,241101 - Mineral Aurifero sin Procesar,,"",AS-376,18PO06622,,2018-12-07,
,, / TR M / Existencias,"",Mineral con Contenido Aurifero y Argentifero sin Procesar,"","",MINERAL AURIFERO Y ARGENTIFERO SIN PROCESAR,,2018-12-15,12/2018,,01,E001,0000019,RAUL CELIN CASTILLO JARA,0,0,20.860000,4981.0009587727708533,708.95,0,103903.68,4981.0009587727708533,609201,241101 - Mineral Aurifero sin Procesar,"",,AS-376,,,,t
Ubicaciones físicas / TR M / Existencias,Ubicaciones virtuales / Produccion, / TR M / Existencias,07,Mineral con Contenido Aurifero y Argentifero sin Procesar,M0001,t,MINERAL AURIFERO Y ARGENTIFERO SIN PROCESAR,2018-12-31,2018-12-31,,CMT-000240,,,CMT-000240,,0,20.860000,0.000000,4981.0009587727708533,0,103903.6799999999999998380000,0.0000000000000001620000,0,"",241101 - Mineral Aurifero sin Procesar,,"",AS-376,,,,
Ubicaciones virtuales / Produccion,Physical Locations / AMCTJ / Existencias,/ AMCTJ / Existencias,08,Mineral con Contenido Aurifero y Argentifero sin Procesar,M0001,t,MINERAL AURIFERO Y ARGENTIFERO SIN PROCESAR,2018-12-31,2018-12-31,,AMCTJ000247,,,AMCTJ000247,,20.860000,0,20.860000,5118.0788926179290508,106763.12570001,0,106763.12570001,5118.0788926179290508,"",241101 - Mineral Aurifero sin Procesar,,"",AS-376,,,,
Virtual Locations / Compras sin factura,Ubicaciones físicas / TR M / Existencias, / TR M / Existencias,03,Mineral con Contenido Aurifero y Argentifero sin Procesar,M0001,t,MINERAL AURIFERO Y ARGENTIFERO SIN PROCESAR,2018-12-07,2018-12-07,,TR M/IN/00244,,,TR M/IN/00244,NEGOCIOS ARGOS E.I.R.L.,32.897000,0,32.897000,2477.4325926376265313,81500.1,0,81500.1,2477.4325926376265313,"",241101 - Mineral Aurifero sin Procesar,,"",AS-377,,,2018-12-07,
Ubicaciones físicas / TR M / Existencias,Ubicaciones virtuales / Produccion, / TR M / Existencias,07,Mineral con Contenido Aurifero y Argentifero sin Procesar,M0001,t,MINERAL AURIFERO Y ARGENTIFERO SIN PROCESAR,2018-12-31,2018-12-31,,CMT-000240,,,CMT-000240,,0,32.897000,0.000000,2477.4325926376265313,0,81500.1000000000000001761000,-0.0000000000000001761000,0,"",241101 - Mineral Aurifero sin Procesar,,"",AS-377,,,,
Ubicaciones virtuales / Produccion,Physical Locations / AMCTJ / Existencias,/ AMCTJ / Existencias,08,Mineral con Contenido Aurifero y Argentifero sin Procesar,M0001,t,MINERAL AURIFERO Y ARGENTIFERO SIN PROCESAR,2018-12-31,2018-12-31,,AMCTJ000247,,,AMCTJ000247,,32.897000,0,32.897000,2614.5104867410402164,86009.55148232,0,86009.55148232,2614.5104867410402164,"",241101 - Mineral Aurifero sin Procesar,,"",AS-377,,,,
Partner Locations / Suppliers,Ubicaciones físicas / TR M / Existencias, / TR M / Existencias,03,Mineral con Contenido Aurifero y Argentifero sin Procesar,M0001,t,MINERAL AURIFERO Y ARGENTIFERO SIN PROCESAR,2018-12-20,2018-12-20,12/2018,TR M/IN/00229,01,E001,0000010,NEGOCIOS ARGOS E.I.R.L.,22.035000,0,22.035000,4009.0093033809847969,88338.52,0,88338.52,4009.0093033809847969,602101 - Mineral Aurifero sin Procesar,241101 - Mineral Aurifero sin Procesar,,"",AS-378,18PO06871,,2018-12-20,
Ubicaciones físicas / TR M / Existencias,Ubicaciones virtuales / Produccion, / TR M / Existencias,07,Mineral con Contenido Aurifero y Argentifero sin Procesar,M0001,t,MINERAL AURIFERO Y ARGENTIFERO SIN PROCESAR,2018-12-31,2018-12-31,,CMT-000240,,,CMT-000240,,0,22.035000,0.000000,4009.0093033809847969,0,88338.5199999999999996915000,0.0000000000000003085000,0,"",241101 - Mineral Aurifero sin Procesar,,"",AS-378,,,,
Ubicaciones virtuales / Produccion,Physical Locations / AMCTJ / Existencias,/ AMCTJ / Existencias,08,Mineral con Contenido Aurifero y Argentifero sin Procesar,M0001,t,MINERAL AURIFERO Y ARGENTIFERO SIN PROCESAR,2018-12-31,2018-12-31,,AMCTJ000247,,,AMCTJ000247,,22.035000,0,22.035000,4146.0871907842069435,91359.03124893,0,91359.03124893,4146.0871907842069435,"",241101 - Mineral Aurifero sin Procesar,,"",AS-378,,,,
Partner Locations / Suppliers,Ubicaciones físicas / TR M / Existencias, / TR M / Existencias,03,Mineral con Contenido Aurifero y Argentifero sin Procesar,M0001,t,MINERAL AURIFERO Y ARGENTIFERO SIN PROCESAR,2018-12-15,2018-12-15,12/2018,TR M/IN/00223,01,0003,0000101,MASIAS ROGELIO HUERTA  ALVARADO,29.895000,0,29.895000,243.1821374811841445,7269.93,0,7269.93,243.1821374811841445,602101 - Mineral Aurifero sin Procesar,241101 - Mineral Aurifero sin Procesar,,"",AS-379,18PO06702,,2018-12-15,
Ubicaciones físicas / TR M / Existencias,Ubicaciones virtuales / Produccion, / TR M / Existencias,07,Mineral con Contenido Aurifero y Argentifero sin Procesar,M0001,t,MINERAL AURIFERO Y ARGENTIFERO SIN PROCESAR,2018-12-31,2018-12-31,,CMT-000240,,,CMT-000240,,0,29.895000,0.000000,243.1821374811841445,0,7269.9299999999999998275000,0.0000000000000001725000,0,"",241101 - Mineral Aurifero sin Procesar,,"",AS-379,,,,
Ubicaciones virtuales / Produccion,Physical Locations / AMCTJ / Existencias,/ AMCTJ / Existencias,08,Mineral con Contenido Aurifero y Argentifero sin Procesar,M0001,t,MINERAL AURIFERO Y ARGENTIFERO SIN PROCESAR,2018-12-31,2018-12-31,,AMCTJ000247,,,AMCTJ000247,,29.895000,0,29.895000,380.2600411269443051,11367.87392949,0,11367.87392949,380.2600411269443051,"",241101 - Mineral Aurifero sin Procesar,,"",AS-379,,,,
Partner Locations / Suppliers,Ubicaciones físicas / TR M / Existencias, / TR M / Existencias,03,Mineral con Contenido Aurifero y Argentifero sin Procesar,M0001,t,MINERAL AURIFERO Y ARGENTIFERO SIN PROCESAR,2018-12-15,2018-12-15,12/2018,TR M/IN/00223,01,0003,0000101,MASIAS ROGELIO HUERTA  ALVARADO,20.535000,0,20.535000,1905.9819819819819820,39139.34,0,39139.34,1905.9819819819819820,602101 - Mineral Aurifero sin Procesar,241101 - Mineral Aurifero sin Procesar,,"",AS-380,18PO06702,,2018-12-15,
Ubicaciones físicas / TR M / Existencias,Ubicaciones virtuales / Produccion, / TR M / Existencias,07,Mineral con Contenido Aurifero y Argentifero sin Procesar,M0001,t,MINERAL AURIFERO Y ARGENTIFERO SIN PROCESAR,2018-12-31,2018-12-31,,CMT-000240,,,CMT-000240,,0,20.535000,0.000000,1905.9819819819819820,0,39139.3400000000000003700000,-0.0000000000000003700000,0,"",241101 - Mineral Aurifero sin Procesar,,"",AS-380,,,,
Ubicaciones virtuales / Produccion,Physical Locations / AMCTJ / Existencias,/ AMCTJ / Existencias,08,Mineral con Contenido Aurifero y Argentifero sin Procesar,M0001,t,MINERAL AURIFERO Y ARGENTIFERO SIN PROCESAR,2018-12-31,2018-12-31,,AMCTJ000247,,,AMCTJ000247,,20.535000,0,20.535000,2043.0598588590211833,41954.23420167,0,41954.23420167,2043.0598588590211833,"",241101 - Mineral Aurifero sin Procesar,,"",AS-380,,,,
Partner Locations / Suppliers,Ubicaciones físicas / TR M / Existencias, / TR M / Existencias,03,Mineral con Contenido Aurifero y Argentifero sin Procesar,M0001,t,MINERAL AURIFERO Y ARGENTIFERO SIN PROCESAR,2018-12-15,2018-12-15,12/2018,TR M/IN/00223,01,0003,0000101,MASIAS ROGELIO HUERTA  ALVARADO,35.055000,0,35.055000,2063.4454428754813864,72334.08,0,72334.08,2063.4454428754813864,602101 - Mineral Aurifero sin Procesar,241101 - Mineral Aurifero sin Procesar,,"",AS-381,18PO06702,,2018-12-15,
Ubicaciones físicas / TR M / Existencias,Ubicaciones virtuales / Produccion, / TR M / Existencias,07,Mineral con Contenido Aurifero y Argentifero sin Procesar,M0001,t,MINERAL AURIFERO Y ARGENTIFERO SIN PROCESAR,2018-12-31,2018-12-31,,CMT-000240,,,CMT-000240,,0,35.050000,0.005000,2063.4454428754813864,0,72323.7627727856225933200000,10.3172272143774066800000,2063.4454428754813864,"",241101 - Mineral Aurifero sin Procesar,,"",AS-381,,,,
Ubicaciones virtuales / Produccion,Physical Locations / AMCTJ / Existencias,/ AMCTJ / Existencias,08,Mineral con Contenido Aurifero y Argentifero sin Procesar,M0001,t,MINERAL AURIFERO Y ARGENTIFERO SIN PROCESAR,2018-12-31,2018-12-31,,AMCTJ000247,,,AMCTJ000247,,35.050000,0,35.050000,2200.8177243894436519,77138.66123985,0,77138.66123985,2200.8177243894436519,"",241101 - Mineral Aurifero sin Procesar,,"",AS-381,,,,
Partner Locations / Suppliers,Ubicaciones físicas / TR M / Existencias, / TR M / Existencias,03,Mineral con Contenido Aurifero y Argentifero sin Procesar,M0001,t,MINERAL AURIFERO Y ARGENTIFERO SIN PROCESAR,2018-12-20,2018-12-20,12/2018,TR M/IN/00229,01,E001,0000010,NEGOCIOS ARGOS E.I.R.L.,26.285000,0,26.285000,2855.0587787711622598,75045.22,0,75045.22,2855.0587787711622598,602101 - Mineral Aurifero sin Procesar,241101 - Mineral Aurifero sin Procesar,,"",AS-382,18PO06871,,2018-12-20,
Ubicaciones físicas / TR M / Existencias,Ubicaciones virtuales / Produccion, / TR M / Existencias,07,Mineral con Contenido Aurifero y Argentifero sin Procesar,M0001,t,MINERAL AURIFERO Y ARGENTIFERO SIN PROCESAR,2018-12-31,2018-12-31,,CMT-000241,,,CMT-000241,,0,26.285000,0.000000,2855.0587787711622598,0,75045.2199999999999988430000,0.0000000000000011570000,0,"",241101 - Mineral Aurifero sin Procesar,,"",AS-382,,,,
Ubicaciones virtuales / Produccion,Physical Locations / AMCTJ / Existencias,/ AMCTJ / Existencias,08,Mineral con Contenido Aurifero y Argentifero sin Procesar,M0001,t,MINERAL AURIFERO Y ARGENTIFERO SIN PROCESAR,2018-12-31,2018-12-31,,AMCTJ000248,,,AMCTJ000248,,26.285000,0,26.285000,2992.1367096043370744,78648.31341195,0,78648.31341195,2992.1367096043370744,"",241101 - Mineral Aurifero sin Procesar,,"",AS-382,,,,
Virtual Locations / Compras sin factura,Ubicaciones físicas / TR M / Existencias, / TR M / Existencias,03,Mineral con Contenido Aurifero y Argentifero sin Procesar,M0001,t,MINERAL AURIFERO Y ARGENTIFERO SIN PROCESAR,2018-12-21,2018-12-21,,TR M/IN/00243,,,TR M/IN/00243,NEGOCIOS ARGOS E.I.R.L.,39.729000,0,39.729000,2503.0340557275541796,99443.04,0,99443.04,2503.0340557275541796,"",241101 - Mineral Aurifero sin Procesar,,"",AS-383,,,2018-12-21,
Ubicaciones físicas / TR M / Existencias,Ubicaciones virtuales / Produccion, / TR M / Existencias,07,Mineral con Contenido Aurifero y Argentifero sin Procesar,M0001,t,MINERAL AURIFERO Y ARGENTIFERO SIN PROCESAR,2018-12-31,2018-12-31,,CMT-000241,,,CMT-000241,,0,39.729000,0.000000,2503.0340557275541796,0,99443.0400000000000013284000,-0.0000000000000013284000,0,"",241101 - Mineral Aurifero sin Procesar,,"",AS-383,,,,
Ubicaciones virtuales / Produccion,Physical Locations / AMCTJ / Existencias,/ AMCTJ / Existencias,08,Mineral con Contenido Aurifero y Argentifero sin Procesar,M0001,t,MINERAL AURIFERO Y ARGENTIFERO SIN PROCESAR,2018-12-31,2018-12-31,,AMCTJ000248,,,AMCTJ000248,,39.729000,0,39.729000,2640.1119609131868408,104889.00809512,0,104889.00809512,2640.1119609131868408,"",241101 - Mineral Aurifero sin Procesar,,"",AS-383,,,,
Virtual Locations / Compras sin factura,Ubicaciones físicas / TR M / Existencias, / TR M / Existencias,03,Mineral con Contenido Aurifero y Argentifero sin Procesar,M0001,t,MINERAL AURIFERO Y ARGENTIFERO SIN PROCESAR,2018-12-21,2018-12-21,,TR M/IN/00251,,,TR M/IN/00251,JENNY MAYERLING ARANDA MORILLO,24.552000,0,24.552000,818.9776800260671228,20107.54,0,20107.54,818.9776800260671228,"",241101 - Mineral Aurifero sin Procesar,,"",AS-384,,,2018-12-21,
Ubicaciones físicas / TR M / Existencias,Ubicaciones virtuales / Produccion, / TR M / Existencias,07,Mineral con Contenido Aurifero y Argentifero sin Procesar,M0001,t,MINERAL AURIFERO Y ARGENTIFERO SIN PROCESAR,2018-12-31,2018-12-31,,CMT-000241,,,CMT-000241,,0,24.552000,0.000000,818.9776800260671228,0,20107.5399999999999989856000,0.0000000000000010144000,0,"",241101 - Mineral Aurifero sin Procesar,,"",AS-384,,,,
Ubicaciones virtuales / Produccion,Physical Locations / AMCTJ / Existencias,/ AMCTJ / Existencias,08,Mineral con Contenido Aurifero y Argentifero sin Procesar,M0001,t,MINERAL AURIFERO Y ARGENTIFERO SIN PROCESAR,2018-12-31,2018-12-31,,AMCTJ000248,,,AMCTJ000248,,24.552000,0,24.552000,956.0556385198761812,23473.07803694,0,23473.07803694,956.0556385198761812,"",241101 - Mineral Aurifero sin Procesar,,"",AS-384,,,,
Partner Locations / Suppliers,Ubicaciones físicas / TR M / Existencias, / TR M / Existencias,03,Mineral con Contenido Aurifero y Argentifero sin Procesar,M0001,t,MINERAL AURIFERO Y ARGENTIFERO SIN PROCESAR,2018-12-20,2018-12-20,12/2018,TR M/IN/00228,01,0001,0000031,LEYDEN VEGA CASTAÑEDA,22.652000,0,22.652000,853.7718523750662193,19339.64,0,19339.64,853.7718523750662193,602101 - Mineral Aurifero sin Procesar,241101 - Mineral Aurifero sin Procesar,,"",AS-385,18PO06870,,2018-12-20,
Ubicaciones físicas / TR M / Existencias,Ubicaciones virtuales / Produccion, / TR M / Existencias,07,Mineral con Contenido Aurifero y Argentifero sin Procesar,M0001,t,MINERAL AURIFERO Y ARGENTIFERO SIN PROCESAR,2018-12-31,2018-12-31,,CMT-000241,,,CMT-000241,,0,22.652000,0.000000,853.7718523750662193,0,19339.6399999999999995836000,0.0000000000000004164000,0,"",241101 - Mineral Aurifero sin Procesar,,"",AS-385,,,,
Ubicaciones virtuales / Produccion,Physical Locations / AMCTJ / Existencias,/ AMCTJ / Existencias,08,Mineral con Contenido Aurifero y Argentifero sin Procesar,M0001,t,MINERAL AURIFERO Y ARGENTIFERO SIN PROCESAR,2018-12-31,2018-12-31,,AMCTJ000248,,,AMCTJ000248,,22.652000,0,22.652000,990.8497841047148155,22444.72930954,0,22444.72930954,990.8497841047148155,"",241101 - Mineral Aurifero sin Procesar,,"",AS-385,,,,
Partner Locations / Suppliers,Ubicaciones físicas / TR M / Existencias, / TR M / Existencias,03,Mineral con Contenido Aurifero y Argentifero sin Procesar,M0001,t,MINERAL AURIFERO Y ARGENTIFERO SIN PROCESAR,2018-12-20,2018-12-20,12/2018,TR M/IN/00229,01,E001,0000010,NEGOCIOS ARGOS E.I.R.L.,22.589000,0,22.589000,7041.4458364690778698,159059.22,0,159059.22,7041.4458364690778698,602101 - Mineral Aurifero sin Procesar,241101 - Mineral Aurifero sin Procesar,,"",AS-386,18PO06871,,2018-12-20,
Ubicaciones físicas / TR M / Existencias,Ubicaciones virtuales / Produccion, / TR M / Existencias,07,Mineral con Contenido Aurifero y Argentifero sin Procesar,M0001,t,MINERAL AURIFERO Y ARGENTIFERO SIN PROCESAR,2018-12-31,2018-12-31,,CMT-000241,,,CMT-000241,,0,22.589000,0.000000,7041.4458364690778698,0,159059.2200000000000009122000,-0.0000000000000009122000,0,"",241101 - Mineral Aurifero sin Procesar,,"",AS-386,,,,
Ubicaciones virtuales / Produccion,Physical Locations / AMCTJ / Existencias,/ AMCTJ / Existencias,08,Mineral con Contenido Aurifero y Argentifero sin Procesar,M0001,t,MINERAL AURIFERO Y ARGENTIFERO SIN PROCESAR,2018-12-31,2018-12-31,,AMCTJ000248,,,AMCTJ000248,,22.589000,0,22.589000,7178.5237402417105671,162155.67276832,0,162155.67276832,7178.5237402417105671,"",241101 - Mineral Aurifero sin Procesar,,"",AS-386,,,,
Partner Locations / Suppliers,Ubicaciones físicas / TR M / Existencias, / TR M / Existencias,03,Mineral con Contenido Aurifero y Argentifero sin Procesar,M0001,t,MINERAL AURIFERO Y ARGENTIFERO SIN PROCESAR,2018-12-20,2018-12-20,12/2018,TR M/IN/00230,01,E001,0000011,NEGOCIOS ARGOS E.I.R.L.,12.371000,0,12.371000,553.9641096111874545,6853.09,0,6853.09,553.9641096111874545,602101 - Mineral Aurifero sin Procesar,241101 - Mineral Aurifero sin Procesar,,"",AS-387,18PO06922,,2018-12-20,
Ubicaciones físicas / TR M / Existencias,Ubicaciones virtuales / Produccion, / TR M / Existencias,07,Mineral con Contenido Aurifero y Argentifero sin Procesar,M0001,t,MINERAL AURIFERO Y ARGENTIFERO SIN PROCESAR,2018-12-31,2018-12-31,,CMT-000241,,,CMT-000241,,0,12.371000,0.000000,553.9641096111874545,0,6853.0899999999999996195000,0.0000000000000003805000,0,"",241101 - Mineral Aurifero sin Procesar,,"",AS-387,,,,
Ubicaciones virtuales / Produccion,Physical Locations / AMCTJ / Existencias,/ AMCTJ / Existencias,08,Mineral con Contenido Aurifero y Argentifero sin Procesar,M0001,t,MINERAL AURIFERO Y ARGENTIFERO SIN PROCESAR,2018-12-31,2018-12-31,,AMCTJ000248,,,AMCTJ000248,,12.371000,0,12.371000,691.0419560860075984,8548.88003874,0,8548.88003874,691.0419560860075984,"",241101 - Mineral Aurifero sin Procesar,,"",AS-387,,,,
Virtual Locations / Compras sin factura,Ubicaciones físicas / TR M / Existencias, / TR M / Existencias,03,Mineral con Contenido Aurifero y Argentifero sin Procesar,M0001,t,MINERAL AURIFERO Y ARGENTIFERO SIN PROCESAR,2018-12-29,2018-12-29,,TR M/IN/00246,,,TR M/IN/00246,MASIAS ROGELIO HUERTA  ALVARADO,34.885000,0,34.885000,1472.1843199082700301,51357.15,0,51357.15,1472.1843199082700301,"",241101 - Mineral Aurifero sin Procesar,,"",AS-388,,,2018-12-29,
Ubicaciones físicas / TR M / Existencias,Ubicaciones virtuales / Produccion, / TR M / Existencias,07,Mineral con Contenido Aurifero y Argentifero sin Procesar,M0001,t,MINERAL AURIFERO Y ARGENTIFERO SIN PROCESAR,2018-12-31,2018-12-31,,CMT-000241,,,CMT-000241,,0,34.885000,0.000000,1472.1843199082700301,0,51357.1500000000000000385000,-0.0000000000000000385000,0,"",241101 - Mineral Aurifero sin Procesar,,"",AS-388,,,,
Ubicaciones virtuales / Produccion,Physical Locations / AMCTJ / Existencias,/ AMCTJ / Existencias,08,Mineral con Contenido Aurifero y Argentifero sin Procesar,M0001,t,MINERAL AURIFERO Y ARGENTIFERO SIN PROCESAR,2018-12-31,2018-12-31,,AMCTJ000248,,,AMCTJ000248,,34.885000,0,34.885000,1609.2622223087286799,56139.11262524,0,56139.11262524,1609.2622223087286799,"",241101 - Mineral Aurifero sin Procesar,,"",AS-388,,,,
Virtual Locations / Compras sin factura,Ubicaciones físicas / TR M / Existencias, / TR M / Existencias,03,Mineral con Contenido Aurifero y Argentifero sin Procesar,M0001,t,MINERAL AURIFERO Y ARGENTIFERO SIN PROCESAR,2018-12-29,2018-12-29,,TR M/IN/00246,,,TR M/IN/00246,MASIAS ROGELIO HUERTA  ALVARADO,2.996000,0,2.996000,1744.2790387182910547,5225.86,0,5225.86,1744.2790387182910547,"",241101 - Mineral Aurifero sin Procesar,,"",AS-389,,,2018-12-29,
Ubicaciones físicas / TR M / Existencias,Ubicaciones virtuales / Produccion, / TR M / Existencias,07,Mineral con Contenido Aurifero y Argentifero sin Procesar,M0001,t,MINERAL AURIFERO Y ARGENTIFERO SIN PROCESAR,2018-12-31,2018-12-31,,CMT-000241,,,CMT-000241,,0,2.996000,0.000000,1744.2790387182910547,0,5225.8599999999999998812000,0.0000000000000001188000,0,"",241101 - Mineral Aurifero sin Procesar,,"",AS-389,,,,
Ubicaciones virtuales / Produccion,Physical Locations / AMCTJ / Existencias,/ AMCTJ / Existencias,08,Mineral con Contenido Aurifero y Argentifero sin Procesar,M0001,t,MINERAL AURIFERO Y ARGENTIFERO SIN PROCESAR,2018-12-31,2018-12-31,,AMCTJ000248,,,AMCTJ000248,,2.996000,0,2.996000,1881.3570720293724967,5636.5457878,0,5636.5457878,1881.3570720293724967,"",241101 - Mineral Aurifero sin Procesar,,"",AS-389,,,,
Virtual Locations / Compras sin factura,Ubicaciones físicas / TR M / Existencias, / TR M / Existencias,03,Mineral con Contenido Aurifero y Argentifero sin Procesar,M0001,t,MINERAL AURIFERO Y ARGENTIFERO SIN PROCESAR,2018-12-29,2018-12-29,,TR M/IN/00246,,,TR M/IN/00246,MASIAS ROGELIO HUERTA  ALVARADO,39.039000,0,39.039000,10022.1775660237198699,391255.79,0,391255.79,10022.1775660237198699,"",241101 - Mineral Aurifero sin Procesar,,"",AS-390,,,2018-12-29,
Ubicaciones físicas / TR M / Existencias,Ubicaciones virtuales / Produccion, / TR M / Existencias,07,Mineral con Contenido Aurifero y Argentifero sin Procesar,M0001,t,MINERAL AURIFERO Y ARGENTIFERO SIN PROCESAR,2018-12-31,2018-12-31,,CMT-000241,,,CMT-000241,,0,39.039000,0.000000,10022.1775660237198699,0,391255.7900000000000010261000,-0.0000000000000010261000,0,"",241101 - Mineral Aurifero sin Procesar,,"",AS-390,,,,
Ubicaciones virtuales / Produccion,Physical Locations / AMCTJ / Existencias,/ AMCTJ / Existencias,08,Mineral con Contenido Aurifero y Argentifero sin Procesar,M0001,t,MINERAL AURIFERO Y ARGENTIFERO SIN PROCESAR,2018-12-31,2018-12-31,,AMCTJ000248,,,AMCTJ000248,,39.039000,0,39.039000,10159.2554776116191501,396607.17459048,0,396607.17459048,10159.2554776116191501,"",241101 - Mineral Aurifero sin Procesar,,"",AS-390,,,,
Virtual Locations / Compras sin factura,Ubicaciones físicas / TR M / Existencias, / TR M / Existencias,03,Mineral con Contenido Aurifero y Argentifero sin Procesar,M0001,t,MINERAL AURIFERO Y ARGENTIFERO SIN PROCESAR,2018-12-29,2018-12-29,,TR M/IN/00246,,,TR M/IN/00246,MASIAS ROGELIO HUERTA  ALVARADO,32.859000,0,32.859000,10022.1774856203779786,329318.73,0,329318.73,10022.1774856203779786,"",241101 - Mineral Aurifero sin Procesar,,"",AS-391,,,2018-12-29,
Ubicaciones físicas / TR M / Existencias,Ubicaciones virtuales / Produccion, / TR M / Existencias,07,Mineral con Contenido Aurifero y Argentifero sin Procesar,M0001,t,MINERAL AURIFERO Y ARGENTIFERO SIN PROCESAR,2018-12-31,2018-12-31,,CMT-000241,,,CMT-000241,,0,32.859000,0.000000,10022.1774856203779786,0,329318.7299999999999988174000,0.0000000000000011826000,0,"",241101 - Mineral Aurifero sin Procesar,,"",AS-391,,,,
Ubicaciones virtuales / Produccion,Physical Locations / AMCTJ / Existencias,/ AMCTJ / Existencias,08,Mineral con Contenido Aurifero y Argentifero sin Procesar,M0001,t,MINERAL AURIFERO Y ARGENTIFERO SIN PROCESAR,2018-12-31,2018-12-31,,AMCTJ000248,,,AMCTJ000248,,32.859000,0,32.859000,10159.255366714447,333822.97209487,0,333822.97209487,10159.255366714447,"",241101 - Mineral Aurifero sin Procesar,,"",AS-391,,,,
Virtual Locations / Compras sin factura,Ubicaciones físicas / TR M / Existencias, / TR M / Existencias,03,Mineral con Contenido Aurifero y Argentifero sin Procesar,M0001,t,MINERAL AURIFERO Y ARGENTIFERO SIN PROCESAR,2018-12-23,2018-12-23,,TR M/IN/00248,,,TR M/IN/00248,MASIAS ROGELIO HUERTA  ALVARADO,25.390000,0,25.390000,253.0192989365892083,6424.16,0,6424.16,253.0192989365892083,"",241101 - Mineral Aurifero sin Procesar,,"",AS-392,,,2018-12-23,
Ubicaciones físicas / TR M / Existencias,Ubicaciones virtuales / Produccion, / TR M / Existencias,07,Mineral con Contenido Aurifero y Argentifero sin Procesar,M0001,t,MINERAL AURIFERO Y ARGENTIFERO SIN PROCESAR,2018-12-31,2018-12-31,,CMT-000242,,,CMT-000242,,0,25.390000,0.000000,253.0192989365892083,0,6424.1599999999999987370000,0.0000000000000012630000,0,"",241101 - Mineral Aurifero sin Procesar,,"",AS-392,,,,
Ubicaciones virtuales / Produccion,Physical Locations / AMCTJ / Existencias,/ AMCTJ / Existencias,08,Mineral con Contenido Aurifero y Argentifero sin Procesar,M0001,t,MINERAL AURIFERO Y ARGENTIFERO SIN PROCESAR,2018-12-31,2018-12-31,,AMCTJ000249,,,AMCTJ000249,,25.390000,0,25.390000,390.0972168708152816,9904.56833635,0,9904.56833635,390.0972168708152816,"",241101 - Mineral Aurifero sin Procesar,,"",AS-392,,,,
Virtual Locations / Compras sin factura,Ubicaciones físicas / TR M / Existencias, / TR M / Existencias,03,Mineral con Contenido Aurifero y Argentifero sin Procesar,M0001,t,MINERAL AURIFERO Y ARGENTIFERO SIN PROCESAR,2018-12-29,2018-12-29,,TR M/IN/00241,,,TR M/IN/00241,NEGOCIOS ARGOS E.I.R.L.,28.028000,0,28.028000,12102.580276865991,339211.12,0,339211.12,12102.580276865991,"",241101 - Mineral Aurifero sin Procesar,,"",AS-393,,,2018-12-29,
Ubicaciones físicas / TR M / Existencias,Ubicaciones virtuales / Produccion, / TR M / Existencias,07,Mineral con Contenido Aurifero y Argentifero sin Procesar,M0001,t,MINERAL AURIFERO Y ARGENTIFERO SIN PROCESAR,2018-12-31,2018-12-31,,CMT-000242,,,CMT-000242,,0,28.028000,0.000000,12102.580276865991,0,339211.119999999995748000,0.000000000004252000,0,"",241101 - Mineral Aurifero sin Procesar,,"",AS-393,,,,
Ubicaciones virtuales / Produccion,Physical Locations / AMCTJ / Existencias,/ AMCTJ / Existencias,08,Mineral con Contenido Aurifero y Argentifero sin Procesar,M0001,t,MINERAL AURIFERO Y ARGENTIFERO SIN PROCESAR,2018-12-31,2018-12-31,,AMCTJ000249,,,AMCTJ000249,,28.028000,0,28.028000,12239.658203872556,343053.14013814,0,343053.14013814,12239.658203872556,"",241101 - Mineral Aurifero sin Procesar,,"",AS-393,,,,
Virtual Locations / Compras sin factura,Ubicaciones físicas / TR M / Existencias, / TR M / Existencias,03,Mineral con Contenido Aurifero y Argentifero sin Procesar,M0001,t,MINERAL AURIFERO Y ARGENTIFERO SIN PROCESAR,2018-12-29,2018-12-29,,TR M/IN/00245,,,TR M/IN/00245,FERMINA MARGARITA SALIRROSAS BACA,31.900000,0,31.900000,2908.3438871473354232,92776.17,0,92776.17,2908.3438871473354232,"",241101 - Mineral Aurifero sin Procesar,,"",AS-394,,,2018-12-29,
Ubicaciones físicas / TR M / Existencias,Ubicaciones virtuales / Produccion, / TR M / Existencias,07,Mineral con Contenido Aurifero y Argentifero sin Procesar,M0001,t,MINERAL AURIFERO Y ARGENTIFERO SIN PROCESAR,2018-12-31,2018-12-31,,CMT-000242,,,CMT-000242,,0,31.900000,0.000000,2908.3438871473354232,0,92776.1700000000000000800000,-0.0000000000000000800000,0,"",241101 - Mineral Aurifero sin Procesar,,"",AS-394,,,,
Ubicaciones virtuales / Produccion,Physical Locations / AMCTJ / Existencias,/ AMCTJ / Existencias,08,Mineral con Contenido Aurifero y Argentifero sin Procesar,M0001,t,MINERAL AURIFERO Y ARGENTIFERO SIN PROCESAR,2018-12-31,2018-12-31,,AMCTJ000249,,,AMCTJ000249,,31.900000,0,31.900000,3045.4218060438871473,97148.9556128,0,97148.9556128,3045.4218060438871473,"",241101 - Mineral Aurifero sin Procesar,,"",AS-394,,,,
Virtual Locations / Compras sin factura,Ubicaciones físicas / TR M / Existencias, / TR M / Existencias,03,Mineral con Contenido Aurifero y Argentifero sin Procesar,M0001,t,MINERAL AURIFERO Y ARGENTIFERO SIN PROCESAR,2018-12-29,2018-12-29,,TR M/IN/00246,,,TR M/IN/00246,MASIAS ROGELIO HUERTA  ALVARADO,36.324000,0,36.324000,214.6357779980178394,7796.43,0,7796.43,214.6357779980178394,"",241101 - Mineral Aurifero sin Procesar,,"",AS-395,,,2018-12-29,
Ubicaciones físicas / TR M / Existencias,Ubicaciones virtuales / Produccion, / TR M / Existencias,07,Mineral con Contenido Aurifero y Argentifero sin Procesar,M0001,t,MINERAL AURIFERO Y ARGENTIFERO SIN PROCESAR,2018-12-31,2018-12-31,,CMT-000242,,,CMT-000242,,0,36.324000,0.000000,214.6357779980178394,0,7796.4299999999999983656000,0.0000000000000016344000,0,"",241101 - Mineral Aurifero sin Procesar,,"",AS-395,,,,
Ubicaciones virtuales / Produccion,Physical Locations / AMCTJ / Existencias,/ AMCTJ / Existencias,08,Mineral con Contenido Aurifero y Argentifero sin Procesar,M0001,t,MINERAL AURIFERO Y ARGENTIFERO SIN PROCESAR,2018-12-31,2018-12-31,,AMCTJ000249,,,AMCTJ000249,,36.324000,0,36.324000,351.7136843150534082,12775.64786906,0,12775.64786906,351.7136843150534082,"",241101 - Mineral Aurifero sin Procesar,,"",AS-395,,,,
Virtual Locations / Compras sin factura,Ubicaciones físicas / TR M / Existencias, / TR M / Existencias,03,Mineral con Contenido Aurifero y Argentifero sin Procesar,M0001,t,MINERAL AURIFERO Y ARGENTIFERO SIN PROCESAR,2018-12-29,2018-12-29,,TR M/IN/00246,,,TR M/IN/00246,MASIAS ROGELIO HUERTA  ALVARADO,37.481000,0,37.481000,1069.4020970625116726,40082.26,0,40082.26,1069.4020970625116726,"",241101 - Mineral Aurifero sin Procesar,,"",AS-396,,,2018-12-29,
Ubicaciones físicas / TR M / Existencias,Ubicaciones virtuales / Produccion, / TR M / Existencias,07,Mineral con Contenido Aurifero y Argentifero sin Procesar,M0001,t,MINERAL AURIFERO Y ARGENTIFERO SIN PROCESAR,2018-12-31,2018-12-31,,CMT-000242,,,CMT-000242,,0,37.481000,0.000000,1069.4020970625116726,0,40082.2600000000000007206000,-0.0000000000000007206000,0,"",241101 - Mineral Aurifero sin Procesar,,"",AS-396,,,,
Ubicaciones virtuales / Produccion,Physical Locations / AMCTJ / Existencias,/ AMCTJ / Existencias,08,Mineral con Contenido Aurifero y Argentifero sin Procesar,M0001,t,MINERAL AURIFERO Y ARGENTIFERO SIN PROCESAR,2018-12-31,2018-12-31,,AMCTJ000249,,,AMCTJ000249,,37.481000,0,37.481000,1206.4799960748112377,45220.07673288,0,45220.07673288,1206.4799960748112377,"",241101 - Mineral Aurifero sin Procesar,,"",AS-396,,,,
Virtual Locations / Compras sin factura,Ubicaciones físicas / TR M / Existencias, / TR M / Existencias,03,Mineral con Contenido Aurifero y Argentifero sin Procesar,M0001,t,MINERAL AURIFERO Y ARGENTIFERO SIN PROCESAR,2018-12-29,2018-12-29,,TR M/IN/00247,,,TR M/IN/00247,LEYDEN VEGA CASTAÑEDA,30.350000,0,30.350000,2813.5792421746293245,85392.13,0,85392.13,2813.5792421746293245,"",241101 - Mineral Aurifero sin Procesar,,"",AS-397,,,2018-12-29,
Ubicaciones físicas / TR M / Existencias,Ubicaciones virtuales / Produccion, / TR M / Existencias,07,Mineral con Contenido Aurifero y Argentifero sin Procesar,M0001,t,MINERAL AURIFERO Y ARGENTIFERO SIN PROCESAR,2018-12-31,2018-12-31,,CMT-000242,,,CMT-000242,,0,30.350000,0.000000,2813.5792421746293245,0,85392.1299999999999985750000,0.0000000000000014250000,0,"",241101 - Mineral Aurifero sin Procesar,,"",AS-397,,,,
Ubicaciones virtuales / Produccion,Physical Locations / AMCTJ / Existencias,/ AMCTJ / Existencias,08,Mineral con Contenido Aurifero y Argentifero sin Procesar,M0001,t,MINERAL AURIFERO Y ARGENTIFERO SIN PROCESAR,2018-12-31,2018-12-31,,AMCTJ000249,,,AMCTJ000249,,30.350000,0,30.350000,2950.6571841018121911,89552.44553749,0,89552.44553749,2950.6571841018121911,"",241101 - Mineral Aurifero sin Procesar,,"",AS-397,,,,
Virtual Locations / Compras sin factura,Ubicaciones físicas / TR M / Existencias, / TR M / Existencias,03,Mineral con Contenido Aurifero y Argentifero sin Procesar,M0001,t,MINERAL AURIFERO Y ARGENTIFERO SIN PROCESAR,2018-12-29,2018-12-29,,TR M/IN/00247,,,TR M/IN/00247,LEYDEN VEGA CASTAÑEDA,5.273000,0,5.273000,8413.6430874265124218,44365.14,0,44365.14,8413.6430874265124218,"",241101 - Mineral Aurifero sin Procesar,,"",AS-398,,,2018-12-29,
Ubicaciones físicas / TR M / Existencias,Ubicaciones virtuales / Produccion, / TR M / Existencias,07,Mineral con Contenido Aurifero y Argentifero sin Procesar,M0001,t,MINERAL AURIFERO Y ARGENTIFERO SIN PROCESAR,2018-12-31,2018-12-31,,CMT-000242,,,CMT-000242,,0,5.273000,0.000000,8413.6430874265124218,0,44365.1400000000000001514000,-0.0000000000000001514000,0,"",241101 - Mineral Aurifero sin Procesar,,"",AS-398,,,,
Ubicaciones virtuales / Produccion,Physical Locations / AMCTJ / Existencias,/ AMCTJ / Existencias,08,Mineral con Contenido Aurifero y Argentifero sin Procesar,M0001,t,MINERAL AURIFERO Y ARGENTIFERO SIN PROCESAR,2018-12-31,2018-12-31,,AMCTJ000249,,,AMCTJ000249,,5.273000,0,5.273000,8550.7209048037170491,45087.95133103,0,45087.95133103,8550.7209048037170491,"",241101 - Mineral Aurifero sin Procesar,,"",AS-398,,,,
Physical Locations / Joya / Stock,Ubicaciones virtuales / Produccion,/ Joya / Stock,07,Lubricantes y Grasas,106-0002-01,Unit(s),GRASA VISTOBLOCK X 20 KG,2018-12-14,2018-12-14,,Joya\OUT\08917,,,Joya\OUT\08917,ALEX ROGELIO (TRB) MEDINA ZABALAGA,0,1.000000,-1.000000,0,0,0.000000,0.000000,0,"",252201 - Lubricantes,21.01.09 MOLINO 6' X 8' DELTA,"",,,,2018-12-14,
Physical Locations / Joya / Stock,Ubicaciones virtuales / Produccion,/ Joya / Stock,07,Lubricantes y Grasas,106-0005-XX,Liter(s),MOBIL GEAR 600 XP 220,2018-12-02,2018-12-02,,Joya\OUT\08751,,,Joya\OUT\08751,ALEX ROGELIO (TRB) MEDINA ZABALAGA,0,20.000000,-20.000000,0,0,0.000000,0.000000,0,"",252201 - Lubricantes,21.01.01 MOLIENDA,"",,,,2018-12-02,
Physical Locations / Joya / Stock,Ubicaciones virtuales / Produccion,/ Joya / Stock,07,Lubricantes y Grasas,106-0005-XX,Liter(s),MOBIL GEAR 600 XP 220,2018-12-31,2018-12-31,,Joya\OUT\09087,,,Joya\OUT\09087,ALEX ROGELIO (TRB) MEDINA ZABALAGA,0,20.000000,-40.000000,0,0,0.000000,0.000000,0,"",252201 - Lubricantes,20.03.09 FAJA TRANSPORTADORA Nr. 1,"",,,,2018-12-31,
Physical Locations / Joya / Stock,Ubicaciones virtuales / Produccion,/ Joya / Stock,07,Lubricantes y Grasas,106-0011-01,Unit(s),GRASA VISTONY  EP 2 LITHIUM X 5 GL,2018-12-14,2018-12-14,,Joya\OUT\08917,,,Joya\OUT\08917,ALEX ROGELIO (TRB) MEDINA ZABALAGA,0,1.000000,-1.000000,0,0,0.000000,0.000000,0,"",252201 - Lubricantes,20.03.09 FAJA TRANSPORTADORA Nr. 1,"",,,,2018-12-14,
Physical Locations / Joya / Stock,Ubicaciones virtuales / Produccion,/ Joya / Stock,07,Lubricantes y Grasas,106-0011-01,Unit(s),GRASA VISTONY  EP 2 LITHIUM X 5 GL,2018-12-31,2018-12-31,,Joya\OUT\09087,,,Joya\OUT\09087,ALEX ROGELIO (TRB) MEDINA ZABALAGA,0,1.000000,-2.000000,0,0,0.000000,0.000000,0,"",252201 - Lubricantes,20.03.04 CARGADOR FRONTAL (CAT 950),"",,,,2018-12-31,
Physical Locations / Joya / Stock,Ubicaciones virtuales / Produccion,/ Joya / Stock,07,Materiales de Ferreteria y Construccion,107-0006-01,Unit(s),AFLOJATODO WD-40,2018-12-14,2018-12-14,,Joya\OUT\08917,,,Joya\OUT\08917,ALEX ROGELIO (TRB) MEDINA ZABALAGA,0,1.000000,-1.000000,0,0,0.000000,0.000000,0,"",252401 - Materiales de Ferreteria y Construccion,25.01.03 TALLER DE MANTENIMIENTO,"",,,,2018-12-14,
Physical Locations / Joya / Stock,Ubicaciones virtuales / Produccion,/ Joya / Stock,07,Materiales de Ferreteria y Construccion,107-0006-01,Unit(s),AFLOJATODO WD-40,2018-12-30,2018-12-30,,Joya\OUT\09079,,,Joya\OUT\09079,ALEX ROGELIO (TRB) MEDINA ZABALAGA,0,1.000000,-2.000000,0,0,0.000000,0.000000,0,"",252401 - Materiales de Ferreteria y Construccion,20.03.32	COLECTOR DE POLVO,"",,,,2018-12-30,
Physical Locations / Joya / Stock,Ubicaciones virtuales / Produccion,/ Joya / Stock,07,Materiales de Ferreteria y Construccion,107-0006-01,Unit(s),AFLOJATODO WD-40,2018-12-31,2018-12-31,,Joya\OUT\09095,,,Joya\OUT\09095,ALEX ROGELIO (TRB) MEDINA ZABALAGA,0,1.000000,-3.000000,0,0,0.000000,0.000000,0,"",252401 - Materiales de Ferreteria y Construccion,20.03.04 CARGADOR FRONTAL (CAT 950),"",,,,2018-12-31,
Physical Locations / Joya / Stock,Ubicaciones virtuales / Produccion,/ Joya / Stock,07,Materiales de Ferreteria y Construccion,107-0040-01,Unit(s),"DISCO DE DESBASTE 7""",2018-12-02,2018-12-02,,Joya\OUT\08751,,,Joya\OUT\08751,ALEX ROGELIO (TRB) MEDINA ZABALAGA,0,1.000000,-1.000000,0,0,0.000000,0.000000,0,"",252401 - Materiales de Ferreteria y Construccion,21.01.01 MOLIENDA,"",,,,2018-12-02,
Physical Locations / Joya / Stock,Ubicaciones virtuales / Produccion,/ Joya / Stock,07,Materiales de Ferreteria y Construccion,107-0040-01,Unit(s),"DISCO DE DESBASTE 7""",2018-12-17,2018-12-17,,Joya\OUT\08933,,,Joya\OUT\08933,ALEX ROGELIO (TRB) MEDINA ZABALAGA,0,4.000000,-5.000000,0,0,0.000000,0.000000,0,"",252401 - Materiales de Ferreteria y Construccion,21.02.03 TANQUE AGITADOR #1 (22'x22'),"",,,,2018-12-17,
Physical Locations / Joya / Stock,Ubicaciones virtuales / Produccion,/ Joya / Stock,07,Materiales de Ferreteria y Construccion,107-0041-01,Unit(s),"DISCO DE CORTE 14""",2018-12-09,2018-12-09,,Joya\OUT\08849,,,Joya\OUT\08849,MARVIN EDUARDO QUISPE LEIVA,0,1.000000,-1.000000,0,0,0.000000,0.000000,0,"",252401 - Materiales de Ferreteria y Construccion,20.03.03 CHANCADO,"",,,,2018-12-09,
Physical Locations / Joya / Stock,Ubicaciones virtuales / Produccion,/ Joya / Stock,07,Materiales de Ferreteria y Construccion,107-0042-01,Unit(s),"DISCO DE CORTE 4 1/2""",2018-12-14,2018-12-14,,Joya\OUT\08917,,,Joya\OUT\08917,ALEX ROGELIO (TRB) MEDINA ZABALAGA,0,25.000000,-25.000000,0,0,0.000000,0.000000,0,"",252401 - Materiales de Ferreteria y Construccion,25.01.03 TALLER DE MANTENIMIENTO,"",,,,2018-12-14,
Physical Locations / Joya / Stock,Ubicaciones virtuales / Produccion,/ Joya / Stock,08,Materiales de Ferreteria y Construccion,107-0042-01,Unit(s),"DISCO DE CORTE 4 1/2""",2018-12-28,2018-12-28,,Joya\OUT\09059,,,Joya\OUT\09059,EDISON (TRB) RAMOS HACHIRI,0,6.000000,-31.000000,0,0,0.000000,0.000000,0,"",252401 - Materiales de Ferreteria y Construccion,29.01.87 OPTIMIZACION DE SISTEMA ELECTRICO DE PLANTA,"",,,,2018-12-28,
Physical Locations / Joya / Stock,Ubicaciones virtuales / Produccion,/ Joya / Stock,07,Materiales de Ferreteria y Construccion,107-0043-01,Unit(s),"DISCO DE CORTE 7""",2018-12-02,2018-12-02,,Joya\OUT\08751,,,Joya\OUT\08751,ALEX ROGELIO (TRB) MEDINA ZABALAGA,0,10.000000,-10.000000,0,0,0.000000,0.000000,0,"",252401 - Materiales de Ferreteria y Construccion,21.01.01 MOLIENDA,"",,,,2018-12-02,
Physical Locations / Joya / Stock,Ubicaciones virtuales / Produccion,/ Joya / Stock,08,Materiales de Ferreteria y Construccion,107-0043-01,Unit(s),"DISCO DE CORTE 7""",2018-12-06,2018-12-06,,Joya\OUT\08818,,,Joya\OUT\08818,,0,4.000000,-14.000000,0,0,0.000000,0.000000,0,"",252401 - Materiales de Ferreteria y Construccion,29.01.82 TANQUE NUEVO DE 22X22',"",,,,2018-12-06,
Physical Locations / Joya / Stock,Ubicaciones virtuales / Produccion,/ Joya / Stock,07,Materiales de Ferreteria y Construccion,107-0043-01,Unit(s),"DISCO DE CORTE 7""",2018-12-09,2018-12-09,,Joya\OUT\08849,,,Joya\OUT\08849,MARVIN EDUARDO QUISPE LEIVA,0,5.000000,-19.000000,0,0,0.000000,0.000000,0,"",252401 - Materiales de Ferreteria y Construccion,20.03.03 CHANCADO,"",,,,2018-12-09,
Physical Locations / Joya / Stock,Ubicaciones virtuales / Produccion,/ Joya / Stock,07,Materiales de Ferreteria y Construccion,107-0043-01,Unit(s),"DISCO DE CORTE 7""",2018-12-14,2018-12-14,,Joya\OUT\08917,,,Joya\OUT\08917,ALEX ROGELIO (TRB) MEDINA ZABALAGA,0,25.000000,-44.000000,0,0,0.000000,0.000000,0,"",252401 - Materiales de Ferreteria y Construccion,25.01.03 TALLER DE MANTENIMIENTO,"",,,,2018-12-14,
Physical Locations / Joya / Stock,Ubicaciones virtuales / Produccion,/ Joya / Stock,08,Materiales de Ferreteria y Construccion,107-0043-01,Unit(s),"DISCO DE CORTE 7""",2018-12-28,2018-12-28,,Joya\OUT\09059,,,Joya\OUT\09059,EDISON (TRB) RAMOS HACHIRI,0,6.000000,-50.000000,0,0,0.000000,0.000000,0,"",252401 - Materiales de Ferreteria y Construccion,29.01.87 OPTIMIZACION DE SISTEMA ELECTRICO DE PLANTA,"",,,,2018-12-28,
Physical Locations / Joya / Stock,Ubicaciones virtuales / Produccion,/ Joya / Stock,07,Materiales de Ferreteria y Construccion,107-0043-01,Unit(s),"DISCO DE CORTE 7""",2018-12-29,2018-12-29,,Joya\OUT\09069,,,Joya\OUT\09069,GAVINO FELICIANO (TRB) CALISAYA RODRIGUEZ,0,9.000000,-59.000000,0,0,0.000000,0.000000,0,"",252401 - Materiales de Ferreteria y Construccion,21.02.01 LIXIVIACIÓN Y ABSORCION,"",,,,2018-12-29,
Physical Locations / Joya / Stock,Ubicaciones virtuales / Produccion,/ Joya / Stock,07,Materiales de Ferreteria y Construccion,107-0045-01,Unit(s),"DISCO DE DESBASTE 4 1/2""",2018-12-02,2018-12-02,,Joya\OUT\08751,,,Joya\OUT\08751,ALEX ROGELIO (TRB) MEDINA ZABALAGA,0,1.000000,-1.000000,0,0,0.000000,0.000000,0,"",252401 - Materiales de Ferreteria y Construccion,21.01.01 MOLIENDA,"",,,,2018-12-02,
Physical Locations / Joya / Stock,Ubicaciones virtuales / Produccion,/ Joya / Stock,07,Materiales de Ferreteria y Construccion,107-0045-01,Unit(s),"DISCO DE DESBASTE 4 1/2""",2018-12-17,2018-12-17,,Joya\OUT\08933,,,Joya\OUT\08933,ALEX ROGELIO (TRB) MEDINA ZABALAGA,0,2.000000,-3.000000,0,0,0.000000,0.000000,0,"",252401 - Materiales de Ferreteria y Construccion,21.02.03 TANQUE AGITADOR #1 (22'x22'),"",,,,2018-12-17,
Physical Locations / Joya / Stock,Ubicaciones virtuales / Produccion,/ Joya / Stock,08,Materiales de Ferreteria y Construccion,107-0051-04,Unit(s),"CODO HDPE 2""",2018-12-12,2018-12-12,,Joya\OUT\08885,,,Joya\OUT\08885,EDISON (TRB) RAMOS HACHIRI,0,3.000000,-3.000000,0,0,0.000000,0.000000,0,"",252401 - Materiales de Ferreteria y Construccion,29.01.82 TANQUE NUEVO DE 22X22',"",,,,2018-12-12,
Physical Locations / Joya / Stock,Ubicaciones virtuales / Produccion,/ Joya / Stock,08,Materiales de Ferreteria y Construccion,107-0056-04,Unit(s),"TEE HDPE  2""",2018-12-12,2018-12-12,,Joya\OUT\08885,,,Joya\OUT\08885,EDISON (TRB) RAMOS HACHIRI,0,3.000000,-3.000000,0,0,0.000000,0.000000,0,"",252401 - Materiales de Ferreteria y Construccion,29.01.82 TANQUE NUEVO DE 22X22',"",,,,2018-12-12,
Physical Locations / Joya / Stock,Ubicaciones virtuales / Produccion,/ Joya / Stock,07,Materiales de Ferreteria y Construccion,107-0101-01,Unit(s),SILICONA ACETICA NEGRA 3M 300ml,2018-12-27,2018-12-27,,Joya\OUT\09054,,,Joya\OUT\09054,JOSE SANTOS MATTA BORJAS,0,1.000000,-1.000000,0,0,0.000000,0.000000,0,"",252401 - Materiales de Ferreteria y Construccion,22.01.03 DESORCIÓN,"",,,,,
Physical Locations / Joya / Stock,Ubicaciones virtuales / Produccion,/ Joya / Stock,07,Materiales de Ferreteria y Construccion,107-0110-01,Unit(s),SOLDIMIX,2018-12-16,2018-12-16,,Joya\OUT\08927,,,Joya\OUT\08927,Harold Zambrano,0,1.000000,-1.000000,0,0,0.000000,0.000000,0,"",252401 - Materiales de Ferreteria y Construccion,"22.01.29	DEPRECIACION DESORCION, FUNDICION Y REFINACION","",,,,,
Physical Locations / Joya / Stock,Ubicaciones virtuales / Produccion,/ Joya / Stock,07,Materiales de Ferreteria y Construccion,107-0110-01,Unit(s),SOLDIMIX,2018-12-19,2018-12-19,,Joya\OUT\08971,,,Joya\OUT\08971,VICTOR URIEL VILCA CENTI,0,1.000000,-2.000000,0,0,0.000000,0.000000,0,"",252401 - Materiales de Ferreteria y Construccion,20.05.02 LABORATORIO QUIMICO,"",,,,2018-12-19,
Physical Locations / Joya / Stock,Ubicaciones virtuales / Produccion,/ Joya / Stock,07,Materiales de Ferreteria y Construccion,107-0118-01,Unit(s),"CINTA TEFLON 3/4""",2018-12-22,2018-12-22,,Joya\OUT\09002,,,Joya\OUT\09002,ALEX ROGELIO (TRB) MEDINA ZABALAGA,0,4.000000,-4.000000,0,0,0.000000,0.000000,0,"",252401 - Materiales de Ferreteria y Construccion,20.03.03 CHANCADO,"",,,,2018-12-22,
Physical Locations / Joya / Stock,Ubicaciones virtuales / Produccion,/ Joya / Stock,07,Materiales de Ferreteria y Construccion,107-0119-01,Unit(s),"CINTA TEFLON AMARILLO 3/4""",2018-12-04,2018-12-04,,Joya\OUT\08800,,,Joya\OUT\08800,CARLOS ABRAHAN HUAMAN MAMANI,0,1.000000,-1.000000,0,0,0.000000,0.000000,0,"",252401 - Materiales de Ferreteria y Construccion,22.01.09 TANQUE DE ACONDICIONAMIENTO 1.0 M3,"",,,,2018-12-04,
Physical Locations / Joya / Stock,Ubicaciones virtuales / Produccion,/ Joya / Stock,07,Materiales de Ferreteria y Construccion,107-0121-01,Caja,TIZA EN PALOTES,2018-12-03,2018-12-03,,Joya\OUT\08786,,,Joya\OUT\08786,GAVINO FELICIANO (TRB) CALISAYA RODRIGUEZ,0,2.000000,-2.000000,0,0,0.000000,0.000000,0,"",252401 - Materiales de Ferreteria y Construccion,20.03.03 CHANCADO,"",,,,2018-12-03,
Physical Locations / Joya / Stock,Ubicaciones virtuales / Produccion,/ Joya / Stock,07,Materiales de Ferreteria y Construccion,107-0121-01,Caja,TIZA EN PALOTES,2018-12-31,2018-12-31,,Joya\OUT\09151,,,Joya\OUT\09151,GAVINO FELICIANO (TRB) CALISAYA RODRIGUEZ,0,2.000000,-4.000000,0,0,0.000000,0.000000,0,"",252401 - Materiales de Ferreteria y Construccion,20.03.03 CHANCADO,"",,,,2018-12-31,
Physical Locations / Joya / Stock,Ubicaciones virtuales / Produccion,/ Joya / Stock,07,Materiales de Ferreteria y Construccion,107-0122-01,Caja,TIZA EN PALOTES DE COLOR,2018-12-03,2018-12-03,,Joya\OUT\08786,,,Joya\OUT\08786,GAVINO FELICIANO (TRB) CALISAYA RODRIGUEZ,0,2.000000,-2.000000,0,0,0.000000,0.000000,0,"",252401 - Materiales de Ferreteria y Construccion,20.03.03 CHANCADO,"",,,,2018-12-03,
Physical Locations / Joya / Stock,Ubicaciones virtuales / Produccion,/ Joya / Stock,07,Materiales de Ferreteria y Construccion,107-0122-01,Caja,TIZA EN PALOTES DE COLOR,2018-12-08,2018-12-08,,Joya\OUT\08841,,,Joya\OUT\08841,Harold Zambrano,0,1.000000,-3.000000,0,0,0.000000,0.000000,0,"",252401 - Materiales de Ferreteria y Construccion,20.03.03 CHANCADO,"",,,,,
Physical Locations / Joya / Stock,Ubicaciones virtuales / Produccion,/ Joya / Stock,07,Materiales de Ferreteria y Construccion,107-0122-01,Caja,TIZA EN PALOTES DE COLOR,2018-12-31,2018-12-31,,Joya\OUT\09151,,,Joya\OUT\09151,GAVINO FELICIANO (TRB) CALISAYA RODRIGUEZ,0,2.000000,-5.000000,0,0,0.000000,0.000000,0,"",252401 - Materiales de Ferreteria y Construccion,20.03.03 CHANCADO,"",,,,2018-12-31,
Physical Locations / Joya / Stock,Ubicaciones virtuales / Produccion,/ Joya / Stock,07,Materiales de Ferreteria y Construccion,107-0123-01,Unit(s),TRIZ,2018-12-16,2018-12-16,,Joya\OUT\08927,,,Joya\OUT\08927,Harold Zambrano,0,1.000000,-1.000000,0,0,0.000000,0.000000,0,"",252401 - Materiales de Ferreteria y Construccion,"22.01.29	DEPRECIACION DESORCION, FUNDICION Y REFINACION","",,,,,
Physical Locations / Joya / Stock,Ubicaciones virtuales / Produccion,/ Joya / Stock,07,Materiales de Ferreteria y Construccion,107-0123-01,Unit(s),TRIZ,2018-12-30,2018-12-30,,Joya\OUT\09085,,,Joya\OUT\09085,JOSE SANTOS MATTA BORJAS,0,2.000000,-3.000000,0,0,0.000000,0.000000,0,"",252401 - Materiales de Ferreteria y Construccion,21.02.01 LIXIVIACIÓN Y ABSORCION,"",,,,,
Physical Locations / Joya / Stock,Ubicaciones virtuales / Produccion,/ Joya / Stock,07,Uniformes e Implementos de Seguridad,110-0001-01,Unit(s),ADAPTADOR 501,2018-12-28,2018-12-28,,Joya\OUT\09057,,,Joya\OUT\09057,LUZ ESTHER CHAÑI CUTIRE,0,2.000000,-2.000000,0,0,0.000000,0.000000,0,"",252403 - Uniforme e Implemento de Seguridad,25.01.03 TALLER DE MANTENIMIENTO,"",,,,,
Physical Locations / Joya / Stock,Ubicaciones virtuales / Produccion,/ Joya / Stock,07,Uniformes e Implementos de Seguridad,110-0001-01,Unit(s),ADAPTADOR 501,2018-12-28,2018-12-28,,Joya\OUT\09061,,,Joya\OUT\09061,LUZ ESTHER CHAÑI CUTIRE,0,2.000000,-4.000000,0,0,0.000000,0.000000,0,"",252403 - Uniforme e Implemento de Seguridad,25.01.03 TALLER DE MANTENIMIENTO,"",,,,,
Physical Locations / Joya / Stock,Ubicaciones virtuales / Produccion,/ Joya / Stock,07,Uniformes e Implementos de Seguridad,110-0002-01,Unit(s),ADAPTADOR 502,2018-12-05,2018-12-05,,Joya\OUT\08810,,,Joya\OUT\08810,LUZ ESTHER CHAÑI CUTIRE,0,1.000000,-1.000000,0,0,0.000000,0.000000,0,"",252403 - Uniforme e Implemento de Seguridad,20.05.02 LABORATORIO QUIMICO,"",,,,,
Physical Locations / Joya / Stock,Ubicaciones virtuales / Produccion,/ Joya / Stock,07,Uniformes e Implementos de Seguridad,110-0002-01,Unit(s),ADAPTADOR 502,2018-12-07,2018-12-07,,Joya\OUT\08825,,,Joya\OUT\08825,LUZ ESTHER CHAÑI CUTIRE,0,1.000000,-2.000000,0,0,0.000000,0.000000,0,"",252403 - Uniforme e Implemento de Seguridad,20.03.03 CHANCADO,"",,,,,
Physical Locations / Joya / Stock,Ubicaciones virtuales / Produccion,/ Joya / Stock,07,Uniformes e Implementos de Seguridad,110-0002-01,Unit(s),ADAPTADOR 502,2018-12-12,2018-12-12,,Joya\OUT\08872,,,Joya\OUT\08872,LUZ ESTHER CHAÑI CUTIRE,0,1.000000,-3.000000,0,0,0.000000,0.000000,0,"",252403 - Uniforme e Implemento de Seguridad,20.03.03 CHANCADO,"",,,,,
Physical Locations / Joya / Stock,Ubicaciones virtuales / Produccion,/ Joya / Stock,07,Uniformes e Implementos de Seguridad,110-0002-01,Unit(s),ADAPTADOR 502,2018-12-12,2018-12-12,,Joya\OUT\08886,,,Joya\OUT\08886,LUZ ESTHER CHAÑI CUTIRE,0,1.000000,-4.000000,0,0,0.000000,0.000000,0,"",252403 - Uniforme e Implemento de Seguridad,21.02.01 LIXIVIACIÓN Y ABSORCION,"",,,,,
Physical Locations / Joya / Stock,Ubicaciones virtuales / Produccion,/ Joya / Stock,07,Uniformes e Implementos de Seguridad,110-0002-01,Unit(s),ADAPTADOR 502,2018-12-12,2018-12-12,,Joya\OUT\08887,,,Joya\OUT\08887,LUZ ESTHER CHAÑI CUTIRE,0,1.000000,-5.000000,0,0,0.000000,0.000000,0,"",252403 - Uniforme e Implemento de Seguridad,23.05.01 SEGURIDAD Y MEDIO AMBIENTE,"",,,,,
Physical Locations / Joya / Stock,Ubicaciones virtuales / Produccion,/ Joya / Stock,07,Uniformes e Implementos de Seguridad,110-0002-01,Unit(s),ADAPTADOR 502,2018-12-12,2018-12-12,,Joya\OUT\08898,,,Joya\OUT\08898,LUZ ESTHER CHAÑI CUTIRE,0,1.000000,-6.000000,0,0,0.000000,0.000000,0,"",252403 - Uniforme e Implemento de Seguridad,20.05.02 LABORATORIO QUIMICO,"",,,,,
Physical Locations / Joya / Stock,Ubicaciones virtuales / Produccion,/ Joya / Stock,07,Uniformes e Implementos de Seguridad,110-0002-01,Unit(s),ADAPTADOR 502,2018-12-18,2018-12-18,,Joya\OUT\08942,,,Joya\OUT\08942,LUCIANO RUBEN VIZA CHOQUE,0,1.000000,-7.000000,0,0,0.000000,0.000000,0,"",252403 - Uniforme e Implemento de Seguridad,23.05.01 SEGURIDAD Y MEDIO AMBIENTE,"",,,,,
Physical Locations / Joya / Stock,Ubicaciones virtuales / Produccion,/ Joya / Stock,07,Uniformes e Implementos de Seguridad,110-0002-01,Unit(s),ADAPTADOR 502,2018-12-19,2018-12-19,,Joya\OUT\08964,,,Joya\OUT\08964,LUZ ESTHER CHAÑI CUTIRE,0,1.000000,-8.000000,0,0,0.000000,0.000000,0,"",252403 - Uniforme e Implemento de Seguridad,21.02.01 LIXIVIACIÓN Y ABSORCION,"",,,,,
Physical Locations / Joya / Stock,Ubicaciones virtuales / Produccion,/ Joya / Stock,07,Uniformes e Implementos de Seguridad,110-0002-01,Unit(s),ADAPTADOR 502,2018-12-20,2018-12-20,,Joya\OUT\08981,,,Joya\OUT\08981,LUZ ESTHER CHAÑI CUTIRE,0,2.000000,-10.000000,0,0,0.000000,0.000000,0,"",252403 - Uniforme e Implemento de Seguridad,20.03.03 CHANCADO,"",,,,,
Physical Locations / Joya / Stock,Ubicaciones virtuales / Produccion,/ Joya / Stock,08,Uniformes e Implementos de Seguridad,110-0002-01,Unit(s),ADAPTADOR 502,2018-12-23,2018-12-23,,Joya\OUT\09015,,,Joya\OUT\09015,LUCIANO RUBEN VIZA CHOQUE,0,1.000000,-11.000000,0,0,0.000000,0.000000,0,"",252403 - Uniforme e Implemento de Seguridad,"01.01.11	GESTION PLANTA,COMERCIAL Y ADMIN.","",,,,,
Physical Locations / Joya / Stock,Ubicaciones virtuales / Produccion,/ Joya / Stock,07,Uniformes e Implementos de Seguridad,110-0002-01,Unit(s),ADAPTADOR 502,2018-12-24,2018-12-24,,Joya\OUT\09029,,,Joya\OUT\09029,LUZ ESTHER CHAÑI CUTIRE,0,2.000000,-13.000000,0,0,0.000000,0.000000,0,"",252403 - Uniforme e Implemento de Seguridad,29.01.81 MEJORAS EN SISTEMA DE ELECTRODEPOSICION Y MEJORAS SISTEMA DE COSECHAS DE CARBÓN,"",,,,,
Physical Locations / Joya / Stock,Ubicaciones virtuales / Produccion,/ Joya / Stock,07,Uniformes e Implementos de Seguridad,110-0002-01,Unit(s),ADAPTADOR 502,2018-12-26,2018-12-26,,Joya\OUT\09040,,,Joya\OUT\09040,LUZ ESTHER CHAÑI CUTIRE,0,1.000000,-14.000000,0,0,0.000000,0.000000,0,"",252403 - Uniforme e Implemento de Seguridad,20.03.03 CHANCADO,"",,,,,
Physical Locations / Joya / Stock,Ubicaciones virtuales / Produccion,/ Joya / Stock,07,Uniformes e Implementos de Seguridad,110-0002-01,Unit(s),ADAPTADOR 502,2018-12-26,2018-12-26,,Joya\OUT\09043,,,Joya\OUT\09043,LUZ ESTHER CHAÑI CUTIRE,0,2.000000,-16.000000,0,0,0.000000,0.000000,0,"",252403 - Uniforme e Implemento de Seguridad,22.01.03 DESORCIÓN,"",,,,,
Physical Locations / Joya / Stock,Ubicaciones virtuales / Produccion,/ Joya / Stock,08,Uniformes e Implementos de Seguridad,110-0002-01,Unit(s),ADAPTADOR 502,2018-12-26,2018-12-26,,Joya\OUT\09049,,,Joya\OUT\09049,LUCIANO RUBEN VIZA CHOQUE,0,1.000000,-17.000000,0,0,0.000000,0.000000,0,"",252403 - Uniforme e Implemento de Seguridad,20.05.02 LABORATORIO QUIMICO,"",,,,,
Physical Locations / Joya / Stock,Ubicaciones virtuales / Produccion,/ Joya / Stock,07,Uniformes e Implementos de Seguridad,110-0004-01,Unit(s),BARBIQUEJO ELASTICO CON MENTONERA PLASTICA Y GANCHO ,2018-12-19,2018-12-19,,Joya\OUT\08964,,,Joya\OUT\08964,LUZ ESTHER CHAÑI CUTIRE,0,1.000000,-1.000000,0,0,0.000000,0.000000,0,"",252403 - Uniforme e Implemento de Seguridad,21.02.01 LIXIVIACIÓN Y ABSORCION,"",,,,,
Physical Locations / Joya / Stock,Ubicaciones virtuales / Produccion,/ Joya / Stock,07,Uniformes e Implementos de Seguridad,110-0004-01,Unit(s),BARBIQUEJO ELASTICO CON MENTONERA PLASTICA Y GANCHO ,2018-12-20,2018-12-20,,Joya\OUT\08985,,,Joya\OUT\08985,LUCIANO RUBEN VIZA CHOQUE,0,1.000000,-2.000000,0,0,0.000000,0.000000,0,"",252403 - Uniforme e Implemento de Seguridad,20.03.03 CHANCADO,"",,,,,
Partner Locations / Suppliers,Physical Locations / Joya / Stock,/ Joya / Stock,03,Uniformes e Implementos de Seguridad,110-0005-04,Par,BOTAS DE SEGURIDAD TALLA 40,2018-12-01,2018-12-01,12/2018,Joya\IN\02930,01,0002,0003194,ESTHER SANDRA PINEDA LOAYZA,4.000000,0,4.000000,65.2550000000000000,261.02,0,261.02,65.2550000000000000,603203 - Uniforme e Implemento de Seguridad,252403 - Uniforme e Implemento de Seguridad,,"",,18PO06647,LM-001642,,
Partner Locations / Suppliers,Physical Locations / Joya / Stock,/ Joya / Stock,03,Uniformes e Implementos de Seguridad,110-0005-04,Par,BOTAS DE SEGURIDAD TALLA 40,2018-12-08,2018-12-08,12/2018,Joya\IN\02893,01,0002,0003157,ESTHER SANDRA PINEDA LOAYZA,4.000000,0,8.000000,0.00000000000000000000,0,0,261.02,32.6275000000000000,,252403 - Uniforme e Implemento de Seguridad,,"",,18PO06446,LM-001560,2018-12-08,
Physical Locations / Joya / Stock,Ubicaciones virtuales / Produccion,/ Joya / Stock,07,Uniformes e Implementos de Seguridad,110-0005-04,Par,BOTAS DE SEGURIDAD TALLA 40,2018-12-11,2018-12-11,,Joya\OUT\08866,,,Joya\OUT\08866,LUZ ESTHER CHAÑI CUTIRE,0,1.000000,7.000000,32.6275000000000000,0,32.6275000000000000000000,228.3925000000000000000000,32.6275000000000000,"",252403 - Uniforme e Implemento de Seguridad,21.02.01 LIXIVIACIÓN Y ABSORCION,"",,,,,
Physical Locations / Joya / Stock,Ubicaciones virtuales / Produccion,/ Joya / Stock,07,Uniformes e Implementos de Seguridad,110-0005-04,Par,BOTAS DE SEGURIDAD TALLA 40,2018-12-12,2018-12-12,,Joya\OUT\08867,,,Joya\OUT\08867,LUZ ESTHER CHAÑI CUTIRE,0,1.000000,6.000000,32.6275000000000000,0,32.6275000000000000000000,195.7650000000000000000000,32.6275000000000000,"",252403 - Uniforme e Implemento de Seguridad,21.02.01 LIXIVIACIÓN Y ABSORCION,"",,,,,
Physical Locations / Joya / Stock,Ubicaciones virtuales / Produccion,/ Joya / Stock,07,Uniformes e Implementos de Seguridad,110-0005-04,Par,BOTAS DE SEGURIDAD TALLA 40,2018-12-12,2018-12-12,,Joya\OUT\08868,,,Joya\OUT\08868,LUZ ESTHER CHAÑI CUTIRE,0,1.000000,5.000000,32.6275000000000000,0,32.6275000000000000000000,163.1375000000000000000000,32.6275000000000000,"",252403 - Uniforme e Implemento de Seguridad,21.02.01 LIXIVIACIÓN Y ABSORCION,"",,,,,
Physical Locations / Joya / Stock,Ubicaciones virtuales / Produccion,/ Joya / Stock,07,Uniformes e Implementos de Seguridad,110-0005-04,Par,BOTAS DE SEGURIDAD TALLA 40,2018-12-12,2018-12-12,,Joya\OUT\08880,,,Joya\OUT\08880,LUZ ESTHER CHAÑI CUTIRE,0,1.000000,4.000000,32.6275000000000000,0,32.6275000000000000000000,130.5100000000000000000000,32.6275000000000000,"",252403 - Uniforme e Implemento de Seguridad,21.02.01 LIXIVIACIÓN Y ABSORCION,"",,,,,
Partner Locations / Suppliers,Physical Locations / Joya / Stock,/ Joya / Stock,03,Uniformes e Implementos de Seguridad,110-0006-04,Par,BOTAS DE SEGURIDAD TALLA 41,2018-12-08,2018-12-08,12/2018,Joya\IN\02893,01,0002,0003157,ESTHER SANDRA PINEDA LOAYZA,4.000000,0,4.000000,0.00000000000000000000,0,0,0,0.00000000000000000000,,252403 - Uniforme e Implemento de Seguridad,,"",,18PO06446,LM-001560,2018-12-08,
Physical Locations / Joya / Stock,Ubicaciones virtuales / Produccion,/ Joya / Stock,07,Uniformes e Implementos de Seguridad,110-0007-04,Par,BOTAS DE SEGURIDAD TALLA 42,2018-12-11,2018-12-11,,Joya\OUT\08865,,,Joya\OUT\08865,LUZ ESTHER CHAÑI CUTIRE,0,1.000000,-1.000000,0,0,0.000000,0.000000,0,"",252403 - Uniforme e Implemento de Seguridad,"01.01.11	GESTION PLANTA,COMERCIAL Y ADMIN.","",,,,,
Partner Locations / Suppliers,Physical Locations / Joya / Stock,/ Joya / Stock,03,Uniformes e Implementos de Seguridad,110-0010-01,Par,CARTUCHOS 6003/07047,2018-12-01,2018-12-01,12/2018,Joya\IN\02929,01,0002,0003195,ESTHER SANDRA PINEDA LOAYZA,24.000000,0,24.000000,31.3558333333333333,752.54,0,752.54,31.3558333333333333,603203 - Uniforme e Implemento de Seguridad,252403 - Uniforme e Implemento de Seguridad,,"",,18PO06653,LM-001642,2018-12-01,
Physical Locations / Joya / Stock,Ubicaciones virtuales / Produccion,/ Joya / Stock,07,Uniformes e Implementos de Seguridad,110-0010-01,Par,CARTUCHOS 6003/07047,2018-12-07,2018-12-07,,Joya\OUT\08825,,,Joya\OUT\08825,LUZ ESTHER CHAÑI CUTIRE,0,1.000000,23.000000,31.3558333333333333,0,31.3558333333333333000000,721.1841666666666667000000,31.3558333333333333,"",252403 - Uniforme e Implemento de Seguridad,20.03.03 CHANCADO,"",,,,,
Physical Locations / Joya / Stock,Ubicaciones virtuales / Produccion,/ Joya / Stock,07,Uniformes e Implementos de Seguridad,110-0010-01,Par,CARTUCHOS 6003/07047,2018-12-12,2018-12-12,,Joya\OUT\08870,,,Joya\OUT\08870,LUZ ESTHER CHAÑI CUTIRE,0,1.000000,22.000000,31.3558333333333333,0,31.3558333333333333000000,689.8283333333333334000000,31.3558333333333333,"",252403 - Uniforme e Implemento de Seguridad,20.03.03 CHANCADO,"",,,,,
Physical Locations / Joya / Stock,Ubicaciones virtuales / Produccion,/ Joya / Stock,07,Uniformes e Implementos de Seguridad,110-0010-01,Par,CARTUCHOS 6003/07047,2018-12-12,2018-12-12,,Joya\OUT\08872,,,Joya\OUT\08872,LUZ ESTHER CHAÑI CUTIRE,0,1.000000,21.000000,31.3558333333333333,0,31.3558333333333333000000,658.4725000000000001000000,31.3558333333333333,"",252403 - Uniforme e Implemento de Seguridad,20.03.03 CHANCADO,"",,,,,
Physical Locations / Joya / Stock,Ubicaciones virtuales / Produccion,/ Joya / Stock,07,Uniformes e Implementos de Seguridad,110-0010-01,Par,CARTUCHOS 6003/07047,2018-12-12,2018-12-12,,Joya\OUT\08881,,,Joya\OUT\08881,LUZ ESTHER CHAÑI CUTIRE,0,1.000000,20.000000,31.3558333333333333,0,31.3558333333333333000000,627.1166666666666668000000,31.3558333333333333,"",252403 - Uniforme e Implemento de Seguridad,20.03.03 CHANCADO,"",,,,,
Physical Locations / Joya / Stock,Ubicaciones virtuales / Produccion,/ Joya / Stock,07,Uniformes e Implementos de Seguridad,110-0010-01,Par,CARTUCHOS 6003/07047,2018-12-12,2018-12-12,,Joya\OUT\08903,,,Joya\OUT\08903,LUZ ESTHER CHAÑI CUTIRE,0,1.000000,19.000000,31.3558333333333333,0,31.3558333333333333000000,595.7608333333333335000000,31.3558333333333333,"",252403 - Uniforme e Implemento de Seguridad,21.02.01 LIXIVIACIÓN Y ABSORCION,"",,,,,
Physical Locations / Joya / Stock,Ubicaciones virtuales / Produccion,/ Joya / Stock,07,Uniformes e Implementos de Seguridad,110-0010-01,Par,CARTUCHOS 6003/07047,2018-12-18,2018-12-18,,Joya\OUT\08942,,,Joya\OUT\08942,LUCIANO RUBEN VIZA CHOQUE,0,1.000000,18.000000,31.3558333333333333,0,31.3558333333333333000000,564.4050000000000002000000,31.3558333333333333,"",252403 - Uniforme e Implemento de Seguridad,23.05.01 SEGURIDAD Y MEDIO AMBIENTE,"",,,,,
Physical Locations / Joya / Stock,Ubicaciones virtuales / Produccion,/ Joya / Stock,07,Uniformes e Implementos de Seguridad,110-0010-01,Par,CARTUCHOS 6003/07047,2018-12-19,2018-12-19,,Joya\OUT\08964,,,Joya\OUT\08964,LUZ ESTHER CHAÑI CUTIRE,0,1.000000,17.000000,31.3558333333333333,0,31.3558333333333333000000,533.0491666666666669000000,31.3558333333333333,"",252403 - Uniforme e Implemento de Seguridad,21.02.01 LIXIVIACIÓN Y ABSORCION,"",,,,,
Physical Locations / Joya / Stock,Ubicaciones virtuales / Produccion,/ Joya / Stock,07,Uniformes e Implementos de Seguridad,110-0010-01,Par,CARTUCHOS 6003/07047,2018-12-19,2018-12-19,,Joya\OUT\08972,,,Joya\OUT\08972,LUZ ESTHER CHAÑI CUTIRE,0,1.000000,16.000000,31.3558333333333333,0,31.3558333333333333000000,501.6933333333333336000000,31.3558333333333333,"",252403 - Uniforme e Implemento de Seguridad,21.02.01 LIXIVIACIÓN Y ABSORCION,"",,,,,
Physical Locations / Joya / Stock,Ubicaciones virtuales / Produccion,/ Joya / Stock,07,Uniformes e Implementos de Seguridad,110-0010-01,Par,CARTUCHOS 6003/07047,2018-12-20,2018-12-20,,Joya\OUT\08981,,,Joya\OUT\08981,LUZ ESTHER CHAÑI CUTIRE,0,1.000000,15.000000,31.3558333333333333,0,31.3558333333333333000000,470.3375000000000003000000,31.3558333333333333,"",252403 - Uniforme e Implemento de Seguridad,20.03.03 CHANCADO,"",,,,,
Physical Locations / Joya / Stock,Ubicaciones virtuales / Produccion,/ Joya / Stock,07,Uniformes e Implementos de Seguridad,110-0010-01,Par,CARTUCHOS 6003/07047,2018-12-24,2018-12-24,,Joya\OUT\09029,,,Joya\OUT\09029,LUZ ESTHER CHAÑI CUTIRE,0,1.000000,14.000000,31.3558333333333333,0,31.3558333333333333000000,438.9816666666666670000000,31.3558333333333333,"",252403 - Uniforme e Implemento de Seguridad,29.01.81 MEJORAS EN SISTEMA DE ELECTRODEPOSICION Y MEJORAS SISTEMA DE COSECHAS DE CARBÓN,"",,,,,
Physical Locations / Joya / Stock,Ubicaciones virtuales / Produccion,/ Joya / Stock,07,Uniformes e Implementos de Seguridad,110-0010-01,Par,CARTUCHOS 6003/07047,2018-12-26,2018-12-26,,Joya\OUT\09040,,,Joya\OUT\09040,LUZ ESTHER CHAÑI CUTIRE,0,1.000000,13.000000,31.3558333333333333,0,31.3558333333333333000000,407.6258333333333337000000,31.3558333333333333,"",252403 - Uniforme e Implemento de Seguridad,20.03.03 CHANCADO,"",,,,,
Physical Locations / Joya / Stock,Ubicaciones virtuales / Produccion,/ Joya / Stock,07,Uniformes e Implementos de Seguridad,110-0010-01,Par,CARTUCHOS 6003/07047,2018-12-28,2018-12-28,,Joya\OUT\09057,,,Joya\OUT\09057,LUZ ESTHER CHAÑI CUTIRE,0,1.000000,12.000000,31.3558333333333333,0,31.3558333333333333000000,376.2700000000000004000000,31.3558333333333333,"",252403 - Uniforme e Implemento de Seguridad,25.01.03 TALLER DE MANTENIMIENTO,"",,,,,
Physical Locations / Joya / Stock,Ubicaciones virtuales / Produccion,/ Joya / Stock,07,Uniformes e Implementos de Seguridad,110-0010-01,Par,CARTUCHOS 6003/07047,2018-12-28,2018-12-28,,Joya\OUT\09061,,,Joya\OUT\09061,LUZ ESTHER CHAÑI CUTIRE,0,1.000000,11.000000,31.3558333333333333,0,31.3558333333333333000000,344.9141666666666671000000,31.3558333333333333,"",252403 - Uniforme e Implemento de Seguridad,25.01.03 TALLER DE MANTENIMIENTO,"",,,,,
Partner Locations / Suppliers,Physical Locations / Joya / Stock,/ Joya / Stock,03,Uniformes e Implementos de Seguridad,110-0011-01,Par,CARTUCHOS 6009S,2018-12-01,2018-12-01,12/2018,Joya\IN\02853,01,0002,0003054,ESTHER SANDRA PINEDA LOAYZA,9.000000,0,9.000000,86.4411111111111111,777.97,0,777.97,86.4411111111111111,603203 - Uniforme e Implemento de Seguridad,252403 - Uniforme e Implemento de Seguridad,,"",,18PO06191,LM-001467,2018-12-01,
Physical Locations / Joya / Stock,Ubicaciones virtuales / Produccion,/ Joya / Stock,07,Uniformes e Implementos de Seguridad,110-0011-01,Par,CARTUCHOS 6009S,2018-12-05,2018-12-05,,Joya\OUT\08810,,,Joya\OUT\08810,LUZ ESTHER CHAÑI CUTIRE,0,1.000000,8.000000,86.4411111111111111,0,86.4411111111111111000000,691.5288888888888889000000,86.4411111111111111,"",252403 - Uniforme e Implemento de Seguridad,20.05.02 LABORATORIO QUIMICO,"",,,,,
Physical Locations / Joya / Stock,Ubicaciones virtuales / Produccion,/ Joya / Stock,07,Uniformes e Implementos de Seguridad,110-0011-01,Par,CARTUCHOS 6009S,2018-12-10,2018-12-10,,Joya\OUT\08860,,,Joya\OUT\08860,LUZ ESTHER CHAÑI CUTIRE,0,1.000000,7.000000,86.4411111111111111,0,86.4411111111111111000000,605.0877777777777778000000,86.4411111111111111,"",252403 - Uniforme e Implemento de Seguridad,20.05.02 LABORATORIO QUIMICO,"",,,,,
Physical Locations / Joya / Stock,Ubicaciones virtuales / Produccion,/ Joya / Stock,07,Uniformes e Implementos de Seguridad,110-0011-01,Par,CARTUCHOS 6009S,2018-12-12,2018-12-12,,Joya\OUT\08874,,,Joya\OUT\08874,LUZ ESTHER CHAÑI CUTIRE,0,1.000000,6.000000,86.4411111111111111,0,86.4411111111111111000000,518.6466666666666667000000,86.4411111111111111,"",252403 - Uniforme e Implemento de Seguridad,22.01.03 DESORCIÓN,"",,,,,
Physical Locations / Joya / Stock,Ubicaciones virtuales / Produccion,/ Joya / Stock,07,Uniformes e Implementos de Seguridad,110-0011-01,Par,CARTUCHOS 6009S,2018-12-12,2018-12-12,,Joya\OUT\08875,,,Joya\OUT\08875,LUZ ESTHER CHAÑI CUTIRE,0,1.000000,5.000000,86.4411111111111111,0,86.4411111111111111000000,432.2055555555555556000000,86.4411111111111111,"",252403 - Uniforme e Implemento de Seguridad,20.05.02 LABORATORIO QUIMICO,"",,,,,
Physical Locations / Joya / Stock,Ubicaciones virtuales / Produccion,/ Joya / Stock,07,Uniformes e Implementos de Seguridad,110-0011-01,Par,CARTUCHOS 6009S,2018-12-12,2018-12-12,,Joya\OUT\08877,,,Joya\OUT\08877,LUZ ESTHER CHAÑI CUTIRE,0,1.000000,4.000000,86.4411111111111111,0,86.4411111111111111000000,345.7644444444444445000000,86.4411111111111111,"",252403 - Uniforme e Implemento de Seguridad,20.05.02 LABORATORIO QUIMICO,"",,,,,
Physical Locations / Joya / Stock,Ubicaciones virtuales / Produccion,/ Joya / Stock,07,Uniformes e Implementos de Seguridad,110-0011-01,Par,CARTUCHOS 6009S,2018-12-12,2018-12-12,,Joya\OUT\08882,,,Joya\OUT\08882,LUZ ESTHER CHAÑI CUTIRE,0,1.000000,3.000000,86.4411111111111111,0,86.4411111111111111000000,259.3233333333333334000000,86.4411111111111111,"",252403 - Uniforme e Implemento de Seguridad,21.02.01 LIXIVIACIÓN Y ABSORCION,"",,,,,
Physical Locations / Joya / Stock,Ubicaciones virtuales / Produccion,/ Joya / Stock,07,Uniformes e Implementos de Seguridad,110-0011-01,Par,CARTUCHOS 6009S,2018-12-12,2018-12-12,,Joya\OUT\08886,,,Joya\OUT\08886,LUZ ESTHER CHAÑI CUTIRE,0,1.000000,2.000000,86.4411111111111111,0,86.4411111111111111000000,172.8822222222222223000000,86.4411111111111111,"",252403 - Uniforme e Implemento de Seguridad,21.02.01 LIXIVIACIÓN Y ABSORCION,"",,,,,
Physical Locations / Joya / Stock,Ubicaciones virtuales / Produccion,/ Joya / Stock,07,Uniformes e Implementos de Seguridad,110-0011-01,Par,CARTUCHOS 6009S,2018-12-12,2018-12-12,,Joya\OUT\08887,,,Joya\OUT\08887,LUZ ESTHER CHAÑI CUTIRE,0,1.000000,1.000000,86.4411111111111111,0,86.4411111111111111000000,86.4411111111111112000000,86.4411111111111111,"",252403 - Uniforme e Implemento de Seguridad,23.05.01 SEGURIDAD Y MEDIO AMBIENTE,"",,,,,
Physical Locations / Joya / Stock,Ubicaciones virtuales / Produccion,/ Joya / Stock,07,Uniformes e Implementos de Seguridad,110-0011-01,Par,CARTUCHOS 6009S,2018-12-12,2018-12-12,,Joya\OUT\08895,,,Joya\OUT\08895,LUZ ESTHER CHAÑI CUTIRE,0,1.000000,0.000000,86.4411111111111111,0,86.4411111111111111000000,0.0000000000000001000000,0,"",252403 - Uniforme e Implemento de Seguridad,20.03.03 CHANCADO,"",,,,,
Physical Locations / Joya / Stock,Ubicaciones virtuales / Produccion,/ Joya / Stock,07,Uniformes e Implementos de Seguridad,110-0011-01,Par,CARTUCHOS 6009S,2018-12-12,2018-12-12,,Joya\OUT\08897,,,Joya\OUT\08897,LUZ ESTHER CHAÑI CUTIRE,0,1.000000,-1.000000,0,0,0.000000,0.0000000000000001000000,0,"",252403 - Uniforme e Implemento de Seguridad,20.05.02 LABORATORIO QUIMICO,"",,,,,
Physical Locations / Joya / Stock,Ubicaciones virtuales / Produccion,/ Joya / Stock,07,Uniformes e Implementos de Seguridad,110-0011-01,Par,CARTUCHOS 6009S,2018-12-12,2018-12-12,,Joya\OUT\08898,,,Joya\OUT\08898,LUZ ESTHER CHAÑI CUTIRE,0,1.000000,-2.000000,0,0,0.000000,0.0000000000000001000000,0,"",252403 - Uniforme e Implemento de Seguridad,20.05.02 LABORATORIO QUIMICO,"",,,,,
Physical Locations / Joya / Stock,Ubicaciones virtuales / Produccion,/ Joya / Stock,07,Uniformes e Implementos de Seguridad,110-0011-01,Par,CARTUCHOS 6009S,2018-12-12,2018-12-12,,Joya\OUT\08901,,,Joya\OUT\08901,LUZ ESTHER CHAÑI CUTIRE,0,1.000000,-3.000000,0,0,0.000000,0.0000000000000001000000,0,"",252403 - Uniforme e Implemento de Seguridad,20.05.02 LABORATORIO QUIMICO,"",,,,,
Physical Locations / Joya / Stock,Ubicaciones virtuales / Produccion,/ Joya / Stock,07,Uniformes e Implementos de Seguridad,110-0011-01,Par,CARTUCHOS 6009S,2018-12-12,2018-12-12,,Joya\OUT\08902,,,Joya\OUT\08902,LUZ ESTHER CHAÑI CUTIRE,0,1.000000,-4.000000,0,0,0.000000,0.0000000000000001000000,0,"",252403 - Uniforme e Implemento de Seguridad,20.05.02 LABORATORIO QUIMICO,"",,,,,
Physical Locations / Joya / Stock,Ubicaciones virtuales / Produccion,/ Joya / Stock,07,Uniformes e Implementos de Seguridad,110-0011-01,Par,CARTUCHOS 6009S,2018-12-19,2018-12-19,,Joya\OUT\08948,,,Joya\OUT\08948,LUZ ESTHER CHAÑI CUTIRE,0,1.000000,-5.000000,0,0,0.000000,0.0000000000000001000000,0,"",252403 - Uniforme e Implemento de Seguridad,20.03.03 CHANCADO,"",,,,,
Physical Locations / Joya / Stock,Ubicaciones virtuales / Produccion,/ Joya / Stock,08,Uniformes e Implementos de Seguridad,110-0011-01,Par,CARTUCHOS 6009S,2018-12-23,2018-12-23,,Joya\OUT\09014,,,Joya\OUT\09014,LUCIANO RUBEN VIZA CHOQUE,0,1.000000,-6.000000,0,0,0.000000,0.0000000000000001000000,0,"",252403 - Uniforme e Implemento de Seguridad,"01.01.11	GESTION PLANTA,COMERCIAL Y ADMIN.","",,,,,
Physical Locations / Joya / Stock,Ubicaciones virtuales / Produccion,/ Joya / Stock,07,Uniformes e Implementos de Seguridad,110-0011-01,Par,CARTUCHOS 6009S,2018-12-26,2018-12-26,,Joya\OUT\09037,,,Joya\OUT\09037,LUZ ESTHER CHAÑI CUTIRE,0,1.000000,-7.000000,0,0,0.000000,0.0000000000000001000000,0,"",252403 - Uniforme e Implemento de Seguridad,21.02.01 LIXIVIACIÓN Y ABSORCION,"",,,,,
Physical Locations / Joya / Stock,Ubicaciones virtuales / Produccion,/ Joya / Stock,08,Uniformes e Implementos de Seguridad,110-0011-01,Par,CARTUCHOS 6009S,2018-12-26,2018-12-26,,Joya\OUT\09042,,,Joya\OUT\09042,LUCIANO RUBEN VIZA CHOQUE,0,1.000000,-8.000000,0,0,0.000000,0.0000000000000001000000,0,"",252403 - Uniforme e Implemento de Seguridad,20.03.03 CHANCADO,"",,,,,
Physical Locations / Joya / Stock,Ubicaciones virtuales / Produccion,/ Joya / Stock,08,Uniformes e Implementos de Seguridad,110-0011-01,Par,CARTUCHOS 6009S,2018-12-26,2018-12-26,,Joya\OUT\09049,,,Joya\OUT\09049,LUCIANO RUBEN VIZA CHOQUE,0,1.000000,-9.000000,0,0,0.000000,0.0000000000000001000000,0,"",252403 - Uniforme e Implemento de Seguridad,20.05.02 LABORATORIO QUIMICO,"",,,,,
Partner Locations / Suppliers,Physical Locations / Joya / Stock,/ Joya / Stock,03,Uniformes e Implementos de Seguridad,110-0011-01,Par,CARTUCHOS 6009S,2018-12-28,2018-12-28,12/2018,Joya\IN\02949,01,0002,0003181,ESTHER SANDRA PINEDA LOAYZA,18.000000,0,9.000000,86.4405555555555556,1555.93,0,1555.9300000000000001000000,172.8811111111111111222222,603203 - Uniforme e Implemento de Seguridad,252403 - Uniforme e Implemento de Seguridad,,"",,19PO00028,LM-001642,2018-12-28,
Partner Locations / Suppliers,Physical Locations / Joya / Stock,/ Joya / Stock,03,Uniformes e Implementos de Seguridad,110-0013-12,Unit(s),CASCO BLANCO,2018-12-01,2018-12-01,12/2018,Joya\IN\02929,01,0002,0003195,ESTHER SANDRA PINEDA LOAYZA,5.000000,0,5.000000,32.2040000000000000,161.02,0,161.02,32.2040000000000000,603203 - Uniforme e Implemento de Seguridad,252403 - Uniforme e Implemento de Seguridad,,"",,18PO06653,LM-001642,2018-12-01,
Physical Locations / Joya / Stock,Ubicaciones virtuales / Produccion,/ Joya / Stock,07,Uniformes e Implementos de Seguridad,110-0013-12,Unit(s),CASCO BLANCO,2018-12-04,2018-12-04,,Joya\OUT\08802,,,Joya\OUT\08802,GAVINO FELICIANO (TRB) CALISAYA RODRIGUEZ,0,1.000000,4.000000,32.2040000000000000,0,32.2040000000000000000000,128.8160000000000000000000,32.2040000000000000,"",252403 - Uniforme e Implemento de Seguridad,01.01.05 LOGISTICA,"",,,,2018-12-04,
Physical Locations / Joya / Stock,Ubicaciones virtuales / Produccion,/ Joya / Stock,07,Uniformes e Implementos de Seguridad,110-0013-12,Unit(s),CASCO BLANCO,2018-12-18,2018-12-18,,Joya\OUT\08942,,,Joya\OUT\08942,LUCIANO RUBEN VIZA CHOQUE,0,1.000000,3.000000,32.2040000000000000,0,32.2040000000000000000000,96.6120000000000000000000,32.2040000000000000,"",252403 - Uniforme e Implemento de Seguridad,23.05.01 SEGURIDAD Y MEDIO AMBIENTE,"",,,,,
Physical Locations / Joya / Stock,Ubicaciones virtuales / Produccion,/ Joya / Stock,07,Uniformes e Implementos de Seguridad,110-0013-12,Unit(s),CASCO BLANCO,2018-12-21,2018-12-21,,Joya\OUT\08988,,,Joya\OUT\08988,LUCIANO RUBEN VIZA CHOQUE,0,1.000000,2.000000,32.2040000000000000,0,32.2040000000000000000000,64.4080000000000000000000,32.2040000000000000,"",252403 - Uniforme e Implemento de Seguridad,"22.01.29	DEPRECIACION DESORCION, FUNDICION Y REFINACION","",,,,,
Physical Locations / Joya / Stock,Ubicaciones virtuales / Produccion,/ Joya / Stock,07,Uniformes e Implementos de Seguridad,110-0013-12,Unit(s),CASCO BLANCO,2018-12-30,2018-12-30,,Joya\OUT\08911,,,Joya\OUT\08911,LUZ ESTHER CHAÑI CUTIRE,0,1.000000,1.000000,32.2040000000000000,0,32.2040000000000000000000,32.2040000000000000000000,32.2040000000000000,"",252403 - Uniforme e Implemento de Seguridad,23.02.01 ALMACENES,"",,,,2018-12-30,
Physical Locations / Joya / Stock,Ubicaciones virtuales / Produccion,/ Joya / Stock,07,Uniformes e Implementos de Seguridad,110-0013-12,Unit(s),CASCO BLANCO,2018-12-30,2018-12-30,,Joya\OUT\09084,,,Joya\OUT\09084,LUZ ESTHER CHAÑI CUTIRE,0,1.000000,0.000000,32.2040000000000000,0,32.2040000000000000000000,0.0000000000000000000000,0,"",252403 - Uniforme e Implemento de Seguridad,21.02.01 LIXIVIACIÓN Y ABSORCION,"",,,,,
Physical Locations / Joya / Stock,Ubicaciones virtuales / Produccion,/ Joya / Stock,07,Uniformes e Implementos de Seguridad,110-0015-12,Unit(s),CASCO PLOMO,2018-12-07,2018-12-07,,Joya\OUT\08825,,,Joya\OUT\08825,LUZ ESTHER CHAÑI CUTIRE,0,1.000000,-1.000000,0,0,0.000000,0.000000,0,"",252403 - Uniforme e Implemento de Seguridad,20.03.03 CHANCADO,"",,,,,
Physical Locations / Joya / Stock,Ubicaciones virtuales / Produccion,/ Joya / Stock,07,Uniformes e Implementos de Seguridad,110-0015-12,Unit(s),CASCO PLOMO,2018-12-07,2018-12-07,,Joya\OUT\08831,,,Joya\OUT\08831,LUZ ESTHER CHAÑI CUTIRE,0,1.000000,-2.000000,0,0,0.000000,0.000000,0,"",252403 - Uniforme e Implemento de Seguridad,20.03.03 CHANCADO,"",,,,,
Physical Locations / Joya / Stock,Ubicaciones virtuales / Produccion,/ Joya / Stock,07,Uniformes e Implementos de Seguridad,110-0015-12,Unit(s),CASCO PLOMO,2018-12-19,2018-12-19,,Joya\OUT\08951,,,Joya\OUT\08951,LUZ ESTHER CHAÑI CUTIRE,0,1.000000,-3.000000,0,0,0.000000,0.000000,0,"",252403 - Uniforme e Implemento de Seguridad,20.03.03 CHANCADO,"",,,,,
Physical Locations / Joya / Stock,Ubicaciones virtuales / Produccion,/ Joya / Stock,07,Uniformes e Implementos de Seguridad,110-0015-12,Unit(s),CASCO PLOMO,2018-12-19,2018-12-19,,Joya\OUT\08952,,,Joya\OUT\08952,LUZ ESTHER CHAÑI CUTIRE,0,1.000000,-4.000000,0,0,0.000000,0.000000,0,"",252403 - Uniforme e Implemento de Seguridad,20.03.03 CHANCADO,"",,,,,
Physical Locations / Joya / Stock,Ubicaciones virtuales / Produccion,/ Joya / Stock,07,Uniformes e Implementos de Seguridad,110-0015-12,Unit(s),CASCO PLOMO,2018-12-19,2018-12-19,,Joya\OUT\08964,,,Joya\OUT\08964,LUZ ESTHER CHAÑI CUTIRE,0,1.000000,-5.000000,0,0,0.000000,0.000000,0,"",252403 - Uniforme e Implemento de Seguridad,21.02.01 LIXIVIACIÓN Y ABSORCION,"",,,,,
Physical Locations / Joya / Stock,Ubicaciones virtuales / Produccion,/ Joya / Stock,07,Uniformes e Implementos de Seguridad,110-0015-12,Unit(s),CASCO PLOMO,2018-12-20,2018-12-20,,Joya\OUT\08981,,,Joya\OUT\08981,LUZ ESTHER CHAÑI CUTIRE,0,1.000000,-6.000000,0,0,0.000000,0.000000,0,"",252403 - Uniforme e Implemento de Seguridad,20.03.03 CHANCADO,"",,,,,
Physical Locations / Joya / Stock,Ubicaciones virtuales / Produccion,/ Joya / Stock,07,Uniformes e Implementos de Seguridad,110-0015-12,Unit(s),CASCO PLOMO,2018-12-24,2018-12-24,,Joya\OUT\09029,,,Joya\OUT\09029,LUZ ESTHER CHAÑI CUTIRE,0,1.000000,-7.000000,0,0,0.000000,0.000000,0,"",252403 - Uniforme e Implemento de Seguridad,29.01.81 MEJORAS EN SISTEMA DE ELECTRODEPOSICION Y MEJORAS SISTEMA DE COSECHAS DE CARBÓN,"",,,,,
Physical Locations / Joya / Stock,Ubicaciones virtuales / Produccion,/ Joya / Stock,07,Uniformes e Implementos de Seguridad,110-0015-12,Unit(s),CASCO PLOMO,2018-12-26,2018-12-26,,Joya\OUT\09040,,,Joya\OUT\09040,LUZ ESTHER CHAÑI CUTIRE,0,1.000000,-8.000000,0,0,0.000000,0.000000,0,"",252403 - Uniforme e Implemento de Seguridad,20.03.03 CHANCADO,"",,,,,
Physical Locations / Joya / Stock,Ubicaciones virtuales / Produccion,/ Joya / Stock,07,Uniformes e Implementos de Seguridad,110-0015-12,Unit(s),CASCO PLOMO,2018-12-28,2018-12-28,,Joya\OUT\09061,,,Joya\OUT\09061,LUZ ESTHER CHAÑI CUTIRE,0,1.000000,-9.000000,0,0,0.000000,0.000000,0,"",252403 - Uniforme e Implemento de Seguridad,25.01.03 TALLER DE MANTENIMIENTO,"",,,,,
Partner Locations / Suppliers,Physical Locations / Joya / Stock,/ Joya / Stock,03,Uniformes e Implementos de Seguridad,110-0022-06,Unit(s),CHALECO NARANJA L,2018-12-08,2018-12-08,12/2018,Joya\IN\02888,01,0002,0003155,ESTHER SANDRA PINEDA LOAYZA,5.000000,0,5.000000,18.6440000000000000,93.22,0,93.22,18.6440000000000000,603203 - Uniforme e Implemento de Seguridad,252403 - Uniforme e Implemento de Seguridad,,"",,18PO06419,LM-001593,2018-12-08,
Physical Locations / Joya / Stock,Ubicaciones virtuales / Produccion,/ Joya / Stock,07,Uniformes e Implementos de Seguridad,110-0022-06,Unit(s),CHALECO NARANJA L,2018-12-21,2018-12-21,,Joya\OUT\08992,,,Joya\OUT\08992,LUZ ESTHER CHAÑI CUTIRE,0,3.000000,2.000000,18.6440000000000000,0,55.9320000000000000000000,37.2880000000000000000000,18.6440000000000000,"",252403 - Uniforme e Implemento de Seguridad,"01.01.11	GESTION PLANTA,COMERCIAL Y ADMIN.","",,,,,
Partner Locations / Suppliers,Physical Locations / Joya / Stock,/ Joya / Stock,03,Uniformes e Implementos de Seguridad,110-0023-06,Unit(s),CHALECO NARANJA M,2018-12-08,2018-12-08,12/2018,Joya\IN\02888,01,0002,0003155,ESTHER SANDRA PINEDA LOAYZA,5.000000,0,5.000000,18.6440000000000000,93.22,0,93.22,18.6440000000000000,603203 - Uniforme e Implemento de Seguridad,252403 - Uniforme e Implemento de Seguridad,,"",,18PO06419,LM-001593,2018-12-08,
Physical Locations / Joya / Stock,Ubicaciones virtuales / Produccion,/ Joya / Stock,07,Uniformes e Implementos de Seguridad,110-0023-06,Unit(s),CHALECO NARANJA M,2018-12-18,2018-12-18,,Joya\OUT\08942,,,Joya\OUT\08942,LUCIANO RUBEN VIZA CHOQUE,0,1.000000,4.000000,18.6440000000000000,0,18.6440000000000000000000,74.5760000000000000000000,18.6440000000000000,"",252403 - Uniforme e Implemento de Seguridad,23.05.01 SEGURIDAD Y MEDIO AMBIENTE,"",,,,,
Physical Locations / Joya / Stock,Ubicaciones virtuales / Produccion,/ Joya / Stock,07,Uniformes e Implementos de Seguridad,110-0023-06,Unit(s),CHALECO NARANJA M,2018-12-19,2018-12-19,,Joya\OUT\08972,,,Joya\OUT\08972,LUZ ESTHER CHAÑI CUTIRE,0,1.000000,3.000000,18.6440000000000000,0,18.6440000000000000000000,55.9320000000000000000000,18.6440000000000000,"",252403 - Uniforme e Implemento de Seguridad,21.02.01 LIXIVIACIÓN Y ABSORCION,"",,,,,
Physical Locations / Joya / Stock,Ubicaciones virtuales / Produccion,/ Joya / Stock,07,Uniformes e Implementos de Seguridad,110-0023-06,Unit(s),CHALECO NARANJA M,2018-12-30,2018-12-30,,Joya\OUT\08911,,,Joya\OUT\08911,LUZ ESTHER CHAÑI CUTIRE,0,1.000000,2.000000,18.6440000000000000,0,18.6440000000000000000000,37.2880000000000000000000,18.6440000000000000,"",252403 - Uniforme e Implemento de Seguridad,23.02.01 ALMACENES,"",,,,2018-12-30,
Partner Locations / Suppliers,Physical Locations / Joya / Stock,/ Joya / Stock,03,Uniformes e Implementos de Seguridad,110-0024-06,Unit(s),CHALECO NARANJA S,2018-12-08,2018-12-08,12/2018,Joya\IN\02888,01,0002,0003155,ESTHER SANDRA PINEDA LOAYZA,5.000000,0,5.000000,18.6440000000000000,93.22,0,93.22,18.6440000000000000,603203 - Uniforme e Implemento de Seguridad,252403 - Uniforme e Implemento de Seguridad,,"",,18PO06419,LM-001593,2018-12-08,
Physical Locations / Joya / Stock,Ubicaciones virtuales / Produccion,/ Joya / Stock,07,Uniformes e Implementos de Seguridad,110-0024-06,Unit(s),CHALECO NARANJA S,2018-12-13,2018-12-13,,Joya\OUT\08910,,,Joya\OUT\08910,LUZ ESTHER CHAÑI CUTIRE,0,1.000000,4.000000,18.6440000000000000,0,18.6440000000000000000000,74.5760000000000000000000,18.6440000000000000,"",252403 - Uniforme e Implemento de Seguridad,23.05.01 SEGURIDAD Y MEDIO AMBIENTE,"",,,,,
Partner Locations / Suppliers,Physical Locations / Joya / Stock,/ Joya / Stock,03,Uniformes e Implementos de Seguridad,110-0027-12,Unit(s),CHOMPA JORGE CHAVEZ L,2018-12-01,2018-12-01,12/2018,Joya\IN\02932,01,0002,0003201,ESTHER SANDRA PINEDA LOAYZA,2.000000,0,2.000000,22.8800000000000000,45.76,0,45.76,22.8800000000000000,603203 - Uniforme e Implemento de Seguridad,252403 - Uniforme e Implemento de Seguridad,,"",,18PO06655,LM-001573,2018-12-01,
Physical Locations / Joya / Stock,Ubicaciones virtuales / Produccion,/ Joya / Stock,07,Uniformes e Implementos de Seguridad,110-0027-12,Unit(s),CHOMPA JORGE CHAVEZ L,2018-12-12,2018-12-12,,Joya\OUT\08896,,,Joya\OUT\08896,LUZ ESTHER CHAÑI CUTIRE,0,1.000000,1.000000,22.8800000000000000,0,22.8800000000000000000000,22.8800000000000000000000,22.8800000000000000,"",252403 - Uniforme e Implemento de Seguridad,20.02.04 BALANZA 80 TN,"",,,,,
Physical Locations / Joya / Stock,Ubicaciones virtuales / Produccion,/ Joya / Stock,07,Uniformes e Implementos de Seguridad,110-0027-12,Unit(s),CHOMPA JORGE CHAVEZ L,2018-12-29,2018-12-29,,Joya\OUT\09075,,,Joya\OUT\09075,LUZ ESTHER CHAÑI CUTIRE,0,1.000000,0.000000,22.8800000000000000,0,22.8800000000000000000000,0.0000000000000000000000,0,"",252403 - Uniforme e Implemento de Seguridad,20.03.03 CHANCADO,"",,,,,
Physical Locations / Joya / Stock,Ubicaciones virtuales / Produccion,/ Joya / Stock,07,Uniformes e Implementos de Seguridad,110-0027-12,Unit(s),CHOMPA JORGE CHAVEZ L,2018-12-29,2018-12-29,,Joya\OUT\09076,,,Joya\OUT\09076,LUZ ESTHER CHAÑI CUTIRE,0,1.000000,-1.000000,0,0,0.000000,0.0000000000000000000000,0,"",252403 - Uniforme e Implemento de Seguridad,20.03.03 CHANCADO,"",,,,,
Physical Locations / Joya / Stock,Ubicaciones virtuales / Produccion,/ Joya / Stock,07,Uniformes e Implementos de Seguridad,110-0027-12,Unit(s),CHOMPA JORGE CHAVEZ L,2018-12-30,2018-12-30,,Joya\OUT\08911,,,Joya\OUT\08911,LUZ ESTHER CHAÑI CUTIRE,0,1.000000,-2.000000,0,0,0.000000,0.0000000000000000000000,0,"",252403 - Uniforme e Implemento de Seguridad,23.02.01 ALMACENES,"",,,,2018-12-30,
Partner Locations / Suppliers,Physical Locations / Joya / Stock,/ Joya / Stock,03,Uniformes e Implementos de Seguridad,110-0028-12,Unit(s),CHOMPA JORGE CHAVEZ M,2018-12-01,2018-12-01,12/2018,Joya\IN\02932,01,0002,0003201,ESTHER SANDRA PINEDA LOAYZA,2.000000,0,2.000000,22.8800000000000000,45.76,0,45.76,22.8800000000000000,603203 - Uniforme e Implemento de Seguridad,252403 - Uniforme e Implemento de Seguridad,,"",,18PO06655,LM-001573,2018-12-01,
Physical Locations / Joya / Stock,Ubicaciones virtuales / Produccion,/ Joya / Stock,07,Uniformes e Implementos de Seguridad,110-0028-12,Unit(s),CHOMPA JORGE CHAVEZ M,2018-12-12,2018-12-12,,Joya\OUT\08904,,,Joya\OUT\08904,LUZ ESTHER CHAÑI CUTIRE,0,1.000000,1.000000,22.8800000000000000,0,22.8800000000000000000000,22.8800000000000000000000,22.8800000000000000,"",252403 - Uniforme e Implemento de Seguridad,21.02.01 LIXIVIACIÓN Y ABSORCION,"",,,,,
Physical Locations / Joya / Stock,Ubicaciones virtuales / Produccion,/ Joya / Stock,07,Uniformes e Implementos de Seguridad,110-0028-12,Unit(s),CHOMPA JORGE CHAVEZ M,2018-12-18,2018-12-18,,Joya\OUT\08942,,,Joya\OUT\08942,LUCIANO RUBEN VIZA CHOQUE,0,1.000000,0.000000,22.8800000000000000,0,22.8800000000000000000000,0.0000000000000000000000,0,"",252403 - Uniforme e Implemento de Seguridad,23.05.01 SEGURIDAD Y MEDIO AMBIENTE,"",,,,,
Physical Locations / Joya / Stock,Ubicaciones virtuales / Produccion,/ Joya / Stock,07,Uniformes e Implementos de Seguridad,110-0028-12,Unit(s),CHOMPA JORGE CHAVEZ M,2018-12-19,2018-12-19,,Joya\OUT\08951,,,Joya\OUT\08951,LUZ ESTHER CHAÑI CUTIRE,0,1.000000,-1.000000,0,0,0.000000,0.0000000000000000000000,0,"",252403 - Uniforme e Implemento de Seguridad,20.03.03 CHANCADO,"",,,,,
Physical Locations / Joya / Stock,Ubicaciones virtuales / Produccion,/ Joya / Stock,07,Uniformes e Implementos de Seguridad,110-0028-12,Unit(s),CHOMPA JORGE CHAVEZ M,2018-12-19,2018-12-19,,Joya\OUT\08952,,,Joya\OUT\08952,LUZ ESTHER CHAÑI CUTIRE,0,1.000000,-2.000000,0,0,0.000000,0.0000000000000000000000,0,"",252403 - Uniforme e Implemento de Seguridad,20.03.03 CHANCADO,"",,,,,
Physical Locations / Joya / Stock,Ubicaciones virtuales / Produccion,/ Joya / Stock,07,Uniformes e Implementos de Seguridad,110-0028-12,Unit(s),CHOMPA JORGE CHAVEZ M,2018-12-29,2018-12-29,,Joya\OUT\09074,,,Joya\OUT\09074,LUZ ESTHER CHAÑI CUTIRE,0,1.000000,-3.000000,0,0,0.000000,0.0000000000000000000000,0,"",252403 - Uniforme e Implemento de Seguridad,20.03.03 CHANCADO,"",,,,,
Physical Locations / Joya / Stock,Ubicaciones virtuales / Produccion,/ Joya / Stock,07,Uniformes e Implementos de Seguridad,110-0035-06,Unit(s),CORTAVIENTO/TAPASOL,2018-12-07,2018-12-07,,Joya\OUT\08825,,,Joya\OUT\08825,LUZ ESTHER CHAÑI CUTIRE,0,1.000000,-1.000000,0,0,0.000000,0.000000,0,"",252403 - Uniforme e Implemento de Seguridad,20.03.03 CHANCADO,"",,,,,
Physical Locations / Joya / Stock,Ubicaciones virtuales / Produccion,/ Joya / Stock,07,Uniformes e Implementos de Seguridad,110-0035-06,Unit(s),CORTAVIENTO/TAPASOL,2018-12-12,2018-12-12,,Joya\OUT\08882,,,Joya\OUT\08882,LUZ ESTHER CHAÑI CUTIRE,0,1.000000,-2.000000,0,0,0.000000,0.000000,0,"",252403 - Uniforme e Implemento de Seguridad,21.02.01 LIXIVIACIÓN Y ABSORCION,"",,,,,
Physical Locations / Joya / Stock,Ubicaciones virtuales / Produccion,/ Joya / Stock,07,Uniformes e Implementos de Seguridad,110-0035-06,Unit(s),CORTAVIENTO/TAPASOL,2018-12-12,2018-12-12,,Joya\OUT\08883,,,Joya\OUT\08883,LUZ ESTHER CHAÑI CUTIRE,0,1.000000,-3.000000,0,0,0.000000,0.000000,0,"",252403 - Uniforme e Implemento de Seguridad,20.03.03 CHANCADO,"",,,,,
Physical Locations / Joya / Stock,Ubicaciones virtuales / Produccion,/ Joya / Stock,07,Uniformes e Implementos de Seguridad,110-0035-06,Unit(s),CORTAVIENTO/TAPASOL,2018-12-19,2018-12-19,,Joya\OUT\08964,,,Joya\OUT\08964,LUZ ESTHER CHAÑI CUTIRE,0,1.000000,-4.000000,0,0,0.000000,0.000000,0,"",252403 - Uniforme e Implemento de Seguridad,21.02.01 LIXIVIACIÓN Y ABSORCION,"",,,,,
Physical Locations / Joya / Stock,Ubicaciones virtuales / Produccion,/ Joya / Stock,07,Uniformes e Implementos de Seguridad,110-0035-06,Unit(s),CORTAVIENTO/TAPASOL,2018-12-20,2018-12-20,,Joya\OUT\08981,,,Joya\OUT\08981,LUZ ESTHER CHAÑI CUTIRE,0,1.000000,-5.000000,0,0,0.000000,0.000000,0,"",252403 - Uniforme e Implemento de Seguridad,20.03.03 CHANCADO,"",,,,,
Physical Locations / Joya / Stock,Ubicaciones virtuales / Produccion,/ Joya / Stock,07,Uniformes e Implementos de Seguridad,110-0035-06,Unit(s),CORTAVIENTO/TAPASOL,2018-12-24,2018-12-24,,Joya\OUT\09029,,,Joya\OUT\09029,LUZ ESTHER CHAÑI CUTIRE,0,1.000000,-6.000000,0,0,0.000000,0.000000,0,"",252403 - Uniforme e Implemento de Seguridad,29.01.81 MEJORAS EN SISTEMA DE ELECTRODEPOSICION Y MEJORAS SISTEMA DE COSECHAS DE CARBÓN,"",,,,,
Physical Locations / Joya / Stock,Ubicaciones virtuales / Produccion,/ Joya / Stock,07,Uniformes e Implementos de Seguridad,110-0035-06,Unit(s),CORTAVIENTO/TAPASOL,2018-12-26,2018-12-26,,Joya\OUT\09040,,,Joya\OUT\09040,LUZ ESTHER CHAÑI CUTIRE,0,1.000000,-7.000000,0,0,0.000000,0.000000,0,"",252403 - Uniforme e Implemento de Seguridad,20.03.03 CHANCADO,"",,,,,
Physical Locations / Joya / Stock,Ubicaciones virtuales / Produccion,/ Joya / Stock,07,Uniformes e Implementos de Seguridad,110-0035-06,Unit(s),CORTAVIENTO/TAPASOL,2018-12-28,2018-12-28,,Joya\OUT\09061,,,Joya\OUT\09061,LUZ ESTHER CHAÑI CUTIRE,0,1.000000,-8.000000,0,0,0.000000,0.000000,0,"",252403 - Uniforme e Implemento de Seguridad,25.01.03 TALLER DE MANTENIMIENTO,"",,,,,
Physical Locations / Joya / Stock,Ubicaciones virtuales / Produccion,/ Joya / Stock,07,Uniformes e Implementos de Seguridad,110-0035-06,Unit(s),CORTAVIENTO/TAPASOL,2018-12-29,2018-12-29,,Joya\OUT\09068,,,Joya\OUT\09068,GAVINO FELICIANO (TRB) CALISAYA RODRIGUEZ,0,1.000000,-9.000000,0,0,0.000000,0.000000,0,"",252403 - Uniforme e Implemento de Seguridad,21.02.01 LIXIVIACIÓN Y ABSORCION,"",,,,2018-12-29,
Physical Locations / Joya / Stock,Ubicaciones virtuales / Produccion,/ Joya / Stock,07,Uniformes e Implementos de Seguridad,110-0036-06,Par,ESCARPIN DE CUERO CROMO,2018-12-24,2018-12-24,,Joya\OUT\09029,,,Joya\OUT\09029,LUZ ESTHER CHAÑI CUTIRE,0,1.000000,-1.000000,0,0,0.000000,0.000000,0,"",252403 - Uniforme e Implemento de Seguridad,29.01.81 MEJORAS EN SISTEMA DE ELECTRODEPOSICION Y MEJORAS SISTEMA DE COSECHAS DE CARBÓN,"",,,,,
Partner Locations / Suppliers,Physical Locations / Joya / Stock,/ Joya / Stock,03,Uniformes e Implementos de Seguridad,110-0040-01,Par,FILTRO 2097/7184 P/RESPIRADOR CONTRA POLVOS Y HUMOS 3M,2018-12-01,2018-12-01,12/2018,Joya\IN\02929,01,0002,0003195,ESTHER SANDRA PINEDA LOAYZA,18.000000,0,18.000000,22.0338888888888889,396.61,0,396.61,22.0338888888888889,603203 - Uniforme e Implemento de Seguridad,252403 - Uniforme e Implemento de Seguridad,,"",,18PO06653,LM-001642,2018-12-01,
Physical Locations / Joya / Stock,Ubicaciones virtuales / Produccion,/ Joya / Stock,07,Uniformes e Implementos de Seguridad,110-0040-01,Par,FILTRO 2097/7184 P/RESPIRADOR CONTRA POLVOS Y HUMOS 3M,2018-12-01,2018-12-01,,Joya\OUT\08769,,,Joya\OUT\08769,ERNESTO ALVAREZ OSORIO,0,1.000000,17.000000,22.0338888888888889,0,22.0338888888888889000000,374.5761111111111111000000,22.0338888888888889,"",252403 - Uniforme e Implemento de Seguridad,20.03.03 CHANCADO,"",,,,,
Physical Locations / Joya / Stock,Ubicaciones virtuales / Produccion,/ Joya / Stock,07,Uniformes e Implementos de Seguridad,110-0040-01,Par,FILTRO 2097/7184 P/RESPIRADOR CONTRA POLVOS Y HUMOS 3M,2018-12-05,2018-12-05,,Joya\OUT\08810,,,Joya\OUT\08810,LUZ ESTHER CHAÑI CUTIRE,0,1.000000,16.000000,22.0338888888888889,0,22.0338888888888889000000,352.5422222222222222000000,22.0338888888888889,"",252403 - Uniforme e Implemento de Seguridad,20.05.02 LABORATORIO QUIMICO,"",,,,,
Physical Locations / Joya / Stock,Ubicaciones virtuales / Produccion,/ Joya / Stock,07,Uniformes e Implementos de Seguridad,110-0040-01,Par,FILTRO 2097/7184 P/RESPIRADOR CONTRA POLVOS Y HUMOS 3M,2018-12-07,2018-12-07,,Joya\OUT\08825,,,Joya\OUT\08825,LUZ ESTHER CHAÑI CUTIRE,0,1.000000,15.000000,22.0338888888888889,0,22.0338888888888889000000,330.5083333333333333000000,22.0338888888888889,"",252403 - Uniforme e Implemento de Seguridad,20.03.03 CHANCADO,"",,,,,
Physical Locations / Joya / Stock,Ubicaciones virtuales / Produccion,/ Joya / Stock,07,Uniformes e Implementos de Seguridad,110-0040-01,Par,FILTRO 2097/7184 P/RESPIRADOR CONTRA POLVOS Y HUMOS 3M,2018-12-10,2018-12-10,,Joya\OUT\08854,,,Joya\OUT\08854,LUZ ESTHER CHAÑI CUTIRE,0,1.000000,14.000000,22.0338888888888889,0,22.0338888888888889000000,308.4744444444444444000000,22.0338888888888889,"",252403 - Uniforme e Implemento de Seguridad,20.03.03 CHANCADO,"",,,,,
Physical Locations / Joya / Stock,Ubicaciones virtuales / Produccion,/ Joya / Stock,07,Uniformes e Implementos de Seguridad,110-0040-01,Par,FILTRO 2097/7184 P/RESPIRADOR CONTRA POLVOS Y HUMOS 3M,2018-12-10,2018-12-10,,Joya\OUT\08860,,,Joya\OUT\08860,LUZ ESTHER CHAÑI CUTIRE,0,1.000000,13.000000,22.0338888888888889,0,22.0338888888888889000000,286.4405555555555555000000,22.0338888888888889,"",252403 - Uniforme e Implemento de Seguridad,20.05.02 LABORATORIO QUIMICO,"",,,,,
Physical Locations / Joya / Stock,Ubicaciones virtuales / Produccion,/ Joya / Stock,07,Uniformes e Implementos de Seguridad,110-0040-01,Par,FILTRO 2097/7184 P/RESPIRADOR CONTRA POLVOS Y HUMOS 3M,2018-12-12,2018-12-12,,Joya\OUT\08870,,,Joya\OUT\08870,LUZ ESTHER CHAÑI CUTIRE,0,1.000000,12.000000,22.0338888888888889,0,22.0338888888888889000000,264.4066666666666666000000,22.0338888888888889,"",252403 - Uniforme e Implemento de Seguridad,20.03.03 CHANCADO,"",,,,,
Physical Locations / Joya / Stock,Ubicaciones virtuales / Produccion,/ Joya / Stock,07,Uniformes e Implementos de Seguridad,110-0040-01,Par,FILTRO 2097/7184 P/RESPIRADOR CONTRA POLVOS Y HUMOS 3M,2018-12-12,2018-12-12,,Joya\OUT\08872,,,Joya\OUT\08872,LUZ ESTHER CHAÑI CUTIRE,0,1.000000,11.000000,22.0338888888888889,0,22.0338888888888889000000,242.3727777777777777000000,22.0338888888888889,"",252403 - Uniforme e Implemento de Seguridad,20.03.03 CHANCADO,"",,,,,
Physical Locations / Joya / Stock,Ubicaciones virtuales / Produccion,/ Joya / Stock,07,Uniformes e Implementos de Seguridad,110-0040-01,Par,FILTRO 2097/7184 P/RESPIRADOR CONTRA POLVOS Y HUMOS 3M,2018-12-12,2018-12-12,,Joya\OUT\08873,,,Joya\OUT\08873,LUZ ESTHER CHAÑI CUTIRE,0,1.000000,10.000000,22.0338888888888889,0,22.0338888888888889000000,220.3388888888888888000000,22.0338888888888889,"",252403 - Uniforme e Implemento de Seguridad,20.03.03 CHANCADO,"",,,,,
Physical Locations / Joya / Stock,Ubicaciones virtuales / Produccion,/ Joya / Stock,07,Uniformes e Implementos de Seguridad,110-0040-01,Par,FILTRO 2097/7184 P/RESPIRADOR CONTRA POLVOS Y HUMOS 3M,2018-12-12,2018-12-12,,Joya\OUT\08874,,,Joya\OUT\08874,LUZ ESTHER CHAÑI CUTIRE,0,1.000000,9.000000,22.0338888888888889,0,22.0338888888888889000000,198.3049999999999999000000,22.0338888888888889,"",252403 - Uniforme e Implemento de Seguridad,22.01.03 DESORCIÓN,"",,,,,
Physical Locations / Joya / Stock,Ubicaciones virtuales / Produccion,/ Joya / Stock,07,Uniformes e Implementos de Seguridad,110-0040-01,Par,FILTRO 2097/7184 P/RESPIRADOR CONTRA POLVOS Y HUMOS 3M,2018-12-12,2018-12-12,,Joya\OUT\08875,,,Joya\OUT\08875,LUZ ESTHER CHAÑI CUTIRE,0,1.000000,8.000000,22.0338888888888889,0,22.0338888888888889000000,176.2711111111111110000000,22.0338888888888889,"",252403 - Uniforme e Implemento de Seguridad,20.05.02 LABORATORIO QUIMICO,"",,,,,
Physical Locations / Joya / Stock,Ubicaciones virtuales / Produccion,/ Joya / Stock,07,Uniformes e Implementos de Seguridad,110-0040-01,Par,FILTRO 2097/7184 P/RESPIRADOR CONTRA POLVOS Y HUMOS 3M,2018-12-12,2018-12-12,,Joya\OUT\08877,,,Joya\OUT\08877,LUZ ESTHER CHAÑI CUTIRE,0,1.000000,7.000000,22.0338888888888889,0,22.0338888888888889000000,154.2372222222222221000000,22.0338888888888889,"",252403 - Uniforme e Implemento de Seguridad,20.05.02 LABORATORIO QUIMICO,"",,,,,
Physical Locations / Joya / Stock,Ubicaciones virtuales / Produccion,/ Joya / Stock,07,Uniformes e Implementos de Seguridad,110-0040-01,Par,FILTRO 2097/7184 P/RESPIRADOR CONTRA POLVOS Y HUMOS 3M,2018-12-12,2018-12-12,,Joya\OUT\08883,,,Joya\OUT\08883,LUZ ESTHER CHAÑI CUTIRE,0,1.000000,6.000000,22.0338888888888889,0,22.0338888888888889000000,132.2033333333333332000000,22.0338888888888889,"",252403 - Uniforme e Implemento de Seguridad,20.03.03 CHANCADO,"",,,,,
Physical Locations / Joya / Stock,Ubicaciones virtuales / Produccion,/ Joya / Stock,07,Uniformes e Implementos de Seguridad,110-0040-01,Par,FILTRO 2097/7184 P/RESPIRADOR CONTRA POLVOS Y HUMOS 3M,2018-12-12,2018-12-12,,Joya\OUT\08886,,,Joya\OUT\08886,LUZ ESTHER CHAÑI CUTIRE,0,1.000000,5.000000,22.0338888888888889,0,22.0338888888888889000000,110.1694444444444443000000,22.0338888888888889,"",252403 - Uniforme e Implemento de Seguridad,21.02.01 LIXIVIACIÓN Y ABSORCION,"",,,,,
Physical Locations / Joya / Stock,Ubicaciones virtuales / Produccion,/ Joya / Stock,07,Uniformes e Implementos de Seguridad,110-0040-01,Par,FILTRO 2097/7184 P/RESPIRADOR CONTRA POLVOS Y HUMOS 3M,2018-12-12,2018-12-12,,Joya\OUT\08887,,,Joya\OUT\08887,LUZ ESTHER CHAÑI CUTIRE,0,1.000000,4.000000,22.0338888888888889,0,22.0338888888888889000000,88.1355555555555554000000,22.0338888888888889,"",252403 - Uniforme e Implemento de Seguridad,23.05.01 SEGURIDAD Y MEDIO AMBIENTE,"",,,,,
Physical Locations / Joya / Stock,Ubicaciones virtuales / Produccion,/ Joya / Stock,07,Uniformes e Implementos de Seguridad,110-0040-01,Par,FILTRO 2097/7184 P/RESPIRADOR CONTRA POLVOS Y HUMOS 3M,2018-12-12,2018-12-12,,Joya\OUT\08891,,,Joya\OUT\08891,LUZ ESTHER CHAÑI CUTIRE,0,1.000000,3.000000,22.0338888888888889,0,22.0338888888888889000000,66.1016666666666665000000,22.0338888888888889,"",252403 - Uniforme e Implemento de Seguridad,20.03.03 CHANCADO,"",,,,,
Physical Locations / Joya / Stock,Ubicaciones virtuales / Produccion,/ Joya / Stock,07,Uniformes e Implementos de Seguridad,110-0040-01,Par,FILTRO 2097/7184 P/RESPIRADOR CONTRA POLVOS Y HUMOS 3M,2018-12-12,2018-12-12,,Joya\OUT\08895,,,Joya\OUT\08895,LUZ ESTHER CHAÑI CUTIRE,0,1.000000,2.000000,22.0338888888888889,0,22.0338888888888889000000,44.0677777777777776000000,22.0338888888888889,"",252403 - Uniforme e Implemento de Seguridad,01.01.01 GERENCIA Y ADMINISTRACION,"",,,,,
Physical Locations / Joya / Stock,Ubicaciones virtuales / Produccion,/ Joya / Stock,07,Uniformes e Implementos de Seguridad,110-0040-01,Par,FILTRO 2097/7184 P/RESPIRADOR CONTRA POLVOS Y HUMOS 3M,2018-12-12,2018-12-12,,Joya\OUT\08897,,,Joya\OUT\08897,LUZ ESTHER CHAÑI CUTIRE,0,1.000000,1.000000,22.0338888888888889,0,22.0338888888888889000000,22.0338888888888887000000,22.0338888888888889,"",252403 - Uniforme e Implemento de Seguridad,20.05.02 LABORATORIO QUIMICO,"",,,,,
Physical Locations / Joya / Stock,Ubicaciones virtuales / Produccion,/ Joya / Stock,07,Uniformes e Implementos de Seguridad,110-0040-01,Par,FILTRO 2097/7184 P/RESPIRADOR CONTRA POLVOS Y HUMOS 3M,2018-12-18,2018-12-18,,Joya\OUT\08942,,,Joya\OUT\08942,LUCIANO RUBEN VIZA CHOQUE,0,1.000000,0.000000,22.0338888888888889,0,22.0338888888888889000000,-0.0000000000000002000000,0,"",252403 - Uniforme e Implemento de Seguridad,23.05.01 SEGURIDAD Y MEDIO AMBIENTE,"",,,,,
Physical Locations / Joya / Stock,Ubicaciones virtuales / Produccion,/ Joya / Stock,07,Uniformes e Implementos de Seguridad,110-0040-01,Par,FILTRO 2097/7184 P/RESPIRADOR CONTRA POLVOS Y HUMOS 3M,2018-12-19,2018-12-19,,Joya\OUT\08948,,,Joya\OUT\08948,LUZ ESTHER CHAÑI CUTIRE,0,2.000000,-2.000000,0,0,0.000000,-0.0000000000000002000000,0,"",252403 - Uniforme e Implemento de Seguridad,20.03.03 CHANCADO,"",,,,,
Physical Locations / Joya / Stock,Ubicaciones virtuales / Produccion,/ Joya / Stock,07,Uniformes e Implementos de Seguridad,110-0040-01,Par,FILTRO 2097/7184 P/RESPIRADOR CONTRA POLVOS Y HUMOS 3M,2018-12-19,2018-12-19,,Joya\OUT\08950,,,Joya\OUT\08950,LUZ ESTHER CHAÑI CUTIRE,0,1.000000,-3.000000,0,0,0.000000,-0.0000000000000002000000,0,"",252403 - Uniforme e Implemento de Seguridad,25.01.03 TALLER DE MANTENIMIENTO,"",,,,,
Physical Locations / Joya / Stock,Ubicaciones virtuales / Produccion,/ Joya / Stock,07,Uniformes e Implementos de Seguridad,110-0040-01,Par,FILTRO 2097/7184 P/RESPIRADOR CONTRA POLVOS Y HUMOS 3M,2018-12-19,2018-12-19,,Joya\OUT\08951,,,Joya\OUT\08951,LUZ ESTHER CHAÑI CUTIRE,0,1.000000,-4.000000,0,0,0.000000,-0.0000000000000002000000,0,"",252403 - Uniforme e Implemento de Seguridad,20.03.03 CHANCADO,"",,,,,
Physical Locations / Joya / Stock,Ubicaciones virtuales / Produccion,/ Joya / Stock,07,Uniformes e Implementos de Seguridad,110-0040-01,Par,FILTRO 2097/7184 P/RESPIRADOR CONTRA POLVOS Y HUMOS 3M,2018-12-19,2018-12-19,,Joya\OUT\08952,,,Joya\OUT\08952,LUZ ESTHER CHAÑI CUTIRE,0,1.000000,-5.000000,0,0,0.000000,-0.0000000000000002000000,0,"",252403 - Uniforme e Implemento de Seguridad,20.03.03 CHANCADO,"",,,,,
Physical Locations / Joya / Stock,Ubicaciones virtuales / Produccion,/ Joya / Stock,07,Uniformes e Implementos de Seguridad,110-0040-01,Par,FILTRO 2097/7184 P/RESPIRADOR CONTRA POLVOS Y HUMOS 3M,2018-12-19,2018-12-19,,Joya\OUT\08964,,,Joya\OUT\08964,LUZ ESTHER CHAÑI CUTIRE,0,1.000000,-6.000000,0,0,0.000000,-0.0000000000000002000000,0,"",252403 - Uniforme e Implemento de Seguridad,21.02.01 LIXIVIACIÓN Y ABSORCION,"",,,,,
Physical Locations / Joya / Stock,Ubicaciones virtuales / Produccion,/ Joya / Stock,07,Uniformes e Implementos de Seguridad,110-0040-01,Par,FILTRO 2097/7184 P/RESPIRADOR CONTRA POLVOS Y HUMOS 3M,2018-12-19,2018-12-19,,Joya\OUT\08972,,,Joya\OUT\08972,LUZ ESTHER CHAÑI CUTIRE,0,1.000000,-7.000000,0,0,0.000000,-0.0000000000000002000000,0,"",252403 - Uniforme e Implemento de Seguridad,21.02.01 LIXIVIACIÓN Y ABSORCION,"",,,,,
Physical Locations / Joya / Stock,Ubicaciones virtuales / Produccion,/ Joya / Stock,07,Uniformes e Implementos de Seguridad,110-0040-01,Par,FILTRO 2097/7184 P/RESPIRADOR CONTRA POLVOS Y HUMOS 3M,2018-12-20,2018-12-20,,Joya\OUT\08981,,,Joya\OUT\08981,LUZ ESTHER CHAÑI CUTIRE,0,1.000000,-8.000000,0,0,0.000000,-0.0000000000000002000000,0,"",252403 - Uniforme e Implemento de Seguridad,20.03.03 CHANCADO,"",,,,,
Physical Locations / Joya / Stock,Ubicaciones virtuales / Produccion,/ Joya / Stock,08,Uniformes e Implementos de Seguridad,110-0040-01,Par,FILTRO 2097/7184 P/RESPIRADOR CONTRA POLVOS Y HUMOS 3M,2018-12-23,2018-12-23,,Joya\OUT\09015,,,Joya\OUT\09015,LUCIANO RUBEN VIZA CHOQUE,0,1.000000,-9.000000,0,0,0.000000,-0.0000000000000002000000,0,"",252403 - Uniforme e Implemento de Seguridad,20.03.03 CHANCADO,"",,,,,
Physical Locations / Joya / Stock,Ubicaciones virtuales / Produccion,/ Joya / Stock,07,Uniformes e Implementos de Seguridad,110-0040-01,Par,FILTRO 2097/7184 P/RESPIRADOR CONTRA POLVOS Y HUMOS 3M,2018-12-24,2018-12-24,,Joya\OUT\09029,,,Joya\OUT\09029,LUZ ESTHER CHAÑI CUTIRE,0,1.000000,-10.000000,0,0,0.000000,-0.0000000000000002000000,0,"",252403 - Uniforme e Implemento de Seguridad,29.01.81 MEJORAS EN SISTEMA DE ELECTRODEPOSICION Y MEJORAS SISTEMA DE COSECHAS DE CARBÓN,"",,,,,
Physical Locations / Joya / Stock,Ubicaciones virtuales / Produccion,/ Joya / Stock,07,Uniformes e Implementos de Seguridad,110-0040-01,Par,FILTRO 2097/7184 P/RESPIRADOR CONTRA POLVOS Y HUMOS 3M,2018-12-26,2018-12-26,,Joya\OUT\09037,,,Joya\OUT\09037,LUZ ESTHER CHAÑI CUTIRE,0,1.000000,-11.000000,0,0,0.000000,-0.0000000000000002000000,0,"",252403 - Uniforme e Implemento de Seguridad,21.02.01 LIXIVIACIÓN Y ABSORCION,"",,,,,
Physical Locations / Joya / Stock,Ubicaciones virtuales / Produccion,/ Joya / Stock,07,Uniformes e Implementos de Seguridad,110-0040-01,Par,FILTRO 2097/7184 P/RESPIRADOR CONTRA POLVOS Y HUMOS 3M,2018-12-26,2018-12-26,,Joya\OUT\09040,,,Joya\OUT\09040,LUZ ESTHER CHAÑI CUTIRE,0,1.000000,-12.000000,0,0,0.000000,-0.0000000000000002000000,0,"",252403 - Uniforme e Implemento de Seguridad,20.03.03 CHANCADO,"",,,,,
Physical Locations / Joya / Stock,Ubicaciones virtuales / Produccion,/ Joya / Stock,07,Uniformes e Implementos de Seguridad,110-0040-01,Par,FILTRO 2097/7184 P/RESPIRADOR CONTRA POLVOS Y HUMOS 3M,2018-12-26,2018-12-26,,Joya\OUT\09040,,,Joya\OUT\09040,LUZ ESTHER CHAÑI CUTIRE,0,1.000000,-13.000000,0,0,0.000000,-0.0000000000000002000000,0,"",252403 - Uniforme e Implemento de Seguridad,20.03.03 CHANCADO,"",,,,,
Physical Locations / Joya / Stock,Ubicaciones virtuales / Produccion,/ Joya / Stock,08,Uniformes e Implementos de Seguridad,110-0040-01,Par,FILTRO 2097/7184 P/RESPIRADOR CONTRA POLVOS Y HUMOS 3M,2018-12-26,2018-12-26,,Joya\OUT\09042,,,Joya\OUT\09042,LUCIANO RUBEN VIZA CHOQUE,0,1.000000,-14.000000,0,0,0.000000,-0.0000000000000002000000,0,"",252403 - Uniforme e Implemento de Seguridad,20.03.03 CHANCADO,"",,,,,
Physical Locations / Joya / Stock,Ubicaciones virtuales / Produccion,/ Joya / Stock,07,Uniformes e Implementos de Seguridad,110-0040-01,Par,FILTRO 2097/7184 P/RESPIRADOR CONTRA POLVOS Y HUMOS 3M,2018-12-26,2018-12-26,,Joya\OUT\09043,,,Joya\OUT\09043,LUZ ESTHER CHAÑI CUTIRE,0,1.000000,-15.000000,0,0,0.000000,-0.0000000000000002000000,0,"",252403 - Uniforme e Implemento de Seguridad,22.01.03 DESORCIÓN,"",,,,,
Physical Locations / Joya / Stock,Ubicaciones virtuales / Produccion,/ Joya / Stock,08,Uniformes e Implementos de Seguridad,110-0040-01,Par,FILTRO 2097/7184 P/RESPIRADOR CONTRA POLVOS Y HUMOS 3M,2018-12-26,2018-12-26,,Joya\OUT\09048,,,Joya\OUT\09048,LUCIANO RUBEN VIZA CHOQUE,0,1.000000,-16.000000,0,0,0.000000,-0.0000000000000002000000,0,"",252403 - Uniforme e Implemento de Seguridad,25.01.03 TALLER DE MANTENIMIENTO,"",,,,,
Physical Locations / Joya / Stock,Ubicaciones virtuales / Produccion,/ Joya / Stock,07,Uniformes e Implementos de Seguridad,110-0040-01,Par,FILTRO 2097/7184 P/RESPIRADOR CONTRA POLVOS Y HUMOS 3M,2018-12-28,2018-12-28,,Joya\OUT\09061,,,Joya\OUT\09061,LUZ ESTHER CHAÑI CUTIRE,0,1.000000,-17.000000,0,0,0.000000,-0.0000000000000002000000,0,"",252403 - Uniforme e Implemento de Seguridad,25.01.03 TALLER DE MANTENIMIENTO,"",,,,,
Physical Locations / Joya / Stock,Ubicaciones virtuales / Produccion,/ Joya / Stock,07,Uniformes e Implementos de Seguridad,110-0041-01,Unit(s),FILTRO N95,2018-12-28,2018-12-28,,Joya\OUT\09057,,,Joya\OUT\09057,LUZ ESTHER CHAÑI CUTIRE,0,2.000000,-2.000000,0,0,0.000000,0.000000,0,"",252403 - Uniforme e Implemento de Seguridad,25.01.03 TALLER DE MANTENIMIENTO,"",,,,,
Physical Locations / Joya / Stock,Ubicaciones virtuales / Produccion,/ Joya / Stock,07,Uniformes e Implementos de Seguridad,110-0041-01,Unit(s),FILTRO N95,2018-12-28,2018-12-28,,Joya\OUT\09061,,,Joya\OUT\09061,LUZ ESTHER CHAÑI CUTIRE,0,2.000000,-4.000000,0,0,0.000000,0.000000,0,"",252403 - Uniforme e Implemento de Seguridad,25.01.03 TALLER DE MANTENIMIENTO,"",,,,,
Partner Locations / Suppliers,Physical Locations / Joya / Stock,/ Joya / Stock,03,Uniformes e Implementos de Seguridad,110-0044-03,Par,"GUANTES ALUMINIZADOS DE 14"" DE LARGO",2018-12-01,2018-12-01,12/2018,Joya\IN\02935,01,0002,0003235,ESTHER SANDRA PINEDA LOAYZA,4.000000,0,4.000000,108.4750000000000000,433.9,0,433.9,108.4750000000000000,603203 - Uniforme e Implemento de Seguridad,252403 - Uniforme e Implemento de Seguridad,,"",,18PO06966,LM-001498,2018-12-01,
Physical Locations / Joya / Stock,Ubicaciones virtuales / Produccion,/ Joya / Stock,07,Uniformes e Implementos de Seguridad,110-0044-03,Par,"GUANTES ALUMINIZADOS DE 14"" DE LARGO",2018-12-25,2018-12-25,,Joya\OUT\09036,,,Joya\OUT\09036,VICTOR URIEL VILCA CENTI,0,1.000000,3.000000,108.4750000000000000,0,108.4750000000000000000000,325.4250000000000000000000,108.4750000000000000,"",252403 - Uniforme e Implemento de Seguridad,20.05.02 LABORATORIO QUIMICO,"",,,,2018-12-25,
Physical Locations / Joya / Stock,Ubicaciones virtuales / Produccion,/ Joya / Stock,07,Uniformes e Implementos de Seguridad,110-0046-01,Par,GUANTES DE BADANA AMARILLO,2018-12-09,2018-12-09,,Joya\OUT\08850,,,Joya\OUT\08850,Harold Zambrano,0,1.000000,-1.000000,0,0,0.000000,0.000000,0,"",252403 - Uniforme e Implemento de Seguridad,21.01.01 MOLIENDA,"",,,,,
Physical Locations / Joya / Stock,Ubicaciones virtuales / Produccion,/ Joya / Stock,07,Uniformes e Implementos de Seguridad,110-0046-01,Par,GUANTES DE BADANA AMARILLO,2018-12-16,2018-12-16,,Joya\OUT\08921,,,Joya\OUT\08921,Harold Zambrano,0,1.000000,-2.000000,0,0,0.000000,0.000000,0,"",252403 - Uniforme e Implemento de Seguridad,21.01.01 MOLIENDA,"",,,,,
Physical Locations / Joya / Stock,Ubicaciones virtuales / Produccion,/ Joya / Stock,07,Uniformes e Implementos de Seguridad,110-0046-01,Par,GUANTES DE BADANA AMARILLO,2018-12-17,2018-12-17,,Joya\OUT\08979,,,Joya\OUT\08979,Harold Zambrano,0,1.000000,-3.000000,0,0,0.000000,0.000000,0,"",252403 - Uniforme e Implemento de Seguridad,21.02.01 LIXIVIACIÓN Y ABSORCION,"",,,,2018-12-17,
Physical Locations / Joya / Stock,Ubicaciones virtuales / Produccion,/ Joya / Stock,07,Uniformes e Implementos de Seguridad,110-0046-01,Par,GUANTES DE BADANA AMARILLO,2018-12-18,2018-12-18,,Joya\OUT\08940,,,Joya\OUT\08940,LUZ ESTHER CHAÑI CUTIRE,0,1.000000,-4.000000,0,0,0.000000,0.000000,0,"",252403 - Uniforme e Implemento de Seguridad,25.01.03 TALLER DE MANTENIMIENTO,"",,,,,
Physical Locations / Joya / Stock,Ubicaciones virtuales / Produccion,/ Joya / Stock,07,Uniformes e Implementos de Seguridad,110-0046-01,Par,GUANTES DE BADANA AMARILLO,2018-12-18,2018-12-18,,Joya\OUT\08942,,,Joya\OUT\08942,LUCIANO RUBEN VIZA CHOQUE,0,1.000000,-5.000000,0,0,0.000000,0.000000,0,"",252403 - Uniforme e Implemento de Seguridad,23.05.01 SEGURIDAD Y MEDIO AMBIENTE,"",,,,,
Physical Locations / Joya / Stock,Ubicaciones virtuales / Produccion,/ Joya / Stock,07,Uniformes e Implementos de Seguridad,110-0046-01,Par,GUANTES DE BADANA AMARILLO,2018-12-19,2018-12-19,,Joya\OUT\08950,,,Joya\OUT\08950,LUZ ESTHER CHAÑI CUTIRE,0,1.000000,-6.000000,0,0,0.000000,0.000000,0,"",252403 - Uniforme e Implemento de Seguridad,25.01.03 TALLER DE MANTENIMIENTO,"",,,,,
Physical Locations / Joya / Stock,Ubicaciones virtuales / Produccion,/ Joya / Stock,07,Uniformes e Implementos de Seguridad,110-0046-01,Par,GUANTES DE BADANA AMARILLO,2018-12-19,2018-12-19,,Joya\OUT\08964,,,Joya\OUT\08964,LUZ ESTHER CHAÑI CUTIRE,0,1.000000,-7.000000,0,0,0.000000,0.000000,0,"",252403 - Uniforme e Implemento de Seguridad,21.02.01 LIXIVIACIÓN Y ABSORCION,"",,,,,
Physical Locations / Joya / Stock,Ubicaciones virtuales / Produccion,/ Joya / Stock,07,Uniformes e Implementos de Seguridad,110-0046-01,Par,GUANTES DE BADANA AMARILLO,2018-12-20,2018-12-20,,Joya\OUT\08981,,,Joya\OUT\08981,LUZ ESTHER CHAÑI CUTIRE,0,1.000000,-8.000000,0,0,0.000000,0.000000,0,"",252403 - Uniforme e Implemento de Seguridad,20.03.03 CHANCADO,"",,,,,
Physical Locations / Joya / Stock,Ubicaciones virtuales / Produccion,/ Joya / Stock,08,Uniformes e Implementos de Seguridad,110-0046-01,Par,GUANTES DE BADANA AMARILLO,2018-12-23,2018-12-23,,Joya\OUT\09014,,,Joya\OUT\09014,LUCIANO RUBEN VIZA CHOQUE,0,1.000000,-9.000000,0,0,0.000000,0.000000,0,"",252403 - Uniforme e Implemento de Seguridad,"01.01.11	GESTION PLANTA,COMERCIAL Y ADMIN.","",,,,,
Physical Locations / Joya / Stock,Ubicaciones virtuales / Produccion,/ Joya / Stock,08,Uniformes e Implementos de Seguridad,110-0046-01,Par,GUANTES DE BADANA AMARILLO,2018-12-26,2018-12-26,,Joya\OUT\09048,,,Joya\OUT\09048,LUCIANO RUBEN VIZA CHOQUE,0,1.000000,-10.000000,0,0,0.000000,0.000000,0,"",252403 - Uniforme e Implemento de Seguridad,25.01.03 TALLER DE MANTENIMIENTO,"",,,,,
Partner Locations / Suppliers,Physical Locations / Joya / Stock,/ Joya / Stock,03,Uniformes e Implementos de Seguridad,110-0047-01,Par,GUANTES DE BADANA BLANCO,2018-12-01,2018-12-01,12/2018,Joya\IN\02933,01,0002,0003203,ESTHER SANDRA PINEDA LOAYZA,36.000000,0,36.000000,8.4744444444444444,305.08,0,305.08,8.4744444444444444,603203 - Uniforme e Implemento de Seguridad,252403 - Uniforme e Implemento de Seguridad,,"",,18PO06654,LM-001642,2018-12-01,
Physical Locations / Joya / Stock,Ubicaciones virtuales / Produccion,/ Joya / Stock,07,Uniformes e Implementos de Seguridad,110-0047-01,Par,GUANTES DE BADANA BLANCO,2018-12-01,2018-12-01,,Joya\OUT\08769,,,Joya\OUT\08769,ERNESTO ALVAREZ OSORIO,0,2.000000,34.000000,8.4744444444444444,0,16.9488888888888888000000,288.1311111111111112000000,8.4744444444444444,"",252403 - Uniforme e Implemento de Seguridad,20.03.03 CHANCADO,"",,,,,
Physical Locations / Joya / Stock,Ubicaciones virtuales / Produccion,/ Joya / Stock,07,Uniformes e Implementos de Seguridad,110-0047-01,Par,GUANTES DE BADANA BLANCO,2018-12-04,2018-12-04,,Joya\OUT\08799,,,Joya\OUT\08799,LUZ ESTHER CHAÑI CUTIRE,0,1.000000,33.000000,8.4744444444444444,0,8.4744444444444444000000,279.6566666666666668000000,8.4744444444444444,"",252403 - Uniforme e Implemento de Seguridad,25.01.03 TALLER DE MANTENIMIENTO,"",,,,,
Physical Locations / Joya / Stock,Ubicaciones virtuales / Produccion,/ Joya / Stock,07,Uniformes e Implementos de Seguridad,110-0047-01,Par,GUANTES DE BADANA BLANCO,2018-12-04,2018-12-04,,Joya\OUT\08806,,,Joya\OUT\08806,LUZ ESTHER CHAÑI CUTIRE,0,1.000000,32.000000,8.4744444444444444,0,8.4744444444444444000000,271.1822222222222224000000,8.4744444444444444,"",252403 - Uniforme e Implemento de Seguridad,25.01.03 TALLER DE MANTENIMIENTO,"",,,,,
Physical Locations / Joya / Stock,Ubicaciones virtuales / Produccion,/ Joya / Stock,07,Uniformes e Implementos de Seguridad,110-0047-01,Par,GUANTES DE BADANA BLANCO,2018-12-04,2018-12-04,,Joya\OUT\08807,,,Joya\OUT\08807,LUZ ESTHER CHAÑI CUTIRE,0,1.000000,31.000000,8.4744444444444444,0,8.4744444444444444000000,262.7077777777777780000000,8.4744444444444444,"",252403 - Uniforme e Implemento de Seguridad,21.02.01 LIXIVIACIÓN Y ABSORCION,"",,,,,
Physical Locations / Joya / Stock,Ubicaciones virtuales / Produccion,/ Joya / Stock,07,Uniformes e Implementos de Seguridad,110-0047-01,Par,GUANTES DE BADANA BLANCO,2018-12-05,2018-12-05,,Joya\OUT\08810,,,Joya\OUT\08810,LUZ ESTHER CHAÑI CUTIRE,0,1.000000,30.000000,8.4744444444444444,0,8.4744444444444444000000,254.2333333333333336000000,8.4744444444444444,"",252403 - Uniforme e Implemento de Seguridad,20.05.02 LABORATORIO QUIMICO,"",,,,,
Physical Locations / Joya / Stock,Ubicaciones virtuales / Produccion,/ Joya / Stock,07,Uniformes e Implementos de Seguridad,110-0047-01,Par,GUANTES DE BADANA BLANCO,2018-12-05,2018-12-05,,Joya\OUT\08811,,,Joya\OUT\08811,LUZ ESTHER CHAÑI CUTIRE,0,1.000000,29.000000,8.4744444444444444,0,8.4744444444444444000000,245.7588888888888892000000,8.4744444444444444,"",252403 - Uniforme e Implemento de Seguridad,25.01.03 TALLER DE MANTENIMIENTO,"",,,,,
Physical Locations / Joya / Stock,Ubicaciones virtuales / Produccion,/ Joya / Stock,07,Uniformes e Implementos de Seguridad,110-0047-01,Par,GUANTES DE BADANA BLANCO,2018-12-05,2018-12-05,,Joya\OUT\08813,,,Joya\OUT\08813,LUZ ESTHER CHAÑI CUTIRE,0,1.000000,28.000000,8.4744444444444444,0,8.4744444444444444000000,237.2844444444444448000000,8.4744444444444444,"",252403 - Uniforme e Implemento de Seguridad,25.01.03 TALLER DE MANTENIMIENTO,"",,,,,
Physical Locations / Joya / Stock,Ubicaciones virtuales / Produccion,/ Joya / Stock,07,Uniformes e Implementos de Seguridad,110-0047-01,Par,GUANTES DE BADANA BLANCO,2018-12-07,2018-12-07,,Joya\OUT\08825,,,Joya\OUT\08825,LUZ ESTHER CHAÑI CUTIRE,0,1.000000,27.000000,8.4744444444444444,0,8.4744444444444444000000,228.8100000000000004000000,8.4744444444444444,"",252403 - Uniforme e Implemento de Seguridad,20.03.03 CHANCADO,"",,,,,
Physical Locations / Joya / Stock,Ubicaciones virtuales / Produccion,/ Joya / Stock,07,Uniformes e Implementos de Seguridad,110-0047-01,Par,GUANTES DE BADANA BLANCO,2018-12-09,2018-12-09,,Joya\OUT\08848,,,Joya\OUT\08848,JOSE SANTOS MATTA BORJAS,0,1.000000,26.000000,8.4744444444444444,0,8.4744444444444444000000,220.3355555555555560000000,8.4744444444444444,"",252403 - Uniforme e Implemento de Seguridad,21.01.09 MOLINO 6' X 8' DELTA,"",,,,,
Physical Locations / Joya / Stock,Ubicaciones virtuales / Produccion,/ Joya / Stock,07,Uniformes e Implementos de Seguridad,110-0047-01,Par,GUANTES DE BADANA BLANCO,2018-12-12,2018-12-12,,Joya\OUT\08876,,,Joya\OUT\08876,LUZ ESTHER CHAÑI CUTIRE,0,1.000000,25.000000,8.4744444444444444,0,8.4744444444444444000000,211.8611111111111116000000,8.4744444444444444,"",252403 - Uniforme e Implemento de Seguridad,20.05.02 LABORATORIO QUIMICO,"",,,,,
Physical Locations / Joya / Stock,Ubicaciones virtuales / Produccion,/ Joya / Stock,07,Uniformes e Implementos de Seguridad,110-0047-01,Par,GUANTES DE BADANA BLANCO,2018-12-12,2018-12-12,,Joya\OUT\08895,,,Joya\OUT\08895,LUZ ESTHER CHAÑI CUTIRE,0,1.000000,24.000000,8.4744444444444444,0,8.4744444444444444000000,203.3866666666666672000000,8.4744444444444444,"",252403 - Uniforme e Implemento de Seguridad,20.03.03 CHANCADO,"",,,,,
Physical Locations / Joya / Stock,Ubicaciones virtuales / Produccion,/ Joya / Stock,07,Uniformes e Implementos de Seguridad,110-0047-01,Par,GUANTES DE BADANA BLANCO,2018-12-12,2018-12-12,,Joya\OUT\08897,,,Joya\OUT\08897,LUZ ESTHER CHAÑI CUTIRE,0,1.000000,23.000000,8.4744444444444444,0,8.4744444444444444000000,194.9122222222222228000000,8.4744444444444444,"",252403 - Uniforme e Implemento de Seguridad,20.05.02 LABORATORIO QUIMICO,"",,,,,
Physical Locations / Joya / Stock,Ubicaciones virtuales / Produccion,/ Joya / Stock,08,Uniformes e Implementos de Seguridad,110-0047-01,Par,GUANTES DE BADANA BLANCO,2018-12-23,2018-12-23,,Joya\OUT\09016,,,Joya\OUT\09016,LUCIANO RUBEN VIZA CHOQUE,0,1.000000,22.000000,8.4744444444444444,0,8.4744444444444444000000,186.4377777777777784000000,8.4744444444444444,"",252403 - Uniforme e Implemento de Seguridad,20.05.02 LABORATORIO QUIMICO,"",,,,,
Physical Locations / Joya / Stock,Ubicaciones virtuales / Produccion,/ Joya / Stock,07,Uniformes e Implementos de Seguridad,110-0047-01,Par,GUANTES DE BADANA BLANCO,2018-12-24,2018-12-24,,Joya\OUT\09029,,,Joya\OUT\09029,LUZ ESTHER CHAÑI CUTIRE,0,1.000000,21.000000,8.4744444444444444,0,8.4744444444444444000000,177.9633333333333340000000,8.4744444444444444,"",252403 - Uniforme e Implemento de Seguridad,29.01.81 MEJORAS EN SISTEMA DE ELECTRODEPOSICION Y MEJORAS SISTEMA DE COSECHAS DE CARBÓN,"",,,,,
Physical Locations / Joya / Stock,Ubicaciones virtuales / Produccion,/ Joya / Stock,07,Uniformes e Implementos de Seguridad,110-0047-01,Par,GUANTES DE BADANA BLANCO,2018-12-28,2018-12-28,,Joya\OUT\09057,,,Joya\OUT\09057,LUZ ESTHER CHAÑI CUTIRE,0,1.000000,20.000000,8.4744444444444444,0,8.4744444444444444000000,169.4888888888888896000000,8.4744444444444444,"",252403 - Uniforme e Implemento de Seguridad,25.01.03 TALLER DE MANTENIMIENTO,"",,,,,
Physical Locations / Joya / Stock,Ubicaciones virtuales / Produccion,/ Joya / Stock,07,Uniformes e Implementos de Seguridad,110-0047-01,Par,GUANTES DE BADANA BLANCO,2018-12-28,2018-12-28,,Joya\OUT\09061,,,Joya\OUT\09061,LUZ ESTHER CHAÑI CUTIRE,0,1.000000,19.000000,8.4744444444444444,0,8.4744444444444444000000,161.0144444444444452000000,8.4744444444444444,"",252403 - Uniforme e Implemento de Seguridad,25.01.03 TALLER DE MANTENIMIENTO,"",,,,,
Physical Locations / Joya / Stock,Ubicaciones virtuales / Produccion,/ Joya / Stock,07,Uniformes e Implementos de Seguridad,110-0047-01,Par,GUANTES DE BADANA BLANCO,2018-12-30,2018-12-30,,Joya\OUT\09077,,,Joya\OUT\09077,LUZ ESTHER CHAÑI CUTIRE,0,1.000000,18.000000,8.4744444444444444,0,8.4744444444444444000000,152.5400000000000008000000,8.4744444444444444,"",252403 - Uniforme e Implemento de Seguridad,21.02.01 LIXIVIACIÓN Y ABSORCION,"",,,,,
Physical Locations / Joya / Stock,Ubicaciones virtuales / Produccion,/ Joya / Stock,07,Uniformes e Implementos de Seguridad,110-0050-01,Par,GUANTES DE CUERO CAÑA LARGA,2018-12-08,2018-12-08,,Joya\OUT\08842,,,Joya\OUT\08842,VICTOR URIEL VILCA CENTI,0,1.000000,-1.000000,0,0,0.000000,0.000000,0,"",252403 - Uniforme e Implemento de Seguridad,20.05.02 LABORATORIO QUIMICO,"",,,,2018-12-08,
Physical Locations / Joya / Stock,Ubicaciones virtuales / Produccion,/ Joya / Stock,07,Uniformes e Implementos de Seguridad,110-0050-01,Par,GUANTES DE CUERO CAÑA LARGA,2018-12-16,2018-12-16,,Joya\OUT\08922,,,Joya\OUT\08922,LUZ ESTHER CHAÑI CUTIRE,0,1.000000,-2.000000,0,0,0.000000,0.000000,0,"",252403 - Uniforme e Implemento de Seguridad,25.01.03 TALLER DE MANTENIMIENTO,"",,,,2018-12-16,
Physical Locations / Joya / Stock,Ubicaciones virtuales / Produccion,/ Joya / Stock,07,Uniformes e Implementos de Seguridad,110-0051-01,Par,GUANTES DE HILO T-8,2018-12-05,2018-12-05,,Joya\OUT\08812,,,Joya\OUT\08812,Harold Zambrano,0,1.000000,-1.000000,0,0,0.000000,0.000000,0,"",252403 - Uniforme e Implemento de Seguridad,21.02.01 LIXIVIACIÓN Y ABSORCION,"",,,,,
Physical Locations / Joya / Stock,Ubicaciones virtuales / Produccion,/ Joya / Stock,07,Uniformes e Implementos de Seguridad,110-0051-01,Par,GUANTES DE HILO T-8,2018-12-05,2018-12-05,,Joya\OUT\08814,,,Joya\OUT\08814,LUZ ESTHER CHAÑI CUTIRE,0,1.000000,-2.000000,0,0,0.000000,0.000000,0,"",252403 - Uniforme e Implemento de Seguridad,23.02.01 ALMACENES,"",,,,,
Physical Locations / Joya / Stock,Ubicaciones virtuales / Produccion,/ Joya / Stock,07,Uniformes e Implementos de Seguridad,110-0051-01,Par,GUANTES DE HILO T-8,2018-12-07,2018-12-07,,Joya\OUT\08825,,,Joya\OUT\08825,LUZ ESTHER CHAÑI CUTIRE,0,1.000000,-3.000000,0,0,0.000000,0.000000,0,"",252403 - Uniforme e Implemento de Seguridad,20.03.03 CHANCADO,"",,,,,
Physical Locations / Joya / Stock,Ubicaciones virtuales / Produccion,/ Joya / Stock,07,Uniformes e Implementos de Seguridad,110-0051-01,Par,GUANTES DE HILO T-8,2018-12-10,2018-12-10,,Joya\OUT\08853,,,Joya\OUT\08853,LUZ ESTHER CHAÑI CUTIRE,0,1.000000,-4.000000,0,0,0.000000,0.000000,0,"",252403 - Uniforme e Implemento de Seguridad,20.03.03 CHANCADO,"",,,,,
Physical Locations / Joya / Stock,Ubicaciones virtuales / Produccion,/ Joya / Stock,07,Uniformes e Implementos de Seguridad,110-0051-01,Par,GUANTES DE HILO T-8,2018-12-12,2018-12-12,,Joya\OUT\08872,,,Joya\OUT\08872,LUZ ESTHER CHAÑI CUTIRE,0,1.000000,-5.000000,0,0,0.000000,0.000000,0,"",252403 - Uniforme e Implemento de Seguridad,20.03.03 CHANCADO,"",,,,,
Physical Locations / Joya / Stock,Ubicaciones virtuales / Produccion,/ Joya / Stock,07,Uniformes e Implementos de Seguridad,110-0051-01,Par,GUANTES DE HILO T-8,2018-12-12,2018-12-12,,Joya\OUT\08904,,,Joya\OUT\08904,LUZ ESTHER CHAÑI CUTIRE,0,1.000000,-6.000000,0,0,0.000000,0.000000,0,"",252403 - Uniforme e Implemento de Seguridad,21.02.01 LIXIVIACIÓN Y ABSORCION,"",,,,,
Physical Locations / Joya / Stock,Ubicaciones virtuales / Produccion,/ Joya / Stock,07,Uniformes e Implementos de Seguridad,110-0051-01,Par,GUANTES DE HILO T-8,2018-12-19,2018-12-19,,Joya\OUT\08949,,,Joya\OUT\08949,LUZ ESTHER CHAÑI CUTIRE,0,1.000000,-7.000000,0,0,0.000000,0.000000,0,"",252403 - Uniforme e Implemento de Seguridad,21.02.01 LIXIVIACIÓN Y ABSORCION,"",,,,,
Physical Locations / Joya / Stock,Ubicaciones virtuales / Produccion,/ Joya / Stock,07,Uniformes e Implementos de Seguridad,110-0051-01,Par,GUANTES DE HILO T-8,2018-12-19,2018-12-19,,Joya\OUT\08951,,,Joya\OUT\08951,LUZ ESTHER CHAÑI CUTIRE,0,1.000000,-8.000000,0,0,0.000000,0.000000,0,"",252403 - Uniforme e Implemento de Seguridad,20.03.03 CHANCADO,"",,,,,
Physical Locations / Joya / Stock,Ubicaciones virtuales / Produccion,/ Joya / Stock,07,Uniformes e Implementos de Seguridad,110-0051-01,Par,GUANTES DE HILO T-8,2018-12-19,2018-12-19,,Joya\OUT\08952,,,Joya\OUT\08952,LUZ ESTHER CHAÑI CUTIRE,0,1.000000,-9.000000,0,0,0.000000,0.000000,0,"",252403 - Uniforme e Implemento de Seguridad,20.03.03 CHANCADO,"",,,,,
Physical Locations / Joya / Stock,Ubicaciones virtuales / Produccion,/ Joya / Stock,07,Uniformes e Implementos de Seguridad,110-0051-01,Par,GUANTES DE HILO T-8,2018-12-19,2018-12-19,,Joya\OUT\08965,,,Joya\OUT\08965,LUZ ESTHER CHAÑI CUTIRE,0,1.000000,-10.000000,0,0,0.000000,0.000000,0,"",252403 - Uniforme e Implemento de Seguridad,21.02.01 LIXIVIACIÓN Y ABSORCION,"",,,,,
Partner Locations / Suppliers,Physical Locations / Joya / Stock,/ Joya / Stock,03,Uniformes e Implementos de Seguridad,110-0052-01,Par,GUANTES DE HILO T-9,2018-12-01,2018-12-01,12/2018,Joya\IN\02929,01,0002,0003195,ESTHER SANDRA PINEDA LOAYZA,36.000000,0,36.000000,6.6950000000000000,241.02,0,241.02,6.6950000000000000,603203 - Uniforme e Implemento de Seguridad,252403 - Uniforme e Implemento de Seguridad,,"",,18PO06653,LM-001642,2018-12-01,
Physical Locations / Joya / Stock,Ubicaciones virtuales / Produccion,/ Joya / Stock,07,Uniformes e Implementos de Seguridad,110-0052-01,Par,GUANTES DE HILO T-9,2018-12-06,2018-12-06,,Joya\OUT\08821,,,Joya\OUT\08821,LUZ ESTHER CHAÑI CUTIRE,0,1.000000,35.000000,6.6950000000000000,0,6.6950000000000000000000,234.3250000000000000000000,6.6950000000000000,"",252403 - Uniforme e Implemento de Seguridad,20.03.03 CHANCADO,"",,,,,
Physical Locations / Joya / Stock,Ubicaciones virtuales / Produccion,/ Joya / Stock,07,Uniformes e Implementos de Seguridad,110-0052-01,Par,GUANTES DE HILO T-9,2018-12-10,2018-12-10,,Joya\OUT\08854,,,Joya\OUT\08854,LUZ ESTHER CHAÑI CUTIRE,0,1.000000,34.000000,6.6950000000000000,0,6.6950000000000000000000,227.6300000000000000000000,6.6950000000000000,"",252403 - Uniforme e Implemento de Seguridad,20.03.03 CHANCADO,"",,,,,
Physical Locations / Joya / Stock,Ubicaciones virtuales / Produccion,/ Joya / Stock,07,Uniformes e Implementos de Seguridad,110-0052-01,Par,GUANTES DE HILO T-9,2018-12-10,2018-12-10,,Joya\OUT\08855,,,Joya\OUT\08855,LUZ ESTHER CHAÑI CUTIRE,0,1.000000,33.000000,6.6950000000000000,0,6.6950000000000000000000,220.9350000000000000000000,6.6950000000000000,"",252403 - Uniforme e Implemento de Seguridad,20.03.03 CHANCADO,"",,,,,
Physical Locations / Joya / Stock,Ubicaciones virtuales / Produccion,/ Joya / Stock,07,Uniformes e Implementos de Seguridad,110-0052-01,Par,GUANTES DE HILO T-9,2018-12-12,2018-12-12,,Joya\OUT\08871,,,Joya\OUT\08871,LUZ ESTHER CHAÑI CUTIRE,0,1.000000,32.000000,6.6950000000000000,0,6.6950000000000000000000,214.2400000000000000000000,6.6950000000000000,"",252403 - Uniforme e Implemento de Seguridad,21.02.01 LIXIVIACIÓN Y ABSORCION,"",,,,,
Physical Locations / Joya / Stock,Ubicaciones virtuales / Produccion,/ Joya / Stock,07,Uniformes e Implementos de Seguridad,110-0052-01,Par,GUANTES DE HILO T-9,2018-12-12,2018-12-12,,Joya\OUT\08891,,,Joya\OUT\08891,LUZ ESTHER CHAÑI CUTIRE,0,1.000000,31.000000,6.6950000000000000,0,6.6950000000000000000000,207.5450000000000000000000,6.6950000000000000,"",252403 - Uniforme e Implemento de Seguridad,20.03.03 CHANCADO,"",,,,,
Physical Locations / Joya / Stock,Ubicaciones virtuales / Produccion,/ Joya / Stock,07,Uniformes e Implementos de Seguridad,110-0052-01,Par,GUANTES DE HILO T-9,2018-12-19,2018-12-19,,Joya\OUT\08960,,,Joya\OUT\08960,LUZ ESTHER CHAÑI CUTIRE,0,1.000000,30.000000,6.6950000000000000,0,6.6950000000000000000000,200.8500000000000000000000,6.6950000000000000,"",252403 - Uniforme e Implemento de Seguridad,20.03.03 CHANCADO,"",,,,,
Physical Locations / Joya / Stock,Ubicaciones virtuales / Produccion,/ Joya / Stock,07,Uniformes e Implementos de Seguridad,110-0052-01,Par,GUANTES DE HILO T-9,2018-12-19,2018-12-19,,Joya\OUT\08963,,,Joya\OUT\08963,LUZ ESTHER CHAÑI CUTIRE,0,1.000000,29.000000,6.6950000000000000,0,6.6950000000000000000000,194.1550000000000000000000,6.6950000000000000,"",252403 - Uniforme e Implemento de Seguridad,21.02.01 LIXIVIACIÓN Y ABSORCION,"",,,,,
Physical Locations / Joya / Stock,Ubicaciones virtuales / Produccion,/ Joya / Stock,07,Uniformes e Implementos de Seguridad,110-0052-01,Par,GUANTES DE HILO T-9,2018-12-19,2018-12-19,,Joya\OUT\08964,,,Joya\OUT\08964,LUZ ESTHER CHAÑI CUTIRE,0,1.000000,28.000000,6.6950000000000000,0,6.6950000000000000000000,187.4600000000000000000000,6.6950000000000000,"",252403 - Uniforme e Implemento de Seguridad,21.02.01 LIXIVIACIÓN Y ABSORCION,"",,,,,
Physical Locations / Joya / Stock,Ubicaciones virtuales / Produccion,/ Joya / Stock,07,Uniformes e Implementos de Seguridad,110-0052-01,Par,GUANTES DE HILO T-9,2018-12-20,2018-12-20,,Joya\OUT\08981,,,Joya\OUT\08981,LUZ ESTHER CHAÑI CUTIRE,0,1.000000,27.000000,6.6950000000000000,0,6.6950000000000000000000,180.7650000000000000000000,6.6950000000000000,"",252403 - Uniforme e Implemento de Seguridad,20.03.03 CHANCADO,"",,,,,
Physical Locations / Joya / Stock,Ubicaciones virtuales / Produccion,/ Joya / Stock,08,Uniformes e Implementos de Seguridad,110-0052-01,Par,GUANTES DE HILO T-9,2018-12-22,2018-12-22,,Joya\OUT\09006,,,Joya\OUT\09006,LUCIANO RUBEN VIZA CHOQUE,0,1.000000,26.000000,6.6950000000000000,0,6.6950000000000000000000,174.0700000000000000000000,6.6950000000000000,"",252403 - Uniforme e Implemento de Seguridad,20.03.03 CHANCADO,"",,,,,
Physical Locations / Joya / Stock,Ubicaciones virtuales / Produccion,/ Joya / Stock,07,Uniformes e Implementos de Seguridad,110-0052-01,Par,GUANTES DE HILO T-9,2018-12-26,2018-12-26,,Joya\OUT\09040,,,Joya\OUT\09040,LUZ ESTHER CHAÑI CUTIRE,0,1.000000,25.000000,6.6950000000000000,0,6.6950000000000000000000,167.3750000000000000000000,6.6950000000000000,"",252403 - Uniforme e Implemento de Seguridad,20.03.03 CHANCADO,"",,,,,
Physical Locations / Joya / Stock,Ubicaciones virtuales / Produccion,/ Joya / Stock,08,Uniformes e Implementos de Seguridad,110-0052-01,Par,GUANTES DE HILO T-9,2018-12-26,2018-12-26,,Joya\OUT\09047,,,Joya\OUT\09047,LUCIANO RUBEN VIZA CHOQUE,0,1.000000,24.000000,6.6950000000000000,0,6.6950000000000000000000,160.6800000000000000000000,6.6950000000000000,"",252403 - Uniforme e Implemento de Seguridad,20.03.03 CHANCADO,"",,,,,
Physical Locations / Joya / Stock,Ubicaciones virtuales / Produccion,/ Joya / Stock,07,Uniformes e Implementos de Seguridad,110-0052-01,Par,GUANTES DE HILO T-9,2018-12-28,2018-12-28,,Joya\OUT\09061,,,Joya\OUT\09061,LUZ ESTHER CHAÑI CUTIRE,0,1.000000,23.000000,6.6950000000000000,0,6.6950000000000000000000,153.9850000000000000000000,6.6950000000000000,"",252403 - Uniforme e Implemento de Seguridad,25.01.03 TALLER DE MANTENIMIENTO,"",,,,,
Physical Locations / Joya / Stock,Ubicaciones virtuales / Produccion,/ Joya / Stock,07,Uniformes e Implementos de Seguridad,110-0054-01,Par,GUANTES DE LATEX NEGRO T-8,2018-12-04,2018-12-04,,Joya\OUT\08804,,,Joya\OUT\08804,HELBERT ERNESTO CALLE PAYEHUANCA,0,2.000000,-2.000000,0,0,0.000000,0.000000,0,"",252403 - Uniforme e Implemento de Seguridad,23.08.08 OTROS COSTOS INDIRECTOS,"",,,,2018-12-04,
Physical Locations / Joya / Stock,Ubicaciones virtuales / Produccion,/ Joya / Stock,07,Uniformes e Implementos de Seguridad,110-0054-01,Par,GUANTES DE LATEX NEGRO T-8,2018-12-12,2018-12-12,,Joya\OUT\08882,,,Joya\OUT\08882,LUZ ESTHER CHAÑI CUTIRE,0,1.000000,-3.000000,0,0,0.000000,0.000000,0,"",252403 - Uniforme e Implemento de Seguridad,21.02.01 LIXIVIACIÓN Y ABSORCION,"",,,,,
Physical Locations / Joya / Stock,Ubicaciones virtuales / Produccion,/ Joya / Stock,07,Uniformes e Implementos de Seguridad,110-0055-01,Par,GUANTES DE LATEX NEGRO T-9,2018-12-04,2018-12-04,,Joya\OUT\08807,,,Joya\OUT\08807,LUZ ESTHER CHAÑI CUTIRE,0,1.000000,-1.000000,0,0,0.000000,0.000000,0,"",252403 - Uniforme e Implemento de Seguridad,21.02.01 LIXIVIACIÓN Y ABSORCION,"",,,,,
Physical Locations / Joya / Stock,Ubicaciones virtuales / Produccion,/ Joya / Stock,07,Uniformes e Implementos de Seguridad,110-0055-01,Par,GUANTES DE LATEX NEGRO T-9,2018-12-12,2018-12-12,,Joya\OUT\08874,,,Joya\OUT\08874,LUZ ESTHER CHAÑI CUTIRE,0,1.000000,-2.000000,0,0,0.000000,0.000000,0,"",252403 - Uniforme e Implemento de Seguridad,21.02.01 LIXIVIACIÓN Y ABSORCION,"",,,,,
Physical Locations / Joya / Stock,Ubicaciones virtuales / Produccion,/ Joya / Stock,07,Uniformes e Implementos de Seguridad,110-0055-01,Par,GUANTES DE LATEX NEGRO T-9,2018-12-17,2018-12-17,,Joya\OUT\08979,,,Joya\OUT\08979,Harold Zambrano,0,2.000000,-4.000000,0,0,0.000000,0.000000,0,"",252403 - Uniforme e Implemento de Seguridad,21.02.01 LIXIVIACIÓN Y ABSORCION,"",,,,2018-12-17,
Physical Locations / Joya / Stock,Ubicaciones virtuales / Produccion,/ Joya / Stock,07,Uniformes e Implementos de Seguridad,110-0055-01,Par,GUANTES DE LATEX NEGRO T-9,2018-12-19,2018-12-19,,Joya\OUT\08963,,,Joya\OUT\08963,LUZ ESTHER CHAÑI CUTIRE,0,1.000000,-5.000000,0,0,0.000000,0.000000,0,"",252403 - Uniforme e Implemento de Seguridad,21.02.01 LIXIVIACIÓN Y ABSORCION,"",,,,,
Physical Locations / Joya / Stock,Ubicaciones virtuales / Produccion,/ Joya / Stock,07,Uniformes e Implementos de Seguridad,110-0055-01,Par,GUANTES DE LATEX NEGRO T-9,2018-12-19,2018-12-19,,Joya\OUT\08964,,,Joya\OUT\08964,LUZ ESTHER CHAÑI CUTIRE,0,1.000000,-6.000000,0,0,0.000000,0.000000,0,"",252403 - Uniforme e Implemento de Seguridad,21.02.01 LIXIVIACIÓN Y ABSORCION,"",,,,,
Physical Locations / Joya / Stock,Ubicaciones virtuales / Produccion,/ Joya / Stock,08,Uniformes e Implementos de Seguridad,110-0055-01,Par,GUANTES DE LATEX NEGRO T-9,2018-12-22,2018-12-22,,Joya\OUT\09003,,,Joya\OUT\09003,LUCIANO RUBEN VIZA CHOQUE,0,1.000000,-7.000000,0,0,0.000000,0.000000,0,"",252403 - Uniforme e Implemento de Seguridad,"01.01.11	GESTION PLANTA,COMERCIAL Y ADMIN.","",,,,,
Physical Locations / Joya / Stock,Ubicaciones virtuales / Produccion,/ Joya / Stock,08,Uniformes e Implementos de Seguridad,110-0055-01,Par,GUANTES DE LATEX NEGRO T-9,2018-12-23,2018-12-23,,Joya\OUT\09021,,,Joya\OUT\09021,LUCIANO RUBEN VIZA CHOQUE,0,1.000000,-8.000000,0,0,0.000000,0.000000,0,"",252403 - Uniforme e Implemento de Seguridad,"01.01.11	GESTION PLANTA,COMERCIAL Y ADMIN.","",,,,,
Physical Locations / Joya / Stock,Ubicaciones virtuales / Produccion,/ Joya / Stock,07,Uniformes e Implementos de Seguridad,110-0055-01,Par,GUANTES DE LATEX NEGRO T-9,2018-12-26,2018-12-26,,Joya\OUT\09037,,,Joya\OUT\09037,LUZ ESTHER CHAÑI CUTIRE,0,1.000000,-9.000000,0,0,0.000000,0.000000,0,"",252403 - Uniforme e Implemento de Seguridad,21.02.01 LIXIVIACIÓN Y ABSORCION,"",,,,,
Physical Locations / Joya / Stock,Ubicaciones virtuales / Produccion,/ Joya / Stock,08,Uniformes e Implementos de Seguridad,110-0061-01,Unit(s),LENTES DE MEDIDA CLAROS,2018-12-26,2018-12-26,,Joya\OUT\09049,,,Joya\OUT\09049,LUCIANO RUBEN VIZA CHOQUE,0,1.000000,-1.000000,0,0,0.000000,0.000000,0,"",252403 - Uniforme e Implemento de Seguridad,20.05.02 LABORATORIO QUIMICO,"",,,,,
Physical Locations / Joya / Stock,Ubicaciones virtuales / Produccion,/ Joya / Stock,07,Uniformes e Implementos de Seguridad,110-0061-01,Unit(s),LENTES DE MEDIDA CLAROS,2018-12-27,2018-12-27,,Joya\OUT\09053,,,Joya\OUT\09053,LUZ ESTHER CHAÑI CUTIRE,0,1.000000,-2.000000,0,0,0.000000,0.000000,0,"",252403 - Uniforme e Implemento de Seguridad,25.01.03 TALLER DE MANTENIMIENTO,"",,,,,
Physical Locations / Joya / Stock,Ubicaciones virtuales / Produccion,/ Joya / Stock,07,Uniformes e Implementos de Seguridad,110-0062-01,Unit(s),LENTES DE MEDIDA OSCUROS,2018-12-27,2018-12-27,,Joya\OUT\09053,,,Joya\OUT\09053,LUZ ESTHER CHAÑI CUTIRE,0,1.000000,-1.000000,0,0,0.000000,0.000000,0,"",252403 - Uniforme e Implemento de Seguridad,25.01.03 TALLER DE MANTENIMIENTO,"",,,,,
Physical Locations / Joya / Stock,Ubicaciones virtuales / Produccion,/ Joya / Stock,07,Uniformes e Implementos de Seguridad,110-0064-01,Unit(s),LENTES OSCUROS,2018-12-04,2018-12-04,,Joya\OUT\08799,,,Joya\OUT\08799,LUZ ESTHER CHAÑI CUTIRE,0,1.000000,-1.000000,0,0,0.000000,0.000000,0,"",252403 - Uniforme e Implemento de Seguridad,25.01.03 TALLER DE MANTENIMIENTO,"",,,,,
Physical Locations / Joya / Stock,Ubicaciones virtuales / Produccion,/ Joya / Stock,07,Uniformes e Implementos de Seguridad,110-0064-01,Unit(s),LENTES OSCUROS,2018-12-04,2018-12-04,,Joya\OUT\08806,,,Joya\OUT\08806,LUZ ESTHER CHAÑI CUTIRE,0,1.000000,-2.000000,0,0,0.000000,0.000000,0,"",252403 - Uniforme e Implemento de Seguridad,25.01.03 TALLER DE MANTENIMIENTO,"",,,,,
Physical Locations / Joya / Stock,Ubicaciones virtuales / Produccion,/ Joya / Stock,08,Uniformes e Implementos de Seguridad,110-0064-01,Unit(s),LENTES OSCUROS,2018-12-05,2018-12-05,,Joya\OUT\08808,,,Joya\OUT\08808,LUZ ESTHER CHAÑI CUTIRE,0,1.000000,-3.000000,0,0,0.000000,0.000000,0,"",252403 - Uniforme e Implemento de Seguridad,22.01.03 DESORCIÓN,"",,,,,
Physical Locations / Joya / Stock,Ubicaciones virtuales / Produccion,/ Joya / Stock,07,Uniformes e Implementos de Seguridad,110-0064-01,Unit(s),LENTES OSCUROS,2018-12-05,2018-12-05,,Joya\OUT\08815,,,Joya\OUT\08815,LUZ ESTHER CHAÑI CUTIRE,0,1.000000,-4.000000,0,0,0.000000,0.000000,0,"",252403 - Uniforme e Implemento de Seguridad,23.05.01 SEGURIDAD Y MEDIO AMBIENTE,"",,,,,
Physical Locations / Joya / Stock,Ubicaciones virtuales / Produccion,/ Joya / Stock,07,Uniformes e Implementos de Seguridad,110-0064-01,Unit(s),LENTES OSCUROS,2018-12-07,2018-12-07,,Joya\OUT\08825,,,Joya\OUT\08825,LUZ ESTHER CHAÑI CUTIRE,0,1.000000,-5.000000,0,0,0.000000,0.000000,0,"",252403 - Uniforme e Implemento de Seguridad,20.03.03 CHANCADO,"",,,,,
Physical Locations / Joya / Stock,Ubicaciones virtuales / Produccion,/ Joya / Stock,07,Uniformes e Implementos de Seguridad,110-0064-01,Unit(s),LENTES OSCUROS,2018-12-12,2018-12-12,,Joya\OUT\08876,,,Joya\OUT\08876,LUZ ESTHER CHAÑI CUTIRE,0,1.000000,-6.000000,0,0,0.000000,0.000000,0,"",252403 - Uniforme e Implemento de Seguridad,20.05.02 LABORATORIO QUIMICO,"",,,,,
Physical Locations / Joya / Stock,Ubicaciones virtuales / Produccion,/ Joya / Stock,07,Uniformes e Implementos de Seguridad,110-0064-01,Unit(s),LENTES OSCUROS,2018-12-12,2018-12-12,,Joya\OUT\08878,,,Joya\OUT\08878,LUZ ESTHER CHAÑI CUTIRE,0,1.000000,-7.000000,0,0,0.000000,0.000000,0,"",252403 - Uniforme e Implemento de Seguridad,20.03.03 CHANCADO,"",,,,,
Physical Locations / Joya / Stock,Ubicaciones virtuales / Produccion,/ Joya / Stock,07,Uniformes e Implementos de Seguridad,110-0064-01,Unit(s),LENTES OSCUROS,2018-12-12,2018-12-12,,Joya\OUT\08879,,,Joya\OUT\08879,LUZ ESTHER CHAÑI CUTIRE,0,1.000000,-8.000000,0,0,0.000000,0.000000,0,"",252403 - Uniforme e Implemento de Seguridad,20.03.03 CHANCADO,"",,,,,
Physical Locations / Joya / Stock,Ubicaciones virtuales / Produccion,/ Joya / Stock,07,Uniformes e Implementos de Seguridad,110-0064-01,Unit(s),LENTES OSCUROS,2018-12-12,2018-12-12,,Joya\OUT\08880,,,Joya\OUT\08880,LUZ ESTHER CHAÑI CUTIRE,0,1.000000,-9.000000,0,0,0.000000,0.000000,0,"",252403 - Uniforme e Implemento de Seguridad,21.02.01 LIXIVIACIÓN Y ABSORCION,"",,,,,
Physical Locations / Joya / Stock,Ubicaciones virtuales / Produccion,/ Joya / Stock,07,Uniformes e Implementos de Seguridad,110-0064-01,Unit(s),LENTES OSCUROS,2018-12-12,2018-12-12,,Joya\OUT\08881,,,Joya\OUT\08881,LUZ ESTHER CHAÑI CUTIRE,0,1.000000,-10.000000,0,0,0.000000,0.000000,0,"",252403 - Uniforme e Implemento de Seguridad,20.03.03 CHANCADO,"",,,,,
Physical Locations / Joya / Stock,Ubicaciones virtuales / Produccion,/ Joya / Stock,07,Uniformes e Implementos de Seguridad,110-0064-01,Unit(s),LENTES OSCUROS,2018-12-12,2018-12-12,,Joya\OUT\08883,,,Joya\OUT\08883,LUZ ESTHER CHAÑI CUTIRE,0,1.000000,-11.000000,0,0,0.000000,0.000000,0,"",252403 - Uniforme e Implemento de Seguridad,20.03.03 CHANCADO,"",,,,,
Physical Locations / Joya / Stock,Ubicaciones virtuales / Produccion,/ Joya / Stock,07,Uniformes e Implementos de Seguridad,110-0064-01,Unit(s),LENTES OSCUROS,2018-12-12,2018-12-12,,Joya\OUT\08903,,,Joya\OUT\08903,LUZ ESTHER CHAÑI CUTIRE,0,1.000000,-12.000000,0,0,0.000000,0.000000,0,"",252403 - Uniforme e Implemento de Seguridad,21.02.01 LIXIVIACIÓN Y ABSORCION,"",,,,,
Physical Locations / Joya / Stock,Ubicaciones virtuales / Produccion,/ Joya / Stock,07,Uniformes e Implementos de Seguridad,110-0064-01,Unit(s),LENTES OSCUROS,2018-12-12,2018-12-12,,Joya\OUT\08904,,,Joya\OUT\08904,LUZ ESTHER CHAÑI CUTIRE,0,1.000000,-13.000000,0,0,0.000000,0.000000,0,"",252403 - Uniforme e Implemento de Seguridad,21.02.01 LIXIVIACIÓN Y ABSORCION,"",,,,,
Physical Locations / Joya / Stock,Ubicaciones virtuales / Produccion,/ Joya / Stock,07,Uniformes e Implementos de Seguridad,110-0064-01,Unit(s),LENTES OSCUROS,2018-12-17,2018-12-17,,Joya\OUT\08979,,,Joya\OUT\08979,Harold Zambrano,0,1.000000,-14.000000,0,0,0.000000,0.000000,0,"",252403 - Uniforme e Implemento de Seguridad,21.02.01 LIXIVIACIÓN Y ABSORCION,"",,,,2018-12-17,
Physical Locations / Joya / Stock,Ubicaciones virtuales / Produccion,/ Joya / Stock,07,Uniformes e Implementos de Seguridad,110-0064-01,Unit(s),LENTES OSCUROS,2018-12-18,2018-12-18,,Joya\OUT\08940,,,Joya\OUT\08940,LUZ ESTHER CHAÑI CUTIRE,0,1.000000,-15.000000,0,0,0.000000,0.000000,0,"",252403 - Uniforme e Implemento de Seguridad,25.01.03 TALLER DE MANTENIMIENTO,"",,,,,
Physical Locations / Joya / Stock,Ubicaciones virtuales / Produccion,/ Joya / Stock,07,Uniformes e Implementos de Seguridad,110-0064-01,Unit(s),LENTES OSCUROS,2018-12-18,2018-12-18,,Joya\OUT\08942,,,Joya\OUT\08942,LUCIANO RUBEN VIZA CHOQUE,0,1.000000,-16.000000,0,0,0.000000,0.000000,0,"",252403 - Uniforme e Implemento de Seguridad,23.05.01 SEGURIDAD Y MEDIO AMBIENTE,"",,,,,
Physical Locations / Joya / Stock,Ubicaciones virtuales / Produccion,/ Joya / Stock,07,Uniformes e Implementos de Seguridad,110-0064-01,Unit(s),LENTES OSCUROS,2018-12-19,2018-12-19,,Joya\OUT\08948,,,Joya\OUT\08948,LUZ ESTHER CHAÑI CUTIRE,0,1.000000,-17.000000,0,0,0.000000,0.000000,0,"",252403 - Uniforme e Implemento de Seguridad,20.03.03 CHANCADO,"",,,,,
Physical Locations / Joya / Stock,Ubicaciones virtuales / Produccion,/ Joya / Stock,07,Uniformes e Implementos de Seguridad,110-0064-01,Unit(s),LENTES OSCUROS,2018-12-19,2018-12-19,,Joya\OUT\08951,,,Joya\OUT\08951,LUZ ESTHER CHAÑI CUTIRE,0,1.000000,-18.000000,0,0,0.000000,0.000000,0,"",252403 - Uniforme e Implemento de Seguridad,20.03.03 CHANCADO,"",,,,,
Physical Locations / Joya / Stock,Ubicaciones virtuales / Produccion,/ Joya / Stock,07,Uniformes e Implementos de Seguridad,110-0064-01,Unit(s),LENTES OSCUROS,2018-12-19,2018-12-19,,Joya\OUT\08952,,,Joya\OUT\08952,LUZ ESTHER CHAÑI CUTIRE,0,1.000000,-19.000000,0,0,0.000000,0.000000,0,"",252403 - Uniforme e Implemento de Seguridad,20.03.03 CHANCADO,"",,,,,
Physical Locations / Joya / Stock,Ubicaciones virtuales / Produccion,/ Joya / Stock,07,Uniformes e Implementos de Seguridad,110-0064-01,Unit(s),LENTES OSCUROS,2018-12-19,2018-12-19,,Joya\OUT\08953,,,Joya\OUT\08953,LUZ ESTHER CHAÑI CUTIRE,0,1.000000,-20.000000,0,0,0.000000,0.000000,0,"",252403 - Uniforme e Implemento de Seguridad,21.02.01 LIXIVIACIÓN Y ABSORCION,"",,,,,
Physical Locations / Joya / Stock,Ubicaciones virtuales / Produccion,/ Joya / Stock,07,Uniformes e Implementos de Seguridad,110-0064-01,Unit(s),LENTES OSCUROS,2018-12-19,2018-12-19,,Joya\OUT\08964,,,Joya\OUT\08964,LUZ ESTHER CHAÑI CUTIRE,0,1.000000,-21.000000,0,0,0.000000,0.000000,0,"",252403 - Uniforme e Implemento de Seguridad,21.02.01 LIXIVIACIÓN Y ABSORCION,"",,,,,
Physical Locations / Joya / Stock,Ubicaciones virtuales / Produccion,/ Joya / Stock,07,Uniformes e Implementos de Seguridad,110-0064-01,Unit(s),LENTES OSCUROS,2018-12-20,2018-12-20,,Joya\OUT\08980,,,Joya\OUT\08980,LUCIANO RUBEN VIZA CHOQUE,0,1.000000,-22.000000,0,0,0.000000,0.000000,0,"",252403 - Uniforme e Implemento de Seguridad,20.05.23	EXTRACTOR DE POLVO SEGUN ESPECIFICACIONES TECNICAS DE MANTENIMIENTO,"",,,,,
Physical Locations / Joya / Stock,Ubicaciones virtuales / Produccion,/ Joya / Stock,07,Uniformes e Implementos de Seguridad,110-0064-01,Unit(s),LENTES OSCUROS,2018-12-20,2018-12-20,,Joya\OUT\08981,,,Joya\OUT\08981,LUZ ESTHER CHAÑI CUTIRE,0,1.000000,-23.000000,0,0,0.000000,0.000000,0,"",252403 - Uniforme e Implemento de Seguridad,20.03.03 CHANCADO,"",,,,,
Physical Locations / Joya / Stock,Ubicaciones virtuales / Produccion,/ Joya / Stock,07,Uniformes e Implementos de Seguridad,110-0064-01,Unit(s),LENTES OSCUROS,2018-12-20,2018-12-20,,Joya\OUT\08985,,,Joya\OUT\08985,LUCIANO RUBEN VIZA CHOQUE,0,1.000000,-24.000000,0,0,0.000000,0.000000,0,"",252403 - Uniforme e Implemento de Seguridad,20.03.03 CHANCADO,"",,,,,
Physical Locations / Joya / Stock,Ubicaciones virtuales / Produccion,/ Joya / Stock,08,Uniformes e Implementos de Seguridad,110-0064-01,Unit(s),LENTES OSCUROS,2018-12-22,2018-12-22,,Joya\OUT\09004,,,Joya\OUT\09004,LUCIANO RUBEN VIZA CHOQUE,0,1.000000,-25.000000,0,0,0.000000,0.000000,0,"",252403 - Uniforme e Implemento de Seguridad,"01.01.11	GESTION PLANTA,COMERCIAL Y ADMIN.","",,,,,
Physical Locations / Joya / Stock,Ubicaciones virtuales / Produccion,/ Joya / Stock,08,Uniformes e Implementos de Seguridad,110-0064-01,Unit(s),LENTES OSCUROS,2018-12-24,2018-12-24,,Joya\OUT\09022,,,Joya\OUT\09022,LUCIANO RUBEN VIZA CHOQUE,0,1.000000,-26.000000,0,0,0.000000,0.000000,0,"",252403 - Uniforme e Implemento de Seguridad,20.03.03 CHANCADO,"",,,,,
Physical Locations / Joya / Stock,Ubicaciones virtuales / Produccion,/ Joya / Stock,07,Uniformes e Implementos de Seguridad,110-0064-01,Unit(s),LENTES OSCUROS,2018-12-24,2018-12-24,,Joya\OUT\09029,,,Joya\OUT\09029,LUZ ESTHER CHAÑI CUTIRE,0,1.000000,-27.000000,0,0,0.000000,0.000000,0,"",252403 - Uniforme e Implemento de Seguridad,29.01.81 MEJORAS EN SISTEMA DE ELECTRODEPOSICION Y MEJORAS SISTEMA DE COSECHAS DE CARBÓN,"",,,,,
Physical Locations / Joya / Stock,Ubicaciones virtuales / Produccion,/ Joya / Stock,07,Uniformes e Implementos de Seguridad,110-0064-01,Unit(s),LENTES OSCUROS,2018-12-24,2018-12-24,,Joya\OUT\09031,,,Joya\OUT\09031,LUZ ESTHER CHAÑI CUTIRE,0,1.000000,-28.000000,0,0,0.000000,0.000000,0,"",252403 - Uniforme e Implemento de Seguridad,23.05.01 SEGURIDAD Y MEDIO AMBIENTE,"",,,,,
Physical Locations / Joya / Stock,Ubicaciones virtuales / Produccion,/ Joya / Stock,07,Uniformes e Implementos de Seguridad,110-0064-01,Unit(s),LENTES OSCUROS,2018-12-26,2018-12-26,,Joya\OUT\09040,,,Joya\OUT\09040,LUZ ESTHER CHAÑI CUTIRE,0,1.000000,-29.000000,0,0,0.000000,0.000000,0,"",252403 - Uniforme e Implemento de Seguridad,20.03.03 CHANCADO,"",,,,,
Physical Locations / Joya / Stock,Ubicaciones virtuales / Produccion,/ Joya / Stock,08,Uniformes e Implementos de Seguridad,110-0064-01,Unit(s),LENTES OSCUROS,2018-12-26,2018-12-26,,Joya\OUT\09042,,,Joya\OUT\09042,LUCIANO RUBEN VIZA CHOQUE,0,1.000000,-30.000000,0,0,0.000000,0.000000,0,"",252403 - Uniforme e Implemento de Seguridad,20.03.03 CHANCADO,"",,,,,
Physical Locations / Joya / Stock,Ubicaciones virtuales / Produccion,/ Joya / Stock,08,Uniformes e Implementos de Seguridad,110-0064-01,Unit(s),LENTES OSCUROS,2018-12-26,2018-12-26,,Joya\OUT\09047,,,Joya\OUT\09047,LUCIANO RUBEN VIZA CHOQUE,0,1.000000,-31.000000,0,0,0.000000,0.000000,0,"",252403 - Uniforme e Implemento de Seguridad,20.03.03 CHANCADO,"",,,,,
Physical Locations / Joya / Stock,Ubicaciones virtuales / Produccion,/ Joya / Stock,08,Uniformes e Implementos de Seguridad,110-0064-01,Unit(s),LENTES OSCUROS,2018-12-26,2018-12-26,,Joya\OUT\09048,,,Joya\OUT\09048,LUCIANO RUBEN VIZA CHOQUE,0,1.000000,-32.000000,0,0,0.000000,0.000000,0,"",252403 - Uniforme e Implemento de Seguridad,25.01.03 TALLER DE MANTENIMIENTO,"",,,,,
Physical Locations / Joya / Stock,Ubicaciones virtuales / Produccion,/ Joya / Stock,07,Uniformes e Implementos de Seguridad,110-0064-01,Unit(s),LENTES OSCUROS,2018-12-28,2018-12-28,,Joya\OUT\09061,,,Joya\OUT\09061,LUZ ESTHER CHAÑI CUTIRE,0,1.000000,-33.000000,0,0,0.000000,0.000000,0,"",252403 - Uniforme e Implemento de Seguridad,25.01.03 TALLER DE MANTENIMIENTO,"",,,,,
Partner Locations / Suppliers,Physical Locations / Joya / Stock,/ Joya / Stock,03,Uniformes e Implementos de Seguridad,110-0064-01,Unit(s),LENTES OSCUROS,2018-12-30,2018-12-30,12/2018,Joya\IN\02944,01,0002,0003221,ESTHER SANDRA PINEDA LOAYZA,24.000000,0,-9.000000,4.24,101.76,0,101.760000,0,603203 - Uniforme e Implemento de Seguridad,252403 - Uniforme e Implemento de Seguridad,,"",,19PO00024,LM-001642,2018-12-30,
Physical Locations / Joya / Stock,Ubicaciones virtuales / Produccion,/ Joya / Stock,07,Uniformes e Implementos de Seguridad,110-0065-01,Unit(s),LENTES CLAROS,2018-12-04,2018-12-04,,Joya\OUT\08806,,,Joya\OUT\08806,LUZ ESTHER CHAÑI CUTIRE,0,1.000000,-1.000000,0,0,0.000000,0.000000,0,"",252403 - Uniforme e Implemento de Seguridad,25.01.03 TALLER DE MANTENIMIENTO,"",,,,,
Physical Locations / Joya / Stock,Ubicaciones virtuales / Produccion,/ Joya / Stock,07,Uniformes e Implementos de Seguridad,110-0065-01,Unit(s),LENTES CLAROS,2018-12-07,2018-12-07,,Joya\OUT\08825,,,Joya\OUT\08825,LUZ ESTHER CHAÑI CUTIRE,0,1.000000,-2.000000,0,0,0.000000,0.000000,0,"",252403 - Uniforme e Implemento de Seguridad,20.03.03 CHANCADO,"",,,,,
Physical Locations / Joya / Stock,Ubicaciones virtuales / Produccion,/ Joya / Stock,07,Uniformes e Implementos de Seguridad,110-0065-01,Unit(s),LENTES CLAROS,2018-12-09,2018-12-09,,Joya\OUT\08850,,,Joya\OUT\08850,Harold Zambrano,0,1.000000,-3.000000,0,0,0.000000,0.000000,0,"",252403 - Uniforme e Implemento de Seguridad,21.01.01 MOLIENDA,"",,,,,
Physical Locations / Joya / Stock,Ubicaciones virtuales / Produccion,/ Joya / Stock,07,Uniformes e Implementos de Seguridad,110-0065-01,Unit(s),LENTES CLAROS,2018-12-10,2018-12-10,,Joya\OUT\08853,,,Joya\OUT\08853,LUZ ESTHER CHAÑI CUTIRE,0,1.000000,-4.000000,0,0,0.000000,0.000000,0,"",252403 - Uniforme e Implemento de Seguridad,20.03.03 CHANCADO,"",,,,,
Physical Locations / Joya / Stock,Ubicaciones virtuales / Produccion,/ Joya / Stock,07,Uniformes e Implementos de Seguridad,110-0065-01,Unit(s),LENTES CLAROS,2018-12-11,2018-12-11,,Joya\OUT\08866,,,Joya\OUT\08866,LUZ ESTHER CHAÑI CUTIRE,0,1.000000,-5.000000,0,0,0.000000,0.000000,0,"",252403 - Uniforme e Implemento de Seguridad,21.02.01 LIXIVIACIÓN Y ABSORCION,"",,,,,
Physical Locations / Joya / Stock,Ubicaciones virtuales / Produccion,/ Joya / Stock,07,Uniformes e Implementos de Seguridad,110-0065-01,Unit(s),LENTES CLAROS,2018-12-12,2018-12-12,,Joya\OUT\08874,,,Joya\OUT\08874,LUZ ESTHER CHAÑI CUTIRE,0,1.000000,-6.000000,0,0,0.000000,0.000000,0,"",252403 - Uniforme e Implemento de Seguridad,22.01.03 DESORCIÓN,"",,,,,
Physical Locations / Joya / Stock,Ubicaciones virtuales / Produccion,/ Joya / Stock,07,Uniformes e Implementos de Seguridad,110-0065-01,Unit(s),LENTES CLAROS,2018-12-12,2018-12-12,,Joya\OUT\08877,,,Joya\OUT\08877,LUZ ESTHER CHAÑI CUTIRE,0,1.000000,-7.000000,0,0,0.000000,0.000000,0,"",252403 - Uniforme e Implemento de Seguridad,20.05.02 LABORATORIO QUIMICO,"",,,,,
Physical Locations / Joya / Stock,Ubicaciones virtuales / Produccion,/ Joya / Stock,07,Uniformes e Implementos de Seguridad,110-0065-01,Unit(s),LENTES CLAROS,2018-12-12,2018-12-12,,Joya\OUT\08883,,,Joya\OUT\08883,LUZ ESTHER CHAÑI CUTIRE,0,1.000000,-8.000000,0,0,0.000000,0.000000,0,"",252403 - Uniforme e Implemento de Seguridad,20.03.03 CHANCADO,"",,,,,
Physical Locations / Joya / Stock,Ubicaciones virtuales / Produccion,/ Joya / Stock,07,Uniformes e Implementos de Seguridad,110-0065-01,Unit(s),LENTES CLAROS,2018-12-12,2018-12-12,,Joya\OUT\08891,,,Joya\OUT\08891,LUZ ESTHER CHAÑI CUTIRE,0,1.000000,-9.000000,0,0,0.000000,0.000000,0,"",252403 - Uniforme e Implemento de Seguridad,20.03.03 CHANCADO,"",,,,,
Physical Locations / Joya / Stock,Ubicaciones virtuales / Produccion,/ Joya / Stock,07,Uniformes e Implementos de Seguridad,110-0065-01,Unit(s),LENTES CLAROS,2018-12-12,2018-12-12,,Joya\OUT\08893,,,Joya\OUT\08893,LUZ ESTHER CHAÑI CUTIRE,0,1.000000,-10.000000,0,0,0.000000,0.000000,0,"",252403 - Uniforme e Implemento de Seguridad,21.02.01 LIXIVIACIÓN Y ABSORCION,"",,,,,
Physical Locations / Joya / Stock,Ubicaciones virtuales / Produccion,/ Joya / Stock,07,Uniformes e Implementos de Seguridad,110-0065-01,Unit(s),LENTES CLAROS,2018-12-12,2018-12-12,,Joya\OUT\08895,,,Joya\OUT\08895,LUZ ESTHER CHAÑI CUTIRE,0,1.000000,-11.000000,0,0,0.000000,0.000000,0,"",252403 - Uniforme e Implemento de Seguridad,20.03.03 CHANCADO,"",,,,,
Physical Locations / Joya / Stock,Ubicaciones virtuales / Produccion,/ Joya / Stock,07,Uniformes e Implementos de Seguridad,110-0065-01,Unit(s),LENTES CLAROS,2018-12-12,2018-12-12,,Joya\OUT\08900,,,Joya\OUT\08900,LUZ ESTHER CHAÑI CUTIRE,0,1.000000,-12.000000,0,0,0.000000,0.000000,0,"",252403 - Uniforme e Implemento de Seguridad,21.02.01 LIXIVIACIÓN Y ABSORCION,"",,,,,
Physical Locations / Joya / Stock,Ubicaciones virtuales / Produccion,/ Joya / Stock,07,Uniformes e Implementos de Seguridad,110-0065-01,Unit(s),LENTES CLAROS,2018-12-12,2018-12-12,,Joya\OUT\08902,,,Joya\OUT\08902,LUZ ESTHER CHAÑI CUTIRE,0,1.000000,-13.000000,0,0,0.000000,0.000000,0,"",252403 - Uniforme e Implemento de Seguridad,20.05.02 LABORATORIO QUIMICO,"",,,,,
Physical Locations / Joya / Stock,Ubicaciones virtuales / Produccion,/ Joya / Stock,07,Uniformes e Implementos de Seguridad,110-0065-01,Unit(s),LENTES CLAROS,2018-12-18,2018-12-18,,Joya\OUT\08942,,,Joya\OUT\08942,LUCIANO RUBEN VIZA CHOQUE,0,1.000000,-14.000000,0,0,0.000000,0.000000,0,"",252403 - Uniforme e Implemento de Seguridad,23.05.01 SEGURIDAD Y MEDIO AMBIENTE,"",,,,,
Physical Locations / Joya / Stock,Ubicaciones virtuales / Produccion,/ Joya / Stock,07,Uniformes e Implementos de Seguridad,110-0065-01,Unit(s),LENTES CLAROS,2018-12-19,2018-12-19,,Joya\OUT\08948,,,Joya\OUT\08948,LUZ ESTHER CHAÑI CUTIRE,0,1.000000,-15.000000,0,0,0.000000,0.000000,0,"",252403 - Uniforme e Implemento de Seguridad,20.03.03 CHANCADO,"",,,,,
Physical Locations / Joya / Stock,Ubicaciones virtuales / Produccion,/ Joya / Stock,07,Uniformes e Implementos de Seguridad,110-0065-01,Unit(s),LENTES CLAROS,2018-12-19,2018-12-19,,Joya\OUT\08951,,,Joya\OUT\08951,LUZ ESTHER CHAÑI CUTIRE,0,1.000000,-16.000000,0,0,0.000000,0.000000,0,"",252403 - Uniforme e Implemento de Seguridad,20.03.03 CHANCADO,"",,,,,
Physical Locations / Joya / Stock,Ubicaciones virtuales / Produccion,/ Joya / Stock,07,Uniformes e Implementos de Seguridad,110-0065-01,Unit(s),LENTES CLAROS,2018-12-19,2018-12-19,,Joya\OUT\08952,,,Joya\OUT\08952,LUZ ESTHER CHAÑI CUTIRE,0,1.000000,-17.000000,0,0,0.000000,0.000000,0,"",252403 - Uniforme e Implemento de Seguridad,20.03.03 CHANCADO,"",,,,,
Physical Locations / Joya / Stock,Ubicaciones virtuales / Produccion,/ Joya / Stock,07,Uniformes e Implementos de Seguridad,110-0065-01,Unit(s),LENTES CLAROS,2018-12-19,2018-12-19,,Joya\OUT\08953,,,Joya\OUT\08953,LUZ ESTHER CHAÑI CUTIRE,0,1.000000,-18.000000,0,0,0.000000,0.000000,0,"",252403 - Uniforme e Implemento de Seguridad,21.02.01 LIXIVIACIÓN Y ABSORCION,"",,,,,
Physical Locations / Joya / Stock,Ubicaciones virtuales / Produccion,/ Joya / Stock,07,Uniformes e Implementos de Seguridad,110-0065-01,Unit(s),LENTES CLAROS,2018-12-19,2018-12-19,,Joya\OUT\08955,,,Joya\OUT\08955,LUZ ESTHER CHAÑI CUTIRE,0,1.000000,-19.000000,0,0,0.000000,0.000000,0,"",252403 - Uniforme e Implemento de Seguridad,20.03.03 CHANCADO,"",,,,,
Physical Locations / Joya / Stock,Ubicaciones virtuales / Produccion,/ Joya / Stock,07,Uniformes e Implementos de Seguridad,110-0065-01,Unit(s),LENTES CLAROS,2018-12-19,2018-12-19,,Joya\OUT\08964,,,Joya\OUT\08964,LUZ ESTHER CHAÑI CUTIRE,0,1.000000,-20.000000,0,0,0.000000,0.000000,0,"",252403 - Uniforme e Implemento de Seguridad,21.02.01 LIXIVIACIÓN Y ABSORCION,"",,,,,
Physical Locations / Joya / Stock,Ubicaciones virtuales / Produccion,/ Joya / Stock,07,Uniformes e Implementos de Seguridad,110-0065-01,Unit(s),LENTES CLAROS,2018-12-19,2018-12-19,,Joya\OUT\08965,,,Joya\OUT\08965,LUZ ESTHER CHAÑI CUTIRE,0,1.000000,-21.000000,0,0,0.000000,0.000000,0,"",252403 - Uniforme e Implemento de Seguridad,21.02.01 LIXIVIACIÓN Y ABSORCION,"",,,,,
Physical Locations / Joya / Stock,Ubicaciones virtuales / Produccion,/ Joya / Stock,07,Uniformes e Implementos de Seguridad,110-0065-01,Unit(s),LENTES CLAROS,2018-12-19,2018-12-19,,Joya\OUT\08970,,,Joya\OUT\08970,LUZ ESTHER CHAÑI CUTIRE,0,1.000000,-22.000000,0,0,0.000000,0.000000,0,"",252403 - Uniforme e Implemento de Seguridad,31.00.01 JEFATURA INGENIERIA Y PROYECTOS,"",,,,,
Physical Locations / Joya / Stock,Ubicaciones virtuales / Produccion,/ Joya / Stock,07,Uniformes e Implementos de Seguridad,110-0065-01,Unit(s),LENTES CLAROS,2018-12-20,2018-12-20,,Joya\OUT\08981,,,Joya\OUT\08981,LUZ ESTHER CHAÑI CUTIRE,0,1.000000,-23.000000,0,0,0.000000,0.000000,0,"",252403 - Uniforme e Implemento de Seguridad,20.03.03 CHANCADO,"",,,,,
Physical Locations / Joya / Stock,Ubicaciones virtuales / Produccion,/ Joya / Stock,07,Uniformes e Implementos de Seguridad,110-0065-01,Unit(s),LENTES CLAROS,2018-12-20,2018-12-20,,Joya\OUT\08985,,,Joya\OUT\08985,LUCIANO RUBEN VIZA CHOQUE,0,1.000000,-24.000000,0,0,0.000000,0.000000,0,"",252403 - Uniforme e Implemento de Seguridad,"20.03.15 CHANCADORA DE QUIJADA 16"" X 24"".","",,,,,
Physical Locations / Joya / Stock,Ubicaciones virtuales / Produccion,/ Joya / Stock,08,Uniformes e Implementos de Seguridad,110-0065-01,Unit(s),LENTES CLAROS,2018-12-24,2018-12-24,,Joya\OUT\09026,,,Joya\OUT\09026,LUCIANO RUBEN VIZA CHOQUE,0,1.000000,-25.000000,0,0,0.000000,0.000000,0,"",252403 - Uniforme e Implemento de Seguridad,20.05.02 LABORATORIO QUIMICO,"",,,,,
Physical Locations / Joya / Stock,Ubicaciones virtuales / Produccion,/ Joya / Stock,07,Uniformes e Implementos de Seguridad,110-0065-01,Unit(s),LENTES CLAROS,2018-12-24,2018-12-24,,Joya\OUT\09029,,,Joya\OUT\09029,LUZ ESTHER CHAÑI CUTIRE,0,1.000000,-26.000000,0,0,0.000000,0.000000,0,"",252403 - Uniforme e Implemento de Seguridad,29.01.81 MEJORAS EN SISTEMA DE ELECTRODEPOSICION Y MEJORAS SISTEMA DE COSECHAS DE CARBÓN,"",,,,,
Physical Locations / Joya / Stock,Ubicaciones virtuales / Produccion,/ Joya / Stock,07,Uniformes e Implementos de Seguridad,110-0065-01,Unit(s),LENTES CLAROS,2018-12-24,2018-12-24,,Joya\OUT\09031,,,Joya\OUT\09031,LUZ ESTHER CHAÑI CUTIRE,0,1.000000,-27.000000,0,0,0.000000,0.000000,0,"",252403 - Uniforme e Implemento de Seguridad,23.05.01 SEGURIDAD Y MEDIO AMBIENTE,"",,,,,
Physical Locations / Joya / Stock,Ubicaciones virtuales / Produccion,/ Joya / Stock,07,Uniformes e Implementos de Seguridad,110-0065-01,Unit(s),LENTES CLAROS,2018-12-26,2018-12-26,,Joya\OUT\09037,,,Joya\OUT\09037,LUZ ESTHER CHAÑI CUTIRE,0,1.000000,-28.000000,0,0,0.000000,0.000000,0,"",252403 - Uniforme e Implemento de Seguridad,21.02.01 LIXIVIACIÓN Y ABSORCION,"",,,,,
Physical Locations / Joya / Stock,Ubicaciones virtuales / Produccion,/ Joya / Stock,07,Uniformes e Implementos de Seguridad,110-0065-01,Unit(s),LENTES CLAROS,2018-12-26,2018-12-26,,Joya\OUT\09040,,,Joya\OUT\09040,LUZ ESTHER CHAÑI CUTIRE,0,1.000000,-29.000000,0,0,0.000000,0.000000,0,"",252403 - Uniforme e Implemento de Seguridad,20.03.03 CHANCADO,"",,,,,
Physical Locations / Joya / Stock,Ubicaciones virtuales / Produccion,/ Joya / Stock,07,Uniformes e Implementos de Seguridad,110-0065-01,Unit(s),LENTES CLAROS,2018-12-26,2018-12-26,,Joya\OUT\09043,,,Joya\OUT\09043,LUZ ESTHER CHAÑI CUTIRE,0,1.000000,-30.000000,0,0,0.000000,0.000000,0,"",252403 - Uniforme e Implemento de Seguridad,22.01.03 DESORCIÓN,"",,,,,
Physical Locations / Joya / Stock,Ubicaciones virtuales / Produccion,/ Joya / Stock,08,Uniformes e Implementos de Seguridad,110-0065-01,Unit(s),LENTES CLAROS,2018-12-26,2018-12-26,,Joya\OUT\09047,,,Joya\OUT\09047,LUCIANO RUBEN VIZA CHOQUE,0,1.000000,-31.000000,0,0,0.000000,0.000000,0,"",252403 - Uniforme e Implemento de Seguridad,20.03.03 CHANCADO,"",,,,,
Physical Locations / Joya / Stock,Ubicaciones virtuales / Produccion,/ Joya / Stock,08,Uniformes e Implementos de Seguridad,110-0065-01,Unit(s),LENTES CLAROS,2018-12-26,2018-12-26,,Joya\OUT\09048,,,Joya\OUT\09048,LUCIANO RUBEN VIZA CHOQUE,0,1.000000,-32.000000,0,0,0.000000,0.000000,0,"",252403 - Uniforme e Implemento de Seguridad,25.01.03 TALLER DE MANTENIMIENTO,"",,,,,
Physical Locations / Joya / Stock,Ubicaciones virtuales / Produccion,/ Joya / Stock,07,Uniformes e Implementos de Seguridad,110-0065-01,Unit(s),LENTES CLAROS,2018-12-27,2018-12-27,,Joya\OUT\09052,,,Joya\OUT\09052,LUZ ESTHER CHAÑI CUTIRE,0,1.000000,-33.000000,0,0,0.000000,0.000000,0,"",252403 - Uniforme e Implemento de Seguridad,20.05.02 LABORATORIO QUIMICO,"",,,,,
Physical Locations / Joya / Stock,Ubicaciones virtuales / Produccion,/ Joya / Stock,07,Uniformes e Implementos de Seguridad,110-0065-01,Unit(s),LENTES CLAROS,2018-12-28,2018-12-28,,Joya\OUT\09061,,,Joya\OUT\09061,LUZ ESTHER CHAÑI CUTIRE,0,1.000000,-34.000000,0,0,0.000000,0.000000,0,"",252403 - Uniforme e Implemento de Seguridad,25.01.03 TALLER DE MANTENIMIENTO,"",,,,,
Partner Locations / Suppliers,Physical Locations / Joya / Stock,/ Joya / Stock,03,Uniformes e Implementos de Seguridad,110-0065-01,Unit(s),LENTES CLAROS,2018-12-30,2018-12-30,12/2018,Joya\IN\02944,01,0002,0003221,ESTHER SANDRA PINEDA LOAYZA,24.000000,0,-10.000000,4.24,101.76,0,101.760000,0,603203 - Uniforme e Implemento de Seguridad,252403 - Uniforme e Implemento de Seguridad,,"",,19PO00024,LM-001642,2018-12-30,
Physical Locations / Joya / Stock,Ubicaciones virtuales / Produccion,/ Joya / Stock,07,Uniformes e Implementos de Seguridad,110-0066-01,Unit(s),MANDIL ALUMINIZADO,2018-12-19,2018-12-19,,Joya\OUT\08948,,,Joya\OUT\08948,LUZ ESTHER CHAÑI CUTIRE,0,1.000000,-1.000000,0,0,0.000000,0.000000,0,"",252403 - Uniforme e Implemento de Seguridad,20.03.03 CHANCADO,"",,,,,
Physical Locations / Joya / Stock,Ubicaciones virtuales / Produccion,/ Joya / Stock,08,Uniformes e Implementos de Seguridad,110-0071-01,Unit(s),MICAS PARA CARETA,2018-12-28,2018-12-28,,Joya\OUT\09059,,,Joya\OUT\09059,EDISON (TRB) RAMOS HACHIRI,0,1.000000,-1.000000,0,0,0.000000,0.000000,0,"",252403 - Uniforme e Implemento de Seguridad,29.01.87 OPTIMIZACION DE SISTEMA ELECTRICO DE PLANTA,"",,,,2018-12-28,
Partner Locations / Suppliers,Physical Locations / Joya / Stock,/ Joya / Stock,03,Uniformes e Implementos de Seguridad,110-0072-01,Unit(s),OREJERAS,2018-12-01,2018-12-01,12/2018,Joya\IN\02929,01,0002,0003195,ESTHER SANDRA PINEDA LOAYZA,6.000000,0,6.000000,55.9316666666666667,335.59,0,335.59,55.9316666666666667,603203 - Uniforme e Implemento de Seguridad,252403 - Uniforme e Implemento de Seguridad,,"",,18PO06653,LM-001642,2018-12-01,
Physical Locations / Joya / Stock,Ubicaciones virtuales / Produccion,/ Joya / Stock,07,Uniformes e Implementos de Seguridad,110-0072-01,Unit(s),OREJERAS,2018-12-05,2018-12-05,,Joya\OUT\08810,,,Joya\OUT\08810,LUZ ESTHER CHAÑI CUTIRE,0,1.000000,5.000000,55.9316666666666667,0,55.9316666666666667000000,279.6583333333333333000000,55.9316666666666667,"",252403 - Uniforme e Implemento de Seguridad,20.05.02 LABORATORIO QUIMICO,"",,,,,
Physical Locations / Joya / Stock,Ubicaciones virtuales / Produccion,/ Joya / Stock,07,Uniformes e Implementos de Seguridad,110-0072-01,Unit(s),OREJERAS,2018-12-12,2018-12-12,,Joya\OUT\08883,,,Joya\OUT\08883,LUZ ESTHER CHAÑI CUTIRE,0,1.000000,4.000000,55.9316666666666667,0,55.9316666666666667000000,223.7266666666666666000000,55.9316666666666667,"",252403 - Uniforme e Implemento de Seguridad,20.03.03 CHANCADO,"",,,,,
Physical Locations / Joya / Stock,Ubicaciones virtuales / Produccion,/ Joya / Stock,07,Uniformes e Implementos de Seguridad,110-0072-01,Unit(s),OREJERAS,2018-12-12,2018-12-12,,Joya\OUT\08899,,,Joya\OUT\08899,LUZ ESTHER CHAÑI CUTIRE,0,1.000000,3.000000,55.9316666666666667,0,55.9316666666666667000000,167.7949999999999999000000,55.9316666666666667,"",252403 - Uniforme e Implemento de Seguridad,20.03.03 CHANCADO,"",,,,,
Physical Locations / Joya / Stock,Ubicaciones virtuales / Produccion,/ Joya / Stock,07,Uniformes e Implementos de Seguridad,110-0072-01,Unit(s),OREJERAS,2018-12-19,2018-12-19,,Joya\OUT\08953,,,Joya\OUT\08953,LUZ ESTHER CHAÑI CUTIRE,0,1.000000,2.000000,55.9316666666666667,0,55.9316666666666667000000,111.8633333333333332000000,55.9316666666666667,"",252403 - Uniforme e Implemento de Seguridad,21.02.01 LIXIVIACIÓN Y ABSORCION,"",,,,,
Physical Locations / Joya / Stock,Ubicaciones virtuales / Produccion,/ Joya / Stock,07,Uniformes e Implementos de Seguridad,110-0072-01,Unit(s),OREJERAS,2018-12-28,2018-12-28,,Joya\OUT\09061,,,Joya\OUT\09061,LUZ ESTHER CHAÑI CUTIRE,0,1.000000,1.000000,55.9316666666666667,0,55.9316666666666667000000,55.9316666666666665000000,55.9316666666666667,"",252403 - Uniforme e Implemento de Seguridad,20.03.22 IMAN SUSPENDIDO,"",,,,,
Physical Locations / Joya / Stock,Ubicaciones virtuales / Produccion,/ Joya / Stock,07,Uniformes e Implementos de Seguridad,110-0072-01,Unit(s),OREJERAS,2018-12-30,2018-12-30,,Joya\OUT\09084,,,Joya\OUT\09084,LUZ ESTHER CHAÑI CUTIRE,0,1.000000,0.000000,55.9316666666666667,0,55.9316666666666667000000,-0.0000000000000002000000,0,"",252403 - Uniforme e Implemento de Seguridad,21.02.01 LIXIVIACIÓN Y ABSORCION,"",,,,,
Partner Locations / Suppliers,Physical Locations / Joya / Stock,/ Joya / Stock,03,Uniformes e Implementos de Seguridad,110-0079-01,Unit(s),POLO DE SEGURIDAD L,2018-12-01,2018-12-01,12/2018,Joya\IN\02932,01,0002,0003201,ESTHER SANDRA PINEDA LOAYZA,2.000000,0,2.000000,16.1000000000000000,32.2,0,32.2,16.1000000000000000,603203 - Uniforme e Implemento de Seguridad,252403 - Uniforme e Implemento de Seguridad,,"",,18PO06655,LM-001573,2018-12-01,
Physical Locations / Joya / Stock,Ubicaciones virtuales / Produccion,/ Joya / Stock,07,Uniformes e Implementos de Seguridad,110-0079-01,Unit(s),POLO DE SEGURIDAD L,2018-12-12,2018-12-12,,Joya\OUT\08870,,,Joya\OUT\08870,LUZ ESTHER CHAÑI CUTIRE,0,1.000000,1.000000,16.1000000000000000,0,16.1000000000000000000000,16.1000000000000000000000,16.1000000000000000,"",252403 - Uniforme e Implemento de Seguridad,20.03.03 CHANCADO,"",,,,,
Physical Locations / Joya / Stock,Ubicaciones virtuales / Produccion,/ Joya / Stock,07,Uniformes e Implementos de Seguridad,110-0079-01,Unit(s),POLO DE SEGURIDAD L,2018-12-29,2018-12-29,,Joya\OUT\09071,,,Joya\OUT\09071,LUZ ESTHER CHAÑI CUTIRE,0,2.000000,-1.000000,16.1000000000000000,0,32.2000000000000000000000,-16.1000000000000000000000,0,"",252403 - Uniforme e Implemento de Seguridad,21.02.01 LIXIVIACIÓN Y ABSORCION,"",,,,2018-12-29,
Partner Locations / Suppliers,Physical Locations / Joya / Stock,/ Joya / Stock,03,Uniformes e Implementos de Seguridad,110-0080-01,Unit(s),POLO DE SEGURIDAD M,2018-12-01,2018-12-01,12/2018,Joya\IN\02932,01,0002,0003201,ESTHER SANDRA PINEDA LOAYZA,2.000000,0,2.000000,16.1000000000000000,32.2,0,32.2,16.1000000000000000,603203 - Uniforme e Implemento de Seguridad,252403 - Uniforme e Implemento de Seguridad,,"",,18PO06655,LM-001573,2018-12-01,
Physical Locations / Joya / Stock,Ubicaciones virtuales / Produccion,/ Joya / Stock,07,Uniformes e Implementos de Seguridad,110-0080-01,Unit(s),POLO DE SEGURIDAD M,2018-12-07,2018-12-07,,Joya\OUT\08825,,,Joya\OUT\08825,LUZ ESTHER CHAÑI CUTIRE,0,1.000000,1.000000,16.1000000000000000,0,16.1000000000000000000000,16.1000000000000000000000,16.1000000000000000,"",252403 - Uniforme e Implemento de Seguridad,20.03.03 CHANCADO,"",,,,,
Physical Locations / Joya / Stock,Ubicaciones virtuales / Produccion,/ Joya / Stock,07,Uniformes e Implementos de Seguridad,110-0080-01,Unit(s),POLO DE SEGURIDAD M,2018-12-07,2018-12-07,,Joya\OUT\08831,,,Joya\OUT\08831,LUZ ESTHER CHAÑI CUTIRE,0,1.000000,0.000000,16.1000000000000000,0,16.1000000000000000000000,0.0000000000000000000000,0,"",252403 - Uniforme e Implemento de Seguridad,20.03.03 CHANCADO,"",,,,,
Physical Locations / Joya / Stock,Ubicaciones virtuales / Produccion,/ Joya / Stock,07,Uniformes e Implementos de Seguridad,110-0080-01,Unit(s),POLO DE SEGURIDAD M,2018-12-24,2018-12-24,,Joya\OUT\09029,,,Joya\OUT\09029,LUZ ESTHER CHAÑI CUTIRE,0,1.000000,-1.000000,0,0,0.000000,0.0000000000000000000000,0,"",252403 - Uniforme e Implemento de Seguridad,29.01.81 MEJORAS EN SISTEMA DE ELECTRODEPOSICION Y MEJORAS SISTEMA DE COSECHAS DE CARBÓN,"",,,,,
Physical Locations / Joya / Stock,Ubicaciones virtuales / Produccion,/ Joya / Stock,07,Uniformes e Implementos de Seguridad,110-0080-01,Unit(s),POLO DE SEGURIDAD M,2018-12-25,2018-12-25,,Joya\OUT\09035,,,Joya\OUT\09035,LUIS FELIPE CARCAMO PALACO,0,1.000000,-2.000000,0,0,0.000000,0.0000000000000000000000,0,"",252403 - Uniforme e Implemento de Seguridad,21.02.01 LIXIVIACIÓN Y ABSORCION,"",,,,,
Physical Locations / Joya / Stock,Ubicaciones virtuales / Produccion,/ Joya / Stock,08,Uniformes e Implementos de Seguridad,110-0080-01,Unit(s),POLO DE SEGURIDAD M,2018-12-29,2018-12-29,,Joya\OUT\09066,,,Joya\OUT\09066,LUCIANO RUBEN VIZA CHOQUE,0,1.000000,-3.000000,0,0,0.000000,0.0000000000000000000000,0,"",252403 - Uniforme e Implemento de Seguridad,21.02.01 LIXIVIACIÓN Y ABSORCION,"",,,,,
Physical Locations / Joya / Stock,Ubicaciones virtuales / Produccion,/ Joya / Stock,07,Uniformes e Implementos de Seguridad,110-0080-01,Unit(s),POLO DE SEGURIDAD M,2018-12-30,2018-12-30,,Joya\OUT\08911,,,Joya\OUT\08911,LUZ ESTHER CHAÑI CUTIRE,0,1.000000,-4.000000,0,0,0.000000,0.0000000000000000000000,0,"",252403 - Uniforme e Implemento de Seguridad,23.02.01 ALMACENES,"",,,,2018-12-30,
Physical Locations / Joya / Stock,Ubicaciones virtuales / Produccion,/ Joya / Stock,07,Uniformes e Implementos de Seguridad,110-0081-01,Unit(s),POLO DE SEGURIDAD S,2018-12-19,2018-12-19,,Joya\OUT\08951,,,Joya\OUT\08951,LUZ ESTHER CHAÑI CUTIRE,0,1.000000,-1.000000,0,0,0.000000,0.000000,0,"",252403 - Uniforme e Implemento de Seguridad,20.03.03 CHANCADO,"",,,,,
Physical Locations / Joya / Stock,Ubicaciones virtuales / Produccion,/ Joya / Stock,07,Uniformes e Implementos de Seguridad,110-0081-01,Unit(s),POLO DE SEGURIDAD S,2018-12-19,2018-12-19,,Joya\OUT\08952,,,Joya\OUT\08952,LUZ ESTHER CHAÑI CUTIRE,0,1.000000,-2.000000,0,0,0.000000,0.000000,0,"",252403 - Uniforme e Implemento de Seguridad,20.03.03 CHANCADO,"",,,,,
Physical Locations / Joya / Stock,Ubicaciones virtuales / Produccion,/ Joya / Stock,07,Uniformes e Implementos de Seguridad,110-0081-01,Unit(s),POLO DE SEGURIDAD S,2018-12-27,2018-12-27,,Joya\OUT\09052,,,Joya\OUT\09052,LUZ ESTHER CHAÑI CUTIRE,0,1.000000,-3.000000,0,0,0.000000,0.000000,0,"",252403 - Uniforme e Implemento de Seguridad,20.05.02 LABORATORIO QUIMICO,"",,,,,
Physical Locations / Joya / Stock,Ubicaciones virtuales / Produccion,/ Joya / Stock,07,Uniformes e Implementos de Seguridad,110-0081-01,Unit(s),POLO DE SEGURIDAD S,2018-12-29,2018-12-29,,Joya\OUT\09072,,,Joya\OUT\09072,LUZ ESTHER CHAÑI CUTIRE,0,1.000000,-4.000000,0,0,0.000000,0.000000,0,"",252403 - Uniforme e Implemento de Seguridad,20.05.02 LABORATORIO QUIMICO,"",,,,,
Physical Locations / Joya / Stock,Ubicaciones virtuales / Produccion,/ Joya / Stock,07,Uniformes e Implementos de Seguridad,110-0081-01,Unit(s),POLO DE SEGURIDAD S,2018-12-29,2018-12-29,,Joya\OUT\09073,,,Joya\OUT\09073,LUZ ESTHER CHAÑI CUTIRE,0,1.000000,-5.000000,0,0,0.000000,0.000000,0,"",252403 - Uniforme e Implemento de Seguridad,20.05.02 LABORATORIO QUIMICO,"",,,,,
Physical Locations / Joya / Stock,Ubicaciones virtuales / Produccion,/ Joya / Stock,07,Uniformes e Implementos de Seguridad,110-0082-01,Unit(s),POLO DE SEGURIDAD XL,2018-12-21,2018-12-21,,Joya\OUT\08995,,,Joya\OUT\08995,LUZ ESTHER CHAÑI CUTIRE,0,1.000000,-1.000000,0,0,0.000000,0.000000,0,"",252403 - Uniforme e Implemento de Seguridad,20.03.03 CHANCADO,"",,,,,
Physical Locations / Joya / Stock,Ubicaciones virtuales / Produccion,/ Joya / Stock,07,Uniformes e Implementos de Seguridad,110-0082-01,Unit(s),POLO DE SEGURIDAD XL,2018-12-28,2018-12-28,,Joya\OUT\09061,,,Joya\OUT\09061,LUZ ESTHER CHAÑI CUTIRE,0,1.000000,-2.000000,0,0,0.000000,0.000000,0,"",252403 - Uniforme e Implemento de Seguridad,25.01.03 TALLER DE MANTENIMIENTO,"",,,,,
Physical Locations / Joya / Stock,Ubicaciones virtuales / Produccion,/ Joya / Stock,07,Uniformes e Implementos de Seguridad,110-0082-01,Unit(s),POLO DE SEGURIDAD XL,2018-12-29,2018-12-29,,Joya\OUT\09074,,,Joya\OUT\09074,LUZ ESTHER CHAÑI CUTIRE,0,1.000000,-3.000000,0,0,0.000000,0.000000,0,"",252403 - Uniforme e Implemento de Seguridad,20.03.03 CHANCADO,"",,,,,
Physical Locations / Joya / Stock,Ubicaciones virtuales / Produccion,/ Joya / Stock,07,Uniformes e Implementos de Seguridad,110-0083-01,Unit(s),POLO DE SEGURIDAD XXL,2018-12-07,2018-12-07,,Joya\OUT\08830,,,Joya\OUT\08830,LUZ ESTHER CHAÑI CUTIRE,0,1.000000,-1.000000,0,0,0.000000,0.000000,0,"",252403 - Uniforme e Implemento de Seguridad,22.01.03 DESORCIÓN,"",,,,,
Partner Locations / Suppliers,Physical Locations / Joya / Stock,/ Joya / Stock,03,Uniformes e Implementos de Seguridad,110-0084-01,Unit(s),PROTECTOR SOLAR 3M,2018-12-01,2018-12-01,12/2018,Joya\IN\02931,01,0002,0003202,ESTHER SANDRA PINEDA LOAYZA,3.000000,0,3.000000,100.0000000000000000,300,0,300,100.0000000000000000,603203 - Uniforme e Implemento de Seguridad,252403 - Uniforme e Implemento de Seguridad,,"",,18PO06652,LM-001629,2018-12-01,
Physical Locations / Joya / Stock,Ubicaciones virtuales / Produccion,/ Joya / Stock,07,Uniformes e Implementos de Seguridad,110-0084-01,Unit(s),PROTECTOR SOLAR 3M,2018-12-19,2018-12-19,,Joya\OUT\08966,,,Joya\OUT\08966,Harold Zambrano,0,1.000000,2.000000,100.0000000000000000,0,100.0000000000000000000000,200.0000000000000000000000,100.0000000000000000,"",252403 - Uniforme e Implemento de Seguridad,20.03.03 CHANCADO,"",,,,,
Physical Locations / Joya / Stock,Ubicaciones virtuales / Produccion,/ Joya / Stock,07,Uniformes e Implementos de Seguridad,110-0084-01,Unit(s),PROTECTOR SOLAR 3M,2018-12-19,2018-12-19,,Joya\OUT\08969,,,Joya\OUT\08969,LUZ ESTHER CHAÑI CUTIRE,0,1.000000,1.000000,100.0000000000000000,0,100.0000000000000000000000,100.0000000000000000000000,100.0000000000000000,"",252403 - Uniforme e Implemento de Seguridad,31.00.01 JEFATURA INGENIERIA Y PROYECTOS,"",,,,,
Physical Locations / Joya / Stock,Ubicaciones virtuales / Produccion,/ Joya / Stock,07,Uniformes e Implementos de Seguridad,110-0085-01,Unit(s),RESPIRADOR DE PARTICULAS 8210,2018-12-07,2018-12-07,,Joya\OUT\08828,,,Joya\OUT\08828,FRANK JHONATAN ARIZAPANA CABRERA,0,1.000000,-1.000000,0,0,0.000000,0.000000,0,"",252403 - Uniforme e Implemento de Seguridad,20.02.05 ATENCION A MINERO REC MINERAL,"",,,,2018-12-07,
Partner Locations / Suppliers,Physical Locations / Joya / Stock,/ Joya / Stock,03,Uniformes e Implementos de Seguridad,110-0089-01,Unit(s),RESPIRADOR MEDIO ROSTRO M,2018-12-01,2018-12-01,12/2018,Joya\IN\02929,01,0002,0003195,ESTHER SANDRA PINEDA LOAYZA,10.000000,0,10.000000,55.0850000000000000,550.85,0,550.85,55.0850000000000000,603203 - Uniforme e Implemento de Seguridad,252403 - Uniforme e Implemento de Seguridad,,"",,18PO06653,LM-001642,2018-12-01,
Physical Locations / Joya / Stock,Ubicaciones virtuales / Produccion,/ Joya / Stock,07,Uniformes e Implementos de Seguridad,110-0089-01,Unit(s),RESPIRADOR MEDIO ROSTRO M,2018-12-05,2018-12-05,,Joya\OUT\08810,,,Joya\OUT\08810,LUZ ESTHER CHAÑI CUTIRE,0,1.000000,9.000000,55.0850000000000000,0,55.0850000000000000000000,495.7650000000000000000000,55.0850000000000000,"",252403 - Uniforme e Implemento de Seguridad,20.05.02 LABORATORIO QUIMICO,"",,,,,
Physical Locations / Joya / Stock,Ubicaciones virtuales / Produccion,/ Joya / Stock,07,Uniformes e Implementos de Seguridad,110-0089-01,Unit(s),RESPIRADOR MEDIO ROSTRO M,2018-12-07,2018-12-07,,Joya\OUT\08825,,,Joya\OUT\08825,LUZ ESTHER CHAÑI CUTIRE,0,1.000000,8.000000,55.0850000000000000,0,55.0850000000000000000000,440.6800000000000000000000,55.0850000000000000,"",252403 - Uniforme e Implemento de Seguridad,20.03.03 CHANCADO,"",,,,,
Physical Locations / Joya / Stock,Ubicaciones virtuales / Produccion,/ Joya / Stock,07,Uniformes e Implementos de Seguridad,110-0089-01,Unit(s),RESPIRADOR MEDIO ROSTRO M,2018-12-10,2018-12-10,,Joya\OUT\08856,,,Joya\OUT\08856,LUZ ESTHER CHAÑI CUTIRE,0,1.000000,7.000000,55.0850000000000000,0,55.0850000000000000000000,385.5950000000000000000000,55.0850000000000000,"",252403 - Uniforme e Implemento de Seguridad,20.03.03 CHANCADO,"",,,,,
Physical Locations / Joya / Stock,Ubicaciones virtuales / Produccion,/ Joya / Stock,07,Uniformes e Implementos de Seguridad,110-0089-01,Unit(s),RESPIRADOR MEDIO ROSTRO M,2018-12-12,2018-12-12,,Joya\OUT\08886,,,Joya\OUT\08886,LUZ ESTHER CHAÑI CUTIRE,0,1.000000,6.000000,55.0850000000000000,0,55.0850000000000000000000,330.5100000000000000000000,55.0850000000000000,"",252403 - Uniforme e Implemento de Seguridad,21.02.01 LIXIVIACIÓN Y ABSORCION,"",,,,,
Physical Locations / Joya / Stock,Ubicaciones virtuales / Produccion,/ Joya / Stock,07,Uniformes e Implementos de Seguridad,110-0089-01,Unit(s),RESPIRADOR MEDIO ROSTRO M,2018-12-12,2018-12-12,,Joya\OUT\08887,,,Joya\OUT\08887,LUZ ESTHER CHAÑI CUTIRE,0,1.000000,5.000000,55.0850000000000000,0,55.0850000000000000000000,275.4250000000000000000000,55.0850000000000000,"",252403 - Uniforme e Implemento de Seguridad,23.05.01 SEGURIDAD Y MEDIO AMBIENTE,"",,,,,
Physical Locations / Joya / Stock,Ubicaciones virtuales / Produccion,/ Joya / Stock,07,Uniformes e Implementos de Seguridad,110-0089-01,Unit(s),RESPIRADOR MEDIO ROSTRO M,2018-12-18,2018-12-18,,Joya\OUT\08942,,,Joya\OUT\08942,LUCIANO RUBEN VIZA CHOQUE,0,1.000000,4.000000,55.0850000000000000,0,55.0850000000000000000000,220.3400000000000000000000,55.0850000000000000,"",252403 - Uniforme e Implemento de Seguridad,23.05.01 SEGURIDAD Y MEDIO AMBIENTE,"",,,,,
Physical Locations / Joya / Stock,Ubicaciones virtuales / Produccion,/ Joya / Stock,07,Uniformes e Implementos de Seguridad,110-0089-01,Unit(s),RESPIRADOR MEDIO ROSTRO M,2018-12-19,2018-12-19,,Joya\OUT\08951,,,Joya\OUT\08951,LUZ ESTHER CHAÑI CUTIRE,0,1.000000,3.000000,55.0850000000000000,0,55.0850000000000000000000,165.2550000000000000000000,55.0850000000000000,"",252403 - Uniforme e Implemento de Seguridad,20.03.03 CHANCADO,"",,,,,
Physical Locations / Joya / Stock,Ubicaciones virtuales / Produccion,/ Joya / Stock,07,Uniformes e Implementos de Seguridad,110-0089-01,Unit(s),RESPIRADOR MEDIO ROSTRO M,2018-12-19,2018-12-19,,Joya\OUT\08952,,,Joya\OUT\08952,LUZ ESTHER CHAÑI CUTIRE,0,1.000000,2.000000,55.0850000000000000,0,55.0850000000000000000000,110.1700000000000000000000,55.0850000000000000,"",252403 - Uniforme e Implemento de Seguridad,20.03.03 CHANCADO,"",,,,,
Physical Locations / Joya / Stock,Ubicaciones virtuales / Produccion,/ Joya / Stock,07,Uniformes e Implementos de Seguridad,110-0089-01,Unit(s),RESPIRADOR MEDIO ROSTRO M,2018-12-19,2018-12-19,,Joya\OUT\08964,,,Joya\OUT\08964,LUZ ESTHER CHAÑI CUTIRE,0,1.000000,1.000000,55.0850000000000000,0,55.0850000000000000000000,55.0850000000000000000000,55.0850000000000000,"",252403 - Uniforme e Implemento de Seguridad,21.02.01 LIXIVIACIÓN Y ABSORCION,"",,,,,
Physical Locations / Joya / Stock,Ubicaciones virtuales / Produccion,/ Joya / Stock,07,Uniformes e Implementos de Seguridad,110-0089-01,Unit(s),RESPIRADOR MEDIO ROSTRO M,2018-12-20,2018-12-20,,Joya\OUT\08981,,,Joya\OUT\08981,LUZ ESTHER CHAÑI CUTIRE,0,1.000000,0.000000,55.0850000000000000,0,55.0850000000000000000000,0.0000000000000000000000,0,"",252403 - Uniforme e Implemento de Seguridad,20.03.03 CHANCADO,"",,,,,
Physical Locations / Joya / Stock,Ubicaciones virtuales / Produccion,/ Joya / Stock,08,Uniformes e Implementos de Seguridad,110-0089-01,Unit(s),RESPIRADOR MEDIO ROSTRO M,2018-12-23,2018-12-23,,Joya\OUT\09016,,,Joya\OUT\09016,LUCIANO RUBEN VIZA CHOQUE,0,1.000000,-1.000000,0,0,0.000000,0.0000000000000000000000,0,"",252403 - Uniforme e Implemento de Seguridad,20.05.02 LABORATORIO QUIMICO,"",,,,,
Physical Locations / Joya / Stock,Ubicaciones virtuales / Produccion,/ Joya / Stock,07,Uniformes e Implementos de Seguridad,110-0089-01,Unit(s),RESPIRADOR MEDIO ROSTRO M,2018-12-24,2018-12-24,,Joya\OUT\09029,,,Joya\OUT\09029,LUZ ESTHER CHAÑI CUTIRE,0,1.000000,-2.000000,0,0,0.000000,0.0000000000000000000000,0,"",252403 - Uniforme e Implemento de Seguridad,29.01.81 MEJORAS EN SISTEMA DE ELECTRODEPOSICION Y MEJORAS SISTEMA DE COSECHAS DE CARBÓN,"",,,,,
Physical Locations / Joya / Stock,Ubicaciones virtuales / Produccion,/ Joya / Stock,07,Uniformes e Implementos de Seguridad,110-0089-01,Unit(s),RESPIRADOR MEDIO ROSTRO M,2018-12-26,2018-12-26,,Joya\OUT\09040,,,Joya\OUT\09040,LUZ ESTHER CHAÑI CUTIRE,0,1.000000,-3.000000,0,0,0.000000,0.0000000000000000000000,0,"",252403 - Uniforme e Implemento de Seguridad,20.03.03 CHANCADO,"",,,,,
Physical Locations / Joya / Stock,Ubicaciones virtuales / Produccion,/ Joya / Stock,07,Uniformes e Implementos de Seguridad,110-0089-01,Unit(s),RESPIRADOR MEDIO ROSTRO M,2018-12-28,2018-12-28,,Joya\OUT\09061,,,Joya\OUT\09061,LUZ ESTHER CHAÑI CUTIRE,0,1.000000,-4.000000,0,0,0.000000,0.0000000000000000000000,0,"",252403 - Uniforme e Implemento de Seguridad,25.01.03 TALLER DE MANTENIMIENTO,"",,,,,
Physical Locations / Joya / Stock,Ubicaciones virtuales / Produccion,/ Joya / Stock,07,Uniformes e Implementos de Seguridad,110-0091-01,Unit(s),SOBRELENTES CLAROS,2018-12-07,2018-12-07,,Joya\OUT\08834,,,Joya\OUT\08834,LUZ ESTHER CHAÑI CUTIRE,0,1.000000,-1.000000,0,0,0.000000,0.000000,0,"",252403 - Uniforme e Implemento de Seguridad,23.02.01 ALMACENES,"",,,,,
Physical Locations / Joya / Stock,Ubicaciones virtuales / Produccion,/ Joya / Stock,07,Uniformes e Implementos de Seguridad,110-0092-01,Unit(s),SOBRELENTES OSCUROS,2018-12-12,2018-12-12,,Joya\OUT\08886,,,Joya\OUT\08886,LUZ ESTHER CHAÑI CUTIRE,0,1.000000,-1.000000,0,0,0.000000,0.000000,0,"",252403 - Uniforme e Implemento de Seguridad,21.02.01 LIXIVIACIÓN Y ABSORCION,"",,,,,
Partner Locations / Suppliers,Physical Locations / Joya / Stock,/ Joya / Stock,03,Uniformes e Implementos de Seguridad,110-0093-01,Par,TAPON P/OIDOS C/CORDON,2018-12-01,2018-12-01,12/2018,Joya\IN\02929,01,0002,0003195,ESTHER SANDRA PINEDA LOAYZA,50.000000,0,50.000000,1.6950000000000000,84.75,0,84.75,1.6950000000000000,603203 - Uniforme e Implemento de Seguridad,252403 - Uniforme e Implemento de Seguridad,,"",,18PO06653,LM-001642,2018-12-01,
Physical Locations / Joya / Stock,Ubicaciones virtuales / Produccion,/ Joya / Stock,08,Uniformes e Implementos de Seguridad,110-0093-01,Par,TAPON P/OIDOS C/CORDON,2018-12-05,2018-12-05,,Joya\OUT\08808,,,Joya\OUT\08808,LUZ ESTHER CHAÑI CUTIRE,0,1.000000,49.000000,1.6950000000000000,0,1.6950000000000000000000,83.0550000000000000000000,1.6950000000000000,"",252403 - Uniforme e Implemento de Seguridad,22.01.03 DESORCIÓN,"",,,,,
Physical Locations / Joya / Stock,Ubicaciones virtuales / Produccion,/ Joya / Stock,07,Uniformes e Implementos de Seguridad,110-0093-01,Par,TAPON P/OIDOS C/CORDON,2018-12-07,2018-12-07,,Joya\OUT\08825,,,Joya\OUT\08825,LUZ ESTHER CHAÑI CUTIRE,0,1.000000,48.000000,1.6950000000000000,0,1.6950000000000000000000,81.3600000000000000000000,1.6950000000000000,"",252403 - Uniforme e Implemento de Seguridad,20.03.03 CHANCADO,"",,,,,
Physical Locations / Joya / Stock,Ubicaciones virtuales / Produccion,/ Joya / Stock,07,Uniformes e Implementos de Seguridad,110-0093-01,Par,TAPON P/OIDOS C/CORDON,2018-12-07,2018-12-07,,Joya\OUT\08831,,,Joya\OUT\08831,LUZ ESTHER CHAÑI CUTIRE,0,1.000000,47.000000,1.6950000000000000,0,1.6950000000000000000000,79.6650000000000000000000,1.6950000000000000,"",252403 - Uniforme e Implemento de Seguridad,20.03.03 CHANCADO,"",,,,,
Physical Locations / Joya / Stock,Ubicaciones virtuales / Produccion,/ Joya / Stock,07,Uniformes e Implementos de Seguridad,110-0093-01,Par,TAPON P/OIDOS C/CORDON,2018-12-07,2018-12-07,,Joya\OUT\08834,,,Joya\OUT\08834,LUZ ESTHER CHAÑI CUTIRE,0,2.000000,45.000000,1.6950000000000000,0,3.3900000000000000000000,76.2750000000000000000000,1.6950000000000000,"",252403 - Uniforme e Implemento de Seguridad,23.02.01 ALMACENES,"",,,,,
Physical Locations / Joya / Stock,Ubicaciones virtuales / Produccion,/ Joya / Stock,07,Uniformes e Implementos de Seguridad,110-0093-01,Par,TAPON P/OIDOS C/CORDON,2018-12-12,2018-12-12,,Joya\OUT\08871,,,Joya\OUT\08871,LUZ ESTHER CHAÑI CUTIRE,0,1.000000,44.000000,1.6950000000000000,0,1.6950000000000000000000,74.5800000000000000000000,1.6950000000000000,"",252403 - Uniforme e Implemento de Seguridad,21.02.01 LIXIVIACIÓN Y ABSORCION,"",,,,,
Physical Locations / Joya / Stock,Ubicaciones virtuales / Produccion,/ Joya / Stock,07,Uniformes e Implementos de Seguridad,110-0093-01,Par,TAPON P/OIDOS C/CORDON,2018-12-12,2018-12-12,,Joya\OUT\08873,,,Joya\OUT\08873,LUZ ESTHER CHAÑI CUTIRE,0,1.000000,43.000000,1.6950000000000000,0,1.6950000000000000000000,72.8850000000000000000000,1.6950000000000000,"",252403 - Uniforme e Implemento de Seguridad,20.03.03 CHANCADO,"",,,,,
Physical Locations / Joya / Stock,Ubicaciones virtuales / Produccion,/ Joya / Stock,07,Uniformes e Implementos de Seguridad,110-0093-01,Par,TAPON P/OIDOS C/CORDON,2018-12-12,2018-12-12,,Joya\OUT\08874,,,Joya\OUT\08874,LUZ ESTHER CHAÑI CUTIRE,0,1.000000,42.000000,1.6950000000000000,0,1.6950000000000000000000,71.1900000000000000000000,1.6950000000000000,"",252403 - Uniforme e Implemento de Seguridad,22.01.03 DESORCIÓN,"",,,,,
Physical Locations / Joya / Stock,Ubicaciones virtuales / Produccion,/ Joya / Stock,07,Uniformes e Implementos de Seguridad,110-0093-01,Par,TAPON P/OIDOS C/CORDON,2018-12-12,2018-12-12,,Joya\OUT\08903,,,Joya\OUT\08903,LUZ ESTHER CHAÑI CUTIRE,0,1.000000,41.000000,1.6950000000000000,0,1.6950000000000000000000,69.4950000000000000000000,1.6950000000000000,"",252403 - Uniforme e Implemento de Seguridad,21.02.01 LIXIVIACIÓN Y ABSORCION,"",,,,,
Physical Locations / Joya / Stock,Ubicaciones virtuales / Produccion,/ Joya / Stock,07,Uniformes e Implementos de Seguridad,110-0093-01,Par,TAPON P/OIDOS C/CORDON,2018-12-16,2018-12-16,,Joya\OUT\08928,,,Joya\OUT\08928,VICTOR URIEL VILCA CENTI,0,1.000000,40.000000,1.6950000000000000,0,1.6950000000000000000000,67.8000000000000000000000,1.6950000000000000,"",252403 - Uniforme e Implemento de Seguridad,20.02.01 PLANILLA ADMINISTRATIVA,"",,,,2018-12-16,
Physical Locations / Joya / Stock,Ubicaciones virtuales / Produccion,/ Joya / Stock,07,Uniformes e Implementos de Seguridad,110-0093-01,Par,TAPON P/OIDOS C/CORDON,2018-12-19,2018-12-19,,Joya\OUT\08951,,,Joya\OUT\08951,LUZ ESTHER CHAÑI CUTIRE,0,1.000000,39.000000,1.6950000000000000,0,1.6950000000000000000000,66.1050000000000000000000,1.6950000000000000,"",252403 - Uniforme e Implemento de Seguridad,20.03.03 CHANCADO,"",,,,,
Physical Locations / Joya / Stock,Ubicaciones virtuales / Produccion,/ Joya / Stock,07,Uniformes e Implementos de Seguridad,110-0093-01,Par,TAPON P/OIDOS C/CORDON,2018-12-19,2018-12-19,,Joya\OUT\08952,,,Joya\OUT\08952,LUZ ESTHER CHAÑI CUTIRE,0,1.000000,38.000000,1.6950000000000000,0,1.6950000000000000000000,64.4100000000000000000000,1.6950000000000000,"",252403 - Uniforme e Implemento de Seguridad,20.03.03 CHANCADO,"",,,,,
Physical Locations / Joya / Stock,Ubicaciones virtuales / Produccion,/ Joya / Stock,07,Uniformes e Implementos de Seguridad,110-0093-01,Par,TAPON P/OIDOS C/CORDON,2018-12-19,2018-12-19,,Joya\OUT\08961,,,Joya\OUT\08961,LUZ ESTHER CHAÑI CUTIRE,0,1.000000,37.000000,1.6950000000000000,0,1.6950000000000000000000,62.7150000000000000000000,1.6950000000000000,"",252403 - Uniforme e Implemento de Seguridad,20.03.03 CHANCADO,"",,,,,
Physical Locations / Joya / Stock,Ubicaciones virtuales / Produccion,/ Joya / Stock,07,Uniformes e Implementos de Seguridad,110-0093-01,Par,TAPON P/OIDOS C/CORDON,2018-12-19,2018-12-19,,Joya\OUT\08962,,,Joya\OUT\08962,LUZ ESTHER CHAÑI CUTIRE,0,1.000000,36.000000,1.6950000000000000,0,1.6950000000000000000000,61.0200000000000000000000,1.6950000000000000,"",252403 - Uniforme e Implemento de Seguridad,20.05.02 LABORATORIO QUIMICO,"",,,,,
Physical Locations / Joya / Stock,Ubicaciones virtuales / Produccion,/ Joya / Stock,07,Uniformes e Implementos de Seguridad,110-0093-01,Par,TAPON P/OIDOS C/CORDON,2018-12-19,2018-12-19,,Joya\OUT\08964,,,Joya\OUT\08964,LUZ ESTHER CHAÑI CUTIRE,0,1.000000,35.000000,1.6950000000000000,0,1.6950000000000000000000,59.3250000000000000000000,1.6950000000000000,"",252403 - Uniforme e Implemento de Seguridad,21.02.01 LIXIVIACIÓN Y ABSORCION,"",,,,,
Physical Locations / Joya / Stock,Ubicaciones virtuales / Produccion,/ Joya / Stock,07,Uniformes e Implementos de Seguridad,110-0093-01,Par,TAPON P/OIDOS C/CORDON,2018-12-20,2018-12-20,,Joya\OUT\08981,,,Joya\OUT\08981,LUZ ESTHER CHAÑI CUTIRE,0,1.000000,34.000000,1.6950000000000000,0,1.6950000000000000000000,57.6300000000000000000000,1.6950000000000000,"",252403 - Uniforme e Implemento de Seguridad,20.03.03 CHANCADO,"",,,,,
Physical Locations / Joya / Stock,Ubicaciones virtuales / Produccion,/ Joya / Stock,08,Uniformes e Implementos de Seguridad,110-0093-01,Par,TAPON P/OIDOS C/CORDON,2018-12-22,2018-12-22,,Joya\OUT\09006,,,Joya\OUT\09006,LUCIANO RUBEN VIZA CHOQUE,0,1.000000,33.000000,1.6950000000000000,0,1.6950000000000000000000,55.9350000000000000000000,1.6950000000000000,"",252403 - Uniforme e Implemento de Seguridad,20.03.03 CHANCADO,"",,,,,
Physical Locations / Joya / Stock,Ubicaciones virtuales / Produccion,/ Joya / Stock,07,Uniformes e Implementos de Seguridad,110-0093-01,Par,TAPON P/OIDOS C/CORDON,2018-12-24,2018-12-24,,Joya\OUT\09029,,,Joya\OUT\09029,LUZ ESTHER CHAÑI CUTIRE,0,1.000000,32.000000,1.6950000000000000,0,1.6950000000000000000000,54.2400000000000000000000,1.6950000000000000,"",252403 - Uniforme e Implemento de Seguridad,29.01.81 MEJORAS EN SISTEMA DE ELECTRODEPOSICION Y MEJORAS SISTEMA DE COSECHAS DE CARBÓN,"",,,,,
Physical Locations / Joya / Stock,Ubicaciones virtuales / Produccion,/ Joya / Stock,07,Uniformes e Implementos de Seguridad,110-0093-01,Par,TAPON P/OIDOS C/CORDON,2018-12-26,2018-12-26,,Joya\OUT\09040,,,Joya\OUT\09040,LUZ ESTHER CHAÑI CUTIRE,0,1.000000,31.000000,1.6950000000000000,0,1.6950000000000000000000,52.5450000000000000000000,1.6950000000000000,"",252403 - Uniforme e Implemento de Seguridad,20.03.03 CHANCADO,"",,,,,
Physical Locations / Joya / Stock,Ubicaciones virtuales / Produccion,/ Joya / Stock,08,Uniformes e Implementos de Seguridad,110-0093-01,Par,TAPON P/OIDOS C/CORDON,2018-12-26,2018-12-26,,Joya\OUT\09049,,,Joya\OUT\09049,LUCIANO RUBEN VIZA CHOQUE,0,1.000000,30.000000,1.6950000000000000,0,1.6950000000000000000000,50.8500000000000000000000,1.6950000000000000,"",252403 - Uniforme e Implemento de Seguridad,20.05.02 LABORATORIO QUIMICO,"",,,,,
Physical Locations / Joya / Stock,Ubicaciones virtuales / Produccion,/ Joya / Stock,07,Uniformes e Implementos de Seguridad,110-0093-01,Par,TAPON P/OIDOS C/CORDON,2018-12-31,2018-12-31,,Joya\OUT\09086,,,Joya\OUT\09086,Harold Zambrano,0,1.000000,29.000000,1.6950000000000000,0,1.6950000000000000000000,49.1550000000000000000000,1.6950000000000000,"",252403 - Uniforme e Implemento de Seguridad,20.03.03 CHANCADO,"",,,,,
Partner Locations / Suppliers,Physical Locations / Joya / Stock,/ Joya / Stock,03,Uniformes e Implementos de Seguridad,110-0095-01,Unit(s),TRAJE DESCARTABLE L,2018-12-01,2018-12-01,12/2018,Joya\IN\02930,01,0002,0003194,ESTHER SANDRA PINEDA LOAYZA,50.000000,0,50.000000,8.0508000000000000,402.54,0,402.54,8.0508000000000000,603203 - Uniforme e Implemento de Seguridad,252403 - Uniforme e Implemento de Seguridad,,"",,18PO06647,LM-001642,,
Physical Locations / Joya / Stock,Ubicaciones virtuales / Produccion,/ Joya / Stock,07,Uniformes e Implementos de Seguridad,110-0095-01,Unit(s),TRAJE DESCARTABLE L,2018-12-01,2018-12-01,,Joya\OUT\08769,,,Joya\OUT\08769,ERNESTO ALVAREZ OSORIO,0,1.000000,49.000000,8.0508000000000000,0,8.0508000000000000000000,394.4892000000000000000000,8.0508000000000000,"",252403 - Uniforme e Implemento de Seguridad,21.02.03 TANQUE AGITADOR #1 (22'x22'),"",,,,,
Physical Locations / Joya / Stock,Ubicaciones virtuales / Produccion,/ Joya / Stock,07,Uniformes e Implementos de Seguridad,110-0095-01,Unit(s),TRAJE DESCARTABLE L,2018-12-09,2018-12-09,,Joya\OUT\08848,,,Joya\OUT\08848,JOSE SANTOS MATTA BORJAS,0,2.000000,47.000000,8.0508000000000000,0,16.1016000000000000000000,378.3876000000000000000000,8.0508000000000000,"",252403 - Uniforme e Implemento de Seguridad,21.02.03 TANQUE AGITADOR #1 (22'x22'),"",,,,,
Physical Locations / Joya / Stock,Ubicaciones virtuales / Produccion,/ Joya / Stock,07,Uniformes e Implementos de Seguridad,110-0095-01,Unit(s),TRAJE DESCARTABLE L,2018-12-12,2018-12-12,,Joya\OUT\08879,,,Joya\OUT\08879,LUZ ESTHER CHAÑI CUTIRE,0,1.000000,46.000000,8.0508000000000000,0,8.0508000000000000000000,370.3368000000000000000000,8.0508000000000000,"",252403 - Uniforme e Implemento de Seguridad,20.03.03 CHANCADO,"",,,,,
Physical Locations / Joya / Stock,Ubicaciones virtuales / Produccion,/ Joya / Stock,07,Uniformes e Implementos de Seguridad,110-0095-01,Unit(s),TRAJE DESCARTABLE L,2018-12-12,2018-12-12,,Joya\OUT\08880,,,Joya\OUT\08880,LUZ ESTHER CHAÑI CUTIRE,0,1.000000,45.000000,8.0508000000000000,0,8.0508000000000000000000,362.2860000000000000000000,8.0508000000000000,"",252403 - Uniforme e Implemento de Seguridad,21.02.01 LIXIVIACIÓN Y ABSORCION,"",,,,,
Physical Locations / Joya / Stock,Ubicaciones virtuales / Produccion,/ Joya / Stock,07,Uniformes e Implementos de Seguridad,110-0095-01,Unit(s),TRAJE DESCARTABLE L,2018-12-17,2018-12-17,,Joya\OUT\08936,,,Joya\OUT\08936,LUZ ESTHER CHAÑI CUTIRE,0,1.000000,44.000000,8.0508000000000000,0,8.0508000000000000000000,354.2352000000000000000000,8.0508000000000000,"",252403 - Uniforme e Implemento de Seguridad,21.02.01 LIXIVIACIÓN Y ABSORCION,"",,,,,
Physical Locations / Joya / Stock,Ubicaciones virtuales / Produccion,/ Joya / Stock,08,Uniformes e Implementos de Seguridad,110-0095-01,Unit(s),TRAJE DESCARTABLE L,2018-12-22,2018-12-22,,Joya\OUT\09000,,,Joya\OUT\09000,LUCIANO RUBEN VIZA CHOQUE,0,1.000000,43.000000,8.0508000000000000,0,8.0508000000000000000000,346.1844000000000000000000,8.0508000000000000,"",252403 - Uniforme e Implemento de Seguridad,"01.01.11	GESTION PLANTA,COMERCIAL Y ADMIN.","",,,,,
Physical Locations / Joya / Stock,Ubicaciones virtuales / Produccion,/ Joya / Stock,08,Uniformes e Implementos de Seguridad,110-0095-01,Unit(s),TRAJE DESCARTABLE L,2018-12-22,2018-12-22,,Joya\OUT\09001,,,Joya\OUT\09001,LUCIANO RUBEN VIZA CHOQUE,0,2.000000,41.000000,8.0508000000000000,0,16.1016000000000000000000,330.0828000000000000000000,8.0508000000000000,"",252403 - Uniforme e Implemento de Seguridad,"01.01.11	GESTION PLANTA,COMERCIAL Y ADMIN.","",,,,,
Physical Locations / Joya / Stock,Ubicaciones virtuales / Produccion,/ Joya / Stock,07,Uniformes e Implementos de Seguridad,110-0095-01,Unit(s),TRAJE DESCARTABLE L,2018-12-23,2018-12-23,,Joya\OUT\09012,,,Joya\OUT\09012,JOSE SANTOS MATTA BORJAS,0,1.000000,40.000000,8.0508000000000000,0,8.0508000000000000000000,322.0320000000000000000000,8.0508000000000000,"",252403 - Uniforme e Implemento de Seguridad,21.02.03 TANQUE AGITADOR #1 (22'x22'),"",,,,,
Physical Locations / Joya / Stock,Ubicaciones virtuales / Produccion,/ Joya / Stock,08,Uniformes e Implementos de Seguridad,110-0095-01,Unit(s),TRAJE DESCARTABLE L,2018-12-24,2018-12-24,,Joya\OUT\09024,,,Joya\OUT\09024,LUCIANO RUBEN VIZA CHOQUE,0,1.000000,39.000000,8.0508000000000000,0,8.0508000000000000000000,313.9812000000000000000000,8.0508000000000000,"",252403 - Uniforme e Implemento de Seguridad,"01.01.11	GESTION PLANTA,COMERCIAL Y ADMIN.","",,,,,
Physical Locations / Joya / Stock,Ubicaciones virtuales / Produccion,/ Joya / Stock,08,Uniformes e Implementos de Seguridad,110-0095-01,Unit(s),TRAJE DESCARTABLE L,2018-12-24,2018-12-24,,Joya\OUT\09025,,,Joya\OUT\09025,LUCIANO RUBEN VIZA CHOQUE,0,1.000000,38.000000,8.0508000000000000,0,8.0508000000000000000000,305.9304000000000000000000,8.0508000000000000,"",252403 - Uniforme e Implemento de Seguridad,"01.01.11	GESTION PLANTA,COMERCIAL Y ADMIN.","",,,,,
Physical Locations / Joya / Stock,Ubicaciones virtuales / Produccion,/ Joya / Stock,07,Uniformes e Implementos de Seguridad,110-0095-01,Unit(s),TRAJE DESCARTABLE L,2018-12-25,2018-12-25,,Joya\OUT\09035,,,Joya\OUT\09035,LUIS FELIPE CARCAMO PALACO,0,2.000000,36.000000,8.0508000000000000,0,16.1016000000000000000000,289.8288000000000000000000,8.0508000000000000,"",252403 - Uniforme e Implemento de Seguridad,21.02.01 LIXIVIACIÓN Y ABSORCION,"",,,,,
Physical Locations / Joya / Stock,Ubicaciones virtuales / Produccion,/ Joya / Stock,07,Uniformes e Implementos de Seguridad,110-0095-01,Unit(s),TRAJE DESCARTABLE L,2018-12-26,2018-12-26,,Joya\OUT\09046,,,Joya\OUT\09046,JOSE SANTOS MATTA BORJAS,0,2.000000,34.000000,8.0508000000000000,0,16.1016000000000000000000,273.7272000000000000000000,8.0508000000000000,"",252403 - Uniforme e Implemento de Seguridad,21.02.03 TANQUE AGITADOR #1 (22'x22'),"",,,,,
Physical Locations / Joya / Stock,Ubicaciones virtuales / Produccion,/ Joya / Stock,08,Uniformes e Implementos de Seguridad,110-0095-01,Unit(s),TRAJE DESCARTABLE L,2018-12-27,2018-12-27,,Joya\OUT\09051,,,Joya\OUT\09051,LUCIANO RUBEN VIZA CHOQUE,0,1.000000,33.000000,8.0508000000000000,0,8.0508000000000000000000,265.6764000000000000000000,8.0508000000000000,"",252403 - Uniforme e Implemento de Seguridad,"01.01.11	GESTION PLANTA,COMERCIAL Y ADMIN.","",,,,,
Physical Locations / Joya / Stock,Ubicaciones virtuales / Produccion,/ Joya / Stock,07,Uniformes e Implementos de Seguridad,110-0095-01,Unit(s),TRAJE DESCARTABLE L,2018-12-30,2018-12-30,,Joya\OUT\09080,,,Joya\OUT\09080,JOSE SANTOS MATTA BORJAS,0,1.000000,32.000000,8.0508000000000000,0,8.0508000000000000000000,257.6256000000000000000000,8.0508000000000000,"",252403 - Uniforme e Implemento de Seguridad,22.01.03 DESORCIÓN,"",,,,,
Partner Locations / Suppliers,Physical Locations / Joya / Stock,/ Joya / Stock,03,Uniformes e Implementos de Seguridad,110-0096-01,Unit(s),TRAJE DESCARTABLE M,2018-12-01,2018-12-01,12/2018,Joya\IN\02930,01,0002,0003194,ESTHER SANDRA PINEDA LOAYZA,50.000000,0,50.000000,8.0508000000000000,402.54,0,402.54,8.0508000000000000,603203 - Uniforme e Implemento de Seguridad,252403 - Uniforme e Implemento de Seguridad,,"",,18PO06647,LM-001642,,
Physical Locations / Joya / Stock,Ubicaciones virtuales / Produccion,/ Joya / Stock,07,Uniformes e Implementos de Seguridad,110-0096-01,Unit(s),TRAJE DESCARTABLE M,2018-12-01,2018-12-01,,Joya\OUT\08769,,,Joya\OUT\08769,ERNESTO ALVAREZ OSORIO,0,1.000000,49.000000,8.0508000000000000,0,8.0508000000000000000000,394.4892000000000000000000,8.0508000000000000,"",252403 - Uniforme e Implemento de Seguridad,21.02.03 TANQUE AGITADOR #1 (22'x22'),"",,,,,
Physical Locations / Joya / Stock,Ubicaciones virtuales / Produccion,/ Joya / Stock,07,Uniformes e Implementos de Seguridad,110-0096-01,Unit(s),TRAJE DESCARTABLE M,2018-12-01,2018-12-01,,Joya\OUT\08776,,,Joya\OUT\08776,ERNESTO ALVAREZ OSORIO,0,3.000000,46.000000,8.0508000000000000,0,24.1524000000000000000000,370.3368000000000000000000,8.0508000000000000,"",252403 - Uniforme e Implemento de Seguridad,21.02.01 LIXIVIACIÓN Y ABSORCION,"",,,,,
Physical Locations / Joya / Stock,Ubicaciones virtuales / Produccion,/ Joya / Stock,07,Uniformes e Implementos de Seguridad,110-0096-01,Unit(s),TRAJE DESCARTABLE M,2018-12-02,2018-12-02,,Joya\OUT\08778,,,Joya\OUT\08778,JOSE SANTOS MATTA BORJAS,0,1.000000,45.000000,8.0508000000000000,0,8.0508000000000000000000,362.2860000000000000000000,8.0508000000000000,"",252403 - Uniforme e Implemento de Seguridad,21.02.01 LIXIVIACIÓN Y ABSORCION,"",,,,,
Physical Locations / Joya / Stock,Ubicaciones virtuales / Produccion,/ Joya / Stock,07,Uniformes e Implementos de Seguridad,110-0096-01,Unit(s),TRAJE DESCARTABLE M,2018-12-03,2018-12-03,,Joya\OUT\08784,,,Joya\OUT\08784,HAROL ZAMBRANO RAMOS,0,1.000000,44.000000,8.0508000000000000,0,8.0508000000000000000000,354.2352000000000000000000,8.0508000000000000,"",252403 - Uniforme e Implemento de Seguridad,21.02.01 LIXIVIACIÓN Y ABSORCION,"",,,,,
Physical Locations / Joya / Stock,Ubicaciones virtuales / Produccion,/ Joya / Stock,07,Uniformes e Implementos de Seguridad,110-0096-01,Unit(s),TRAJE DESCARTABLE M,2018-12-09,2018-12-09,,Joya\OUT\08848,,,Joya\OUT\08848,JOSE SANTOS MATTA BORJAS,0,1.000000,43.000000,8.0508000000000000,0,8.0508000000000000000000,346.1844000000000000000000,8.0508000000000000,"",252403 - Uniforme e Implemento de Seguridad,21.02.03 TANQUE AGITADOR #1 (22'x22'),"",,,,,
Physical Locations / Joya / Stock,Ubicaciones virtuales / Produccion,/ Joya / Stock,07,Uniformes e Implementos de Seguridad,110-0096-01,Unit(s),TRAJE DESCARTABLE M,2018-12-12,2018-12-12,,Joya\OUT\08867,,,Joya\OUT\08867,LUZ ESTHER CHAÑI CUTIRE,0,1.000000,42.000000,8.0508000000000000,0,8.0508000000000000000000,338.1336000000000000000000,8.0508000000000000,"",252403 - Uniforme e Implemento de Seguridad,21.02.01 LIXIVIACIÓN Y ABSORCION,"",,,,,
Physical Locations / Joya / Stock,Ubicaciones virtuales / Produccion,/ Joya / Stock,07,Uniformes e Implementos de Seguridad,110-0096-01,Unit(s),TRAJE DESCARTABLE M,2018-12-12,2018-12-12,,Joya\OUT\08868,,,Joya\OUT\08868,LUZ ESTHER CHAÑI CUTIRE,0,1.000000,41.000000,8.0508000000000000,0,8.0508000000000000000000,330.0828000000000000000000,8.0508000000000000,"",252403 - Uniforme e Implemento de Seguridad,21.02.01 LIXIVIACIÓN Y ABSORCION,"",,,,,
Physical Locations / Joya / Stock,Ubicaciones virtuales / Produccion,/ Joya / Stock,07,Uniformes e Implementos de Seguridad,110-0096-01,Unit(s),TRAJE DESCARTABLE M,2018-12-12,2018-12-12,,Joya\OUT\08878,,,Joya\OUT\08878,LUZ ESTHER CHAÑI CUTIRE,0,1.000000,40.000000,8.0508000000000000,0,8.0508000000000000000000,322.0320000000000000000000,8.0508000000000000,"",252403 - Uniforme e Implemento de Seguridad,20.03.03 CHANCADO,"",,,,,
Physical Locations / Joya / Stock,Ubicaciones virtuales / Produccion,/ Joya / Stock,07,Uniformes e Implementos de Seguridad,110-0096-01,Unit(s),TRAJE DESCARTABLE M,2018-12-17,2018-12-17,,Joya\OUT\08979,,,Joya\OUT\08979,Harold Zambrano,0,1.000000,39.000000,8.0508000000000000,0,8.0508000000000000000000,313.9812000000000000000000,8.0508000000000000,"",252403 - Uniforme e Implemento de Seguridad,21.02.01 LIXIVIACIÓN Y ABSORCION,"",,,,2018-12-17,
Physical Locations / Joya / Stock,Ubicaciones virtuales / Produccion,/ Joya / Stock,08,Uniformes e Implementos de Seguridad,110-0096-01,Unit(s),TRAJE DESCARTABLE M,2018-12-22,2018-12-22,,Joya\OUT\08998,,,Joya\OUT\08998,LUCIANO RUBEN VIZA CHOQUE,0,1.000000,38.000000,8.0508000000000000,0,8.0508000000000000000000,305.9304000000000000000000,8.0508000000000000,"",252403 - Uniforme e Implemento de Seguridad,"01.01.11	GESTION PLANTA,COMERCIAL Y ADMIN.","",,,,,
Physical Locations / Joya / Stock,Ubicaciones virtuales / Produccion,/ Joya / Stock,08,Uniformes e Implementos de Seguridad,110-0096-01,Unit(s),TRAJE DESCARTABLE M,2018-12-24,2018-12-24,,Joya\OUT\09023,,,Joya\OUT\09023,LUCIANO RUBEN VIZA CHOQUE,0,1.000000,37.000000,8.0508000000000000,0,8.0508000000000000000000,297.8796000000000000000000,8.0508000000000000,"",252403 - Uniforme e Implemento de Seguridad,"01.01.11	GESTION PLANTA,COMERCIAL Y ADMIN.","",,,,,
Physical Locations / Joya / Stock,Ubicaciones virtuales / Produccion,/ Joya / Stock,07,Uniformes e Implementos de Seguridad,110-0096-01,Unit(s),TRAJE DESCARTABLE M,2018-12-27,2018-12-27,,Joya\OUT\09054,,,Joya\OUT\09054,JOSE SANTOS MATTA BORJAS,0,1.000000,36.000000,8.0508000000000000,0,8.0508000000000000000000,289.8288000000000000000000,8.0508000000000000,"",252403 - Uniforme e Implemento de Seguridad,22.01.03 DESORCIÓN,"",,,,,
Physical Locations / Joya / Stock,Ubicaciones virtuales / Produccion,/ Joya / Stock,07,Uniformes e Implementos de Seguridad,110-0096-01,Unit(s),TRAJE DESCARTABLE M,2018-12-31,2018-12-31,,Joya\OUT\09094,,,Joya\OUT\09094,JOSE SANTOS MATTA BORJAS,0,1.000000,35.000000,8.0508000000000000,0,8.0508000000000000000000,281.7780000000000000000000,8.0508000000000000,"",252403 - Uniforme e Implemento de Seguridad,21.02.03 TANQUE AGITADOR #1 (22'x22'),"",,,,,
Partner Locations / Suppliers,Physical Locations / Joya / Stock,/ Joya / Stock,03,Uniformes e Implementos de Seguridad,110-0098-01,Unit(s),TRAJE DESCARTABLE XL,2018-12-01,2018-12-01,12/2018,Joya\IN\02930,01,0002,0003194,ESTHER SANDRA PINEDA LOAYZA,50.000000,0,50.000000,8.0508000000000000,402.54,0,402.54,8.0508000000000000,603203 - Uniforme e Implemento de Seguridad,252403 - Uniforme e Implemento de Seguridad,,"",,18PO06647,LM-001642,,
Physical Locations / Joya / Stock,Ubicaciones virtuales / Produccion,/ Joya / Stock,07,Uniformes e Implementos de Seguridad,110-0098-01,Unit(s),TRAJE DESCARTABLE XL,2018-12-08,2018-12-08,,Joya\OUT\08839,,,Joya\OUT\08839,Harold Zambrano,0,1.000000,49.000000,8.0508000000000000,0,8.0508000000000000000000,394.4892000000000000000000,8.0508000000000000,"",252403 - Uniforme e Implemento de Seguridad,21.02.01 LIXIVIACIÓN Y ABSORCION,"",,,,,
Physical Locations / Joya / Stock,Ubicaciones virtuales / Produccion,/ Joya / Stock,07,Uniformes e Implementos de Seguridad,110-0098-01,Unit(s),TRAJE DESCARTABLE XL,2018-12-08,2018-12-08,,Joya\OUT\08840,,,Joya\OUT\08840,Harold Zambrano,0,1.000000,48.000000,8.0508000000000000,0,8.0508000000000000000000,386.4384000000000000000000,8.0508000000000000,"",252403 - Uniforme e Implemento de Seguridad,21.02.01 LIXIVIACIÓN Y ABSORCION,"",,,,,
Physical Locations / Joya / Stock,Ubicaciones virtuales / Produccion,/ Joya / Stock,07,Uniformes e Implementos de Seguridad,110-0098-01,Unit(s),TRAJE DESCARTABLE XL,2018-12-11,2018-12-11,,Joya\OUT\08864,,,Joya\OUT\08864,JOSE SANTOS MATTA BORJAS,0,1.000000,47.000000,8.0508000000000000,0,8.0508000000000000000000,378.3876000000000000000000,8.0508000000000000,"",252403 - Uniforme e Implemento de Seguridad,22.01.03 DESORCIÓN,"",,,,,
Physical Locations / Joya / Stock,Ubicaciones virtuales / Produccion,/ Joya / Stock,07,Uniformes e Implementos de Seguridad,110-0098-01,Unit(s),TRAJE DESCARTABLE XL,2018-12-17,2018-12-17,,Joya\OUT\08935,,,Joya\OUT\08935,LUZ ESTHER CHAÑI CUTIRE,0,1.000000,46.000000,8.0508000000000000,0,8.0508000000000000000000,370.3368000000000000000000,8.0508000000000000,"",252403 - Uniforme e Implemento de Seguridad,21.02.01 LIXIVIACIÓN Y ABSORCION,"",,,,,
Physical Locations / Joya / Stock,Ubicaciones virtuales / Produccion,/ Joya / Stock,07,Uniformes e Implementos de Seguridad,110-0098-01,Unit(s),TRAJE DESCARTABLE XL,2018-12-22,2018-12-22,,Joya\OUT\09011,,,Joya\OUT\09011,JOSE SANTOS MATTA BORJAS,0,1.000000,45.000000,8.0508000000000000,0,8.0508000000000000000000,362.2860000000000000000000,8.0508000000000000,"",252403 - Uniforme e Implemento de Seguridad,22.01.03 DESORCIÓN,"",,,,,
Partner Locations / Suppliers,Physical Locations / Joya / Stock,/ Joya / Stock,03,Uniformes e Implementos de Seguridad,110-0100-01,Juego,UNIFORME DRILL L,2018-12-01,2018-12-01,12/2018,Joya\IN\02932,01,0002,0003201,ESTHER SANDRA PINEDA LOAYZA,2.000000,0,2.000000,30.9400000000000000,61.88,0,61.88,30.9400000000000000,603203 - Uniforme e Implemento de Seguridad,252403 - Uniforme e Implemento de Seguridad,,"",,18PO06655,LM-001573,2018-12-01,
Physical Locations / Joya / Stock,Ubicaciones virtuales / Produccion,/ Joya / Stock,07,Uniformes e Implementos de Seguridad,110-0100-01,Juego,UNIFORME DRILL L,2018-12-16,2018-12-16,,Joya\OUT\08924,,,Joya\OUT\08924,Harold Zambrano,0,1.000000,1.000000,30.9400000000000000,0,30.9400000000000000000000,30.9400000000000000000000,30.9400000000000000,"",252403 - Uniforme e Implemento de Seguridad,21.01.01 MOLIENDA,"",,,,,
Physical Locations / Joya / Stock,Ubicaciones virtuales / Produccion,/ Joya / Stock,07,Uniformes e Implementos de Seguridad,110-0100-01,Juego,UNIFORME DRILL L,2018-12-19,2018-12-19,,Joya\OUT\08952,,,Joya\OUT\08952,LUZ ESTHER CHAÑI CUTIRE,0,1.000000,0.000000,30.9400000000000000,0,30.9400000000000000000000,0.0000000000000000000000,0,"",252403 - Uniforme e Implemento de Seguridad,20.03.03 CHANCADO,"",,,,,
Physical Locations / Joya / Stock,Ubicaciones virtuales / Produccion,/ Joya / Stock,07,Uniformes e Implementos de Seguridad,110-0100-01,Juego,UNIFORME DRILL L,2018-12-19,2018-12-19,,Joya\OUT\08964,,,Joya\OUT\08964,LUZ ESTHER CHAÑI CUTIRE,0,1.000000,-1.000000,0,0,0.000000,0.0000000000000000000000,0,"",252403 - Uniforme e Implemento de Seguridad,21.02.01 LIXIVIACIÓN Y ABSORCION,"",,,,,
Partner Locations / Suppliers,Physical Locations / Joya / Stock,/ Joya / Stock,03,Uniformes e Implementos de Seguridad,110-0100-01,Juego,UNIFORME DRILL L,2018-12-21,2018-12-21,12/2018,Joya\IN\02947,01,0002,0003211,ESTHER SANDRA PINEDA LOAYZA,1.000000,0,0.000000,30.93,30.93,0,30.9300000000000000000000,0,603203 - Uniforme e Implemento de Seguridad,252403 - Uniforme e Implemento de Seguridad,,"",,19PO00027,LM-001573,2018-12-21,
Physical Locations / Joya / Stock,Ubicaciones virtuales / Produccion,/ Joya / Stock,07,Uniformes e Implementos de Seguridad,110-0100-01,Juego,UNIFORME DRILL L,2018-12-26,2018-12-26,,Joya\OUT\09040,,,Joya\OUT\09040,LUZ ESTHER CHAÑI CUTIRE,0,1.000000,-1.000000,0,0,0.000000,30.9300000000000000000000,0,"",252403 - Uniforme e Implemento de Seguridad,20.03.03 CHANCADO,"",,,,,
Physical Locations / Joya / Stock,Ubicaciones virtuales / Produccion,/ Joya / Stock,07,Uniformes e Implementos de Seguridad,110-0100-01,Juego,UNIFORME DRILL L,2018-12-29,2018-12-29,,Joya\OUT\09064,,,Joya\OUT\09064,LUZ ESTHER CHAÑI CUTIRE,0,1.000000,-2.000000,0,0,0.000000,30.9300000000000000000000,0,"",252403 - Uniforme e Implemento de Seguridad,"21.02.18 BOMBA DE PULPA VERTICAL 1.1/2""X24""  LIXIVIACION","",,,,,
Partner Locations / Suppliers,Physical Locations / Joya / Stock,/ Joya / Stock,03,Uniformes e Implementos de Seguridad,110-0101-01,Juego,UNIFORME DRILL M,2018-12-01,2018-12-01,12/2018,Joya\IN\02932,01,0002,0003201,ESTHER SANDRA PINEDA LOAYZA,2.000000,0,2.000000,30.9300000000000000,61.86,0,61.86,30.9300000000000000,603203 - Uniforme e Implemento de Seguridad,252403 - Uniforme e Implemento de Seguridad,,"",,18PO06655,LM-001573,2018-12-01,
Physical Locations / Joya / Stock,Ubicaciones virtuales / Produccion,/ Joya / Stock,07,Uniformes e Implementos de Seguridad,110-0101-01,Juego,UNIFORME DRILL M,2018-12-07,2018-12-07,,Joya\OUT\08825,,,Joya\OUT\08825,LUZ ESTHER CHAÑI CUTIRE,0,1.000000,1.000000,30.9300000000000000,0,30.9300000000000000000000,30.9300000000000000000000,30.9300000000000000,"",252403 - Uniforme e Implemento de Seguridad,20.03.03 CHANCADO,"",,,,,
Physical Locations / Joya / Stock,Ubicaciones virtuales / Produccion,/ Joya / Stock,07,Uniformes e Implementos de Seguridad,110-0101-01,Juego,UNIFORME DRILL M,2018-12-07,2018-12-07,,Joya\OUT\08831,,,Joya\OUT\08831,LUZ ESTHER CHAÑI CUTIRE,0,1.000000,0.000000,30.9300000000000000,0,30.9300000000000000000000,0.0000000000000000000000,0,"",252403 - Uniforme e Implemento de Seguridad,20.03.03 CHANCADO,"",,,,,
Partner Locations / Suppliers,Physical Locations / Joya / Stock,/ Joya / Stock,03,Uniformes e Implementos de Seguridad,110-0101-01,Juego,UNIFORME DRILL M,2018-12-21,2018-12-21,12/2018,Joya\IN\02947,01,0002,0003211,ESTHER SANDRA PINEDA LOAYZA,1.000000,0,1.000000,30.9300000000000000,30.93,0,30.9300000000000000000000,30.9300000000000000000000,603203 - Uniforme e Implemento de Seguridad,252403 - Uniforme e Implemento de Seguridad,,"",,19PO00027,LM-001573,2018-12-21,
Physical Locations / Joya / Stock,Ubicaciones virtuales / Produccion,/ Joya / Stock,08,Uniformes e Implementos de Seguridad,110-0101-01,Juego,UNIFORME DRILL M,2018-12-29,2018-12-29,,Joya\OUT\09066,,,Joya\OUT\09066,LUCIANO RUBEN VIZA CHOQUE,0,1.000000,0.000000,30.9300000000000000000000,0,30.9300000000000000000000000000,0.0000000000000000000000000000,0,"",252403 - Uniforme e Implemento de Seguridad,"01.01.11	GESTION PLANTA,COMERCIAL Y ADMIN.","",,,,,
Physical Locations / Joya / Stock,Ubicaciones virtuales / Produccion,/ Joya / Stock,07,Uniformes e Implementos de Seguridad,110-0101-01,Juego,UNIFORME DRILL M,2018-12-29,2018-12-29,,Joya\OUT\09074,,,Joya\OUT\09074,LUZ ESTHER CHAÑI CUTIRE,0,1.000000,-1.000000,0,0,0.000000,0.0000000000000000000000000000,0,"",252403 - Uniforme e Implemento de Seguridad,20.03.03 CHANCADO,"",,,,,
Physical Locations / Joya / Stock,Ubicaciones virtuales / Produccion,/ Joya / Stock,07,Uniformes e Implementos de Seguridad,110-0102-01,Juego,UNIFORME DRILL S,2018-12-19,2018-12-19,,Joya\OUT\08972,,,Joya\OUT\08972,LUZ ESTHER CHAÑI CUTIRE,0,1.000000,-1.000000,0,0,0.000000,0.000000,0,"",252403 - Uniforme e Implemento de Seguridad,21.02.01 LIXIVIACIÓN Y ABSORCION,"",,,,,
Partner Locations / Suppliers,Physical Locations / Joya / Stock,/ Joya / Stock,03,Uniformes e Implementos de Seguridad,110-0102-01,Juego,UNIFORME DRILL S,2018-12-21,2018-12-21,12/2018,Joya\IN\02947,01,0002,0003211,ESTHER SANDRA PINEDA LOAYZA,1.000000,0,0.000000,30.93,30.93,0,30.930000,0,603203 - Uniforme e Implemento de Seguridad,252403 - Uniforme e Implemento de Seguridad,,"",,19PO00027,LM-001573,2018-12-21,
Physical Locations / Joya / Stock,Ubicaciones virtuales / Produccion,/ Joya / Stock,07,Uniformes e Implementos de Seguridad,110-0102-01,Juego,UNIFORME DRILL S,2018-12-27,2018-12-27,,Joya\OUT\09052,,,Joya\OUT\09052,LUZ ESTHER CHAÑI CUTIRE,0,1.000000,-1.000000,0,0,0.000000,30.930000,0,"",252403 - Uniforme e Implemento de Seguridad,20.05.02 LABORATORIO QUIMICO,"",,,,,
Physical Locations / Joya / Stock,Ubicaciones virtuales / Produccion,/ Joya / Stock,07,Uniformes e Implementos de Seguridad,110-0102-01,Juego,UNIFORME DRILL S,2018-12-29,2018-12-29,,Joya\OUT\09072,,,Joya\OUT\09072,LUZ ESTHER CHAÑI CUTIRE,0,1.000000,-2.000000,0,0,0.000000,30.930000,0,"",252403 - Uniforme e Implemento de Seguridad,20.05.02 LABORATORIO QUIMICO,"",,,,,
Physical Locations / Joya / Stock,Ubicaciones virtuales / Produccion,/ Joya / Stock,07,Uniformes e Implementos de Seguridad,110-0102-01,Juego,UNIFORME DRILL S,2018-12-29,2018-12-29,,Joya\OUT\09073,,,Joya\OUT\09073,LUZ ESTHER CHAÑI CUTIRE,0,1.000000,-3.000000,0,0,0.000000,30.930000,0,"",252403 - Uniforme e Implemento de Seguridad,20.05.02 LABORATORIO QUIMICO,"",,,,,
Physical Locations / Joya / Stock,Ubicaciones virtuales / Produccion,/ Joya / Stock,07,Uniformes e Implementos de Seguridad,110-0104-01,Juego,UNIFORME DRILL XXL,2018-12-07,2018-12-07,,Joya\OUT\08830,,,Joya\OUT\08830,LUZ ESTHER CHAÑI CUTIRE,0,1.000000,-1.000000,0,0,0.000000,0.000000,0,"",252403 - Uniforme e Implemento de Seguridad,22.01.03 DESORCIÓN,"",,,,,
Physical Locations / Joya / Stock,Ubicaciones virtuales / Produccion,/ Joya / Stock,07,Uniformes e Implementos de Seguridad,110-0105-01,Juego,UNIFORME JEAN L,2018-12-24,2018-12-24,,Joya\OUT\09029,,,Joya\OUT\09029,LUZ ESTHER CHAÑI CUTIRE,0,1.000000,-1.000000,0,0,0.000000,0.000000,0,"",252403 - Uniforme e Implemento de Seguridad,29.01.81 MEJORAS EN SISTEMA DE ELECTRODEPOSICION Y MEJORAS SISTEMA DE COSECHAS DE CARBÓN,"",,,,,
Physical Locations / Joya / Stock,Ubicaciones virtuales / Produccion,/ Joya / Stock,08,Uniformes e Implementos de Seguridad,110-0106-01,Juego,UNIFORME JEAN M,2018-12-26,2018-12-26,,Joya\OUT\09048,,,Joya\OUT\09048,LUCIANO RUBEN VIZA CHOQUE,0,1.000000,-1.000000,0,0,0.000000,0.000000,0,"",252403 - Uniforme e Implemento de Seguridad,25.01.03 TALLER DE MANTENIMIENTO,"",,,,,
Physical Locations / Joya / Stock,Ubicaciones virtuales / Produccion,/ Joya / Stock,07,Uniformes e Implementos de Seguridad,110-0106-01,Juego,UNIFORME JEAN M,2018-12-28,2018-12-28,,Joya\OUT\09061,,,Joya\OUT\09061,LUZ ESTHER CHAÑI CUTIRE,0,1.000000,-2.000000,0,0,0.000000,0.000000,0,"",252403 - Uniforme e Implemento de Seguridad,25.01.03 TALLER DE MANTENIMIENTO,"",,,,,
Physical Locations / Joya / Stock,Ubicaciones virtuales / Produccion,/ Joya / Stock,07,Uniformes e Implementos de Seguridad,110-0106-01,Juego,UNIFORME JEAN M,2018-12-30,2018-12-30,,Joya\OUT\08911,,,Joya\OUT\08911,LUZ ESTHER CHAÑI CUTIRE,0,1.000000,-3.000000,0,0,0.000000,0.000000,0,"",252403 - Uniforme e Implemento de Seguridad,23.02.01 ALMACENES,"",,,,2018-12-30,
Physical Locations / Joya / Stock,Ubicaciones virtuales / Produccion,/ Joya / Stock,07,Uniformes e Implementos de Seguridad,110-0110-01,Par,ZAPATOS DE SEGURIDAD TALLA 38,2018-12-01,2018-12-01,,Joya\OUT\08773,,,Joya\OUT\08773,ERNESTO ALVAREZ OSORIO,0,1.000000,-1.000000,0,0,0.000000,0.000000,0,"",252403 - Uniforme e Implemento de Seguridad,"22.01.29	DEPRECIACION DESORCION, FUNDICION Y REFINACION","",,,,,
Partner Locations / Suppliers,Physical Locations / Joya / Stock,/ Joya / Stock,03,Uniformes e Implementos de Seguridad,110-0110-01,Par,ZAPATOS DE SEGURIDAD TALLA 38,2018-12-08,2018-12-08,12/2018,Joya\IN\02893,01,0002,0003157,ESTHER SANDRA PINEDA LOAYZA,2.000000,0,1.000000,91.5250000000000000,183.05,0,183.050000,183.0500000000000000,603203 - Uniforme e Implemento de Seguridad,252403 - Uniforme e Implemento de Seguridad,,"",,18PO06446,LM-001560,2018-12-08,
Physical Locations / Joya / Stock,Ubicaciones virtuales / Produccion,/ Joya / Stock,07,Uniformes e Implementos de Seguridad,110-0110-01,Par,ZAPATOS DE SEGURIDAD TALLA 38,2018-12-19,2018-12-19,,Joya\OUT\08951,,,Joya\OUT\08951,LUZ ESTHER CHAÑI CUTIRE,0,1.000000,0.000000,183.0500000000000000,0,183.0500000000000000000000,0.0000000000000000000000,0,"",252403 - Uniforme e Implemento de Seguridad,20.03.03 CHANCADO,"",,,,,
Partner Locations / Suppliers,Physical Locations / Joya / Stock,/ Joya / Stock,03,Uniformes e Implementos de Seguridad,110-0111-01,Par,ZAPATOS DE SEGURIDAD TALLA 39,2018-12-01,2018-12-01,12/2018,Joya\IN\02933,01,0002,0003203,ESTHER SANDRA PINEDA LOAYZA,3.000000,0,3.000000,91.5266666666666667,274.58,0,274.58,91.5266666666666667,603203 - Uniforme e Implemento de Seguridad,252403 - Uniforme e Implemento de Seguridad,,"",,18PO06654,LM-001642,2018-12-01,
Physical Locations / Joya / Stock,Ubicaciones virtuales / Produccion,/ Joya / Stock,07,Uniformes e Implementos de Seguridad,110-0111-01,Par,ZAPATOS DE SEGURIDAD TALLA 39,2018-12-07,2018-12-07,,Joya\OUT\08825,,,Joya\OUT\08825,LUZ ESTHER CHAÑI CUTIRE,0,1.000000,2.000000,91.5266666666666667,0,91.5266666666666667000000,183.0533333333333333000000,91.5266666666666667,"",252403 - Uniforme e Implemento de Seguridad,20.03.03 CHANCADO,"",,,,,
Partner Locations / Suppliers,Physical Locations / Joya / Stock,/ Joya / Stock,03,Uniformes e Implementos de Seguridad,110-0111-01,Par,ZAPATOS DE SEGURIDAD TALLA 39,2018-12-08,2018-12-08,12/2018,Joya\IN\02893,01,0002,0003157,ESTHER SANDRA PINEDA LOAYZA,2.000000,0,4.000000,91.5250000000000000,183.05,0,366.1033333333333333000000,91.5258333333333333250000,603203 - Uniforme e Implemento de Seguridad,252403 - Uniforme e Implemento de Seguridad,,"",,18PO06446,LM-001560,2018-12-08,
Physical Locations / Joya / Stock,Ubicaciones virtuales / Produccion,/ Joya / Stock,07,Uniformes e Implementos de Seguridad,110-0111-01,Par,ZAPATOS DE SEGURIDAD TALLA 39,2018-12-18,2018-12-18,,Joya\OUT\08942,,,Joya\OUT\08942,LUCIANO RUBEN VIZA CHOQUE,0,1.000000,3.000000,91.5258333333333333250000,0,91.5258333333333333250000000000,274.5774999999999999750000000000,91.5258333333333333250000,"",252403 - Uniforme e Implemento de Seguridad,23.05.01 SEGURIDAD Y MEDIO AMBIENTE,"",,,,,
Physical Locations / Joya / Stock,Ubicaciones virtuales / Produccion,/ Joya / Stock,07,Uniformes e Implementos de Seguridad,110-0111-01,Par,ZAPATOS DE SEGURIDAD TALLA 39,2018-12-19,2018-12-19,,Joya\OUT\08949,,,Joya\OUT\08949,LUZ ESTHER CHAÑI CUTIRE,0,1.000000,2.000000,91.5258333333333333250000,0,91.5258333333333333250000000000,183.0516666666666666500000000000,91.5258333333333333250000,"",252403 - Uniforme e Implemento de Seguridad,21.02.01 LIXIVIACIÓN Y ABSORCION,"",,,,,
Physical Locations / Joya / Stock,Ubicaciones virtuales / Produccion,/ Joya / Stock,07,Uniformes e Implementos de Seguridad,110-0111-01,Par,ZAPATOS DE SEGURIDAD TALLA 39,2018-12-26,2018-12-26,,Joya\OUT\09039,,,Joya\OUT\09039,LUZ ESTHER CHAÑI CUTIRE,0,1.000000,1.000000,91.5258333333333333250000,0,91.5258333333333333250000000000,91.5258333333333333250000000000,91.5258333333333333250000,"",252403 - Uniforme e Implemento de Seguridad,21.02.01 LIXIVIACIÓN Y ABSORCION,"",,,,,
Partner Locations / Suppliers,Physical Locations / Joya / Stock,/ Joya / Stock,03,Uniformes e Implementos de Seguridad,110-0112-01,Par,ZAPATOS DE SEGURIDAD TALLA 40,2018-12-01,2018-12-01,12/2018,Joya\IN\02933,01,0002,0003203,ESTHER SANDRA PINEDA LOAYZA,3.000000,0,3.000000,91.5266666666666667,274.58,0,274.58,91.5266666666666667,603203 - Uniforme e Implemento de Seguridad,252403 - Uniforme e Implemento de Seguridad,,"",,18PO06654,LM-001642,2018-12-01,
Partner Locations / Suppliers,Physical Locations / Joya / Stock,/ Joya / Stock,03,Uniformes e Implementos de Seguridad,110-0112-01,Par,ZAPATOS DE SEGURIDAD TALLA 40,2018-12-08,2018-12-08,12/2018,Joya\IN\02893,01,0002,0003157,ESTHER SANDRA PINEDA LOAYZA,2.000000,0,5.000000,91.5250000000000000,183.05,0,457.63,91.5260000000000000,603203 - Uniforme e Implemento de Seguridad,252403 - Uniforme e Implemento de Seguridad,,"",,18PO06446,LM-001560,2018-12-08,
Physical Locations / Joya / Stock,Ubicaciones virtuales / Produccion,/ Joya / Stock,07,Uniformes e Implementos de Seguridad,110-0112-01,Par,ZAPATOS DE SEGURIDAD TALLA 40,2018-12-10,2018-12-10,,Joya\OUT\08817,,,Joya\OUT\08817,LUZ ESTHER CHAÑI CUTIRE,0,1.000000,4.000000,91.5260000000000000,0,91.5260000000000000000000,366.1040000000000000000000,91.5260000000000000,"",252403 - Uniforme e Implemento de Seguridad,21.02.01 LIXIVIACIÓN Y ABSORCION,"",,,,,
Physical Locations / Joya / Stock,Ubicaciones virtuales / Produccion,/ Joya / Stock,07,Uniformes e Implementos de Seguridad,110-0112-01,Par,ZAPATOS DE SEGURIDAD TALLA 40,2018-12-19,2018-12-19,,Joya\OUT\08964,,,Joya\OUT\08964,LUZ ESTHER CHAÑI CUTIRE,0,1.000000,3.000000,91.5260000000000000,0,91.5260000000000000000000,274.5780000000000000000000,91.5260000000000000,"",252403 - Uniforme e Implemento de Seguridad,21.02.01 LIXIVIACIÓN Y ABSORCION,"",,,,,
Physical Locations / Joya / Stock,Ubicaciones virtuales / Produccion,/ Joya / Stock,07,Uniformes e Implementos de Seguridad,110-0112-01,Par,ZAPATOS DE SEGURIDAD TALLA 40,2018-12-20,2018-12-20,,Joya\OUT\08981,,,Joya\OUT\08981,LUZ ESTHER CHAÑI CUTIRE,0,1.000000,2.000000,91.5260000000000000,0,91.5260000000000000000000,183.0520000000000000000000,91.5260000000000000,"",252403 - Uniforme e Implemento de Seguridad,20.03.03 CHANCADO,"",,,,,
Physical Locations / Joya / Stock,Ubicaciones virtuales / Produccion,/ Joya / Stock,08,Uniformes e Implementos de Seguridad,110-0112-01,Par,ZAPATOS DE SEGURIDAD TALLA 40,2018-12-21,2018-12-21,,Joya\OUT\08987,,,Joya\OUT\08987,LUCIANO RUBEN VIZA CHOQUE,0,1.000000,1.000000,91.5260000000000000,0,91.5260000000000000000000,91.5260000000000000000000,91.5260000000000000,"",252403 - Uniforme e Implemento de Seguridad,"01.01.11	GESTION PLANTA,COMERCIAL Y ADMIN.","",,,,,
Physical Locations / Joya / Stock,Ubicaciones virtuales / Produccion,/ Joya / Stock,07,Uniformes e Implementos de Seguridad,110-0112-01,Par,ZAPATOS DE SEGURIDAD TALLA 40,2018-12-28,2018-12-28,,Joya\OUT\09061,,,Joya\OUT\09061,LUZ ESTHER CHAÑI CUTIRE,0,1.000000,0.000000,91.5260000000000000,0,91.5260000000000000000000,0.0000000000000000000000,0,"",252403 - Uniforme e Implemento de Seguridad,25.01.03 TALLER DE MANTENIMIENTO,"",,,,,
Partner Locations / Suppliers,Physical Locations / Joya / Stock,/ Joya / Stock,03,Uniformes e Implementos de Seguridad,110-0113-01,Par,ZAPATOS DE SEGURIDAD TALLA 41,2018-12-01,2018-12-01,12/2018,Joya\IN\02933,01,0002,0003203,ESTHER SANDRA PINEDA LOAYZA,3.000000,0,3.000000,91.5266666666666667,274.58,0,274.58,91.5266666666666667,603203 - Uniforme e Implemento de Seguridad,252403 - Uniforme e Implemento de Seguridad,,"",,18PO06654,LM-001642,2018-12-01,
Partner Locations / Suppliers,Physical Locations / Joya / Stock,/ Joya / Stock,03,Uniformes e Implementos de Seguridad,110-0113-01,Par,ZAPATOS DE SEGURIDAD TALLA 41,2018-12-08,2018-12-08,12/2018,Joya\IN\02893,01,0002,0003157,ESTHER SANDRA PINEDA LOAYZA,2.000000,0,5.000000,91.5250000000000000,183.05,0,457.63,91.5260000000000000,603203 - Uniforme e Implemento de Seguridad,252403 - Uniforme e Implemento de Seguridad,,"",,18PO06446,LM-001560,2018-12-08,
Physical Locations / Joya / Stock,Ubicaciones virtuales / Produccion,/ Joya / Stock,07,Uniformes e Implementos de Seguridad,110-0113-01,Par,ZAPATOS DE SEGURIDAD TALLA 41,2018-12-10,2018-12-10,,Joya\OUT\08852,,,Joya\OUT\08852,LUZ ESTHER CHAÑI CUTIRE,0,1.000000,4.000000,91.5260000000000000,0,91.5260000000000000000000,366.1040000000000000000000,91.5260000000000000,"",252403 - Uniforme e Implemento de Seguridad,20.03.03 CHANCADO,"",,,,,
Physical Locations / Joya / Stock,Ubicaciones virtuales / Produccion,/ Joya / Stock,07,Uniformes e Implementos de Seguridad,110-0113-01,Par,ZAPATOS DE SEGURIDAD TALLA 41,2018-12-19,2018-12-19,,Joya\OUT\08952,,,Joya\OUT\08952,LUZ ESTHER CHAÑI CUTIRE,0,1.000000,3.000000,91.5260000000000000,0,91.5260000000000000000000,274.5780000000000000000000,91.5260000000000000,"",252403 - Uniforme e Implemento de Seguridad,20.03.03 CHANCADO,"",,,,,
Physical Locations / Joya / Stock,Ubicaciones virtuales / Produccion,/ Joya / Stock,07,Uniformes e Implementos de Seguridad,110-0113-01,Par,ZAPATOS DE SEGURIDAD TALLA 41,2018-12-20,2018-12-20,,Joya\OUT\08978,,,Joya\OUT\08978,VICTOR URIEL VILCA CENTI,0,1.000000,2.000000,91.5260000000000000,0,91.5260000000000000000000,183.0520000000000000000000,91.5260000000000000,"",252403 - Uniforme e Implemento de Seguridad,20.05.02 LABORATORIO QUIMICO,"",,,,2018-12-20,
Physical Locations / Joya / Stock,Ubicaciones virtuales / Produccion,/ Joya / Stock,07,Uniformes e Implementos de Seguridad,110-0113-01,Par,ZAPATOS DE SEGURIDAD TALLA 41,2018-12-24,2018-12-24,,Joya\OUT\09033,,,Joya\OUT\09033,GAVINO FELICIANO (TRB) CALISAYA RODRIGUEZ,0,1.000000,1.000000,91.5260000000000000,0,91.5260000000000000000000,91.5260000000000000000000,91.5260000000000000,"",252403 - Uniforme e Implemento de Seguridad,21.02.01 LIXIVIACIÓN Y ABSORCION,"",,,,2018-12-24,
Partner Locations / Suppliers,Physical Locations / Joya / Stock,/ Joya / Stock,03,Uniformes e Implementos de Seguridad,110-0114-01,Par,ZAPATOS DE SEGURIDAD TALLA 42,2018-12-01,2018-12-01,12/2018,Joya\IN\02933,01,0002,0003203,ESTHER SANDRA PINEDA LOAYZA,3.000000,0,3.000000,91.5266666666666667,274.58,0,274.58,91.5266666666666667,603203 - Uniforme e Implemento de Seguridad,252403 - Uniforme e Implemento de Seguridad,,"",,18PO06654,LM-001642,2018-12-01,
Partner Locations / Suppliers,Physical Locations / Joya / Stock,/ Joya / Stock,03,Uniformes e Implementos de Seguridad,110-0114-01,Par,ZAPATOS DE SEGURIDAD TALLA 42,2018-12-08,2018-12-08,12/2018,Joya\IN\02893,01,0002,0003157,ESTHER SANDRA PINEDA LOAYZA,2.000000,0,5.000000,91.5250000000000000,183.05,0,457.63,91.5260000000000000,603203 - Uniforme e Implemento de Seguridad,252403 - Uniforme e Implemento de Seguridad,,"",,18PO06446,LM-001560,2018-12-08,
Physical Locations / Joya / Stock,Ubicaciones virtuales / Produccion,/ Joya / Stock,07,Uniformes e Implementos de Seguridad,110-0114-01,Par,ZAPATOS DE SEGURIDAD TALLA 42,2018-12-24,2018-12-24,,Joya\OUT\09029,,,Joya\OUT\09029,LUZ ESTHER CHAÑI CUTIRE,0,1.000000,4.000000,91.5260000000000000,0,91.5260000000000000000000,366.1040000000000000000000,91.5260000000000000,"",252403 - Uniforme e Implemento de Seguridad,29.01.81 MEJORAS EN SISTEMA DE ELECTRODEPOSICION Y MEJORAS SISTEMA DE COSECHAS DE CARBÓN,"",,,,,
Physical Locations / Joya / Stock,Ubicaciones virtuales / Produccion,/ Joya / Stock,07,Uniformes e Implementos de Seguridad,110-0114-01,Par,ZAPATOS DE SEGURIDAD TALLA 42,2018-12-26,2018-12-26,,Joya\OUT\09040,,,Joya\OUT\09040,LUZ ESTHER CHAÑI CUTIRE,0,1.000000,3.000000,91.5260000000000000,0,91.5260000000000000000000,274.5780000000000000000000,91.5260000000000000,"",252403 - Uniforme e Implemento de Seguridad,20.03.03 CHANCADO,"",,,,,
Physical Locations / Joya / Stock,Ubicaciones virtuales / Produccion,/ Joya / Stock,07,Uniformes e Implementos de Seguridad,110-0116-01,Par,ZAPATOS DE SEGURIDAD TALLA 44,2018-12-07,2018-12-07,,Joya\OUT\08830,,,Joya\OUT\08830,LUZ ESTHER CHAÑI CUTIRE,0,1.000000,-1.000000,0,0,0.000000,0.000000,0,"",252403 - Uniforme e Implemento de Seguridad,22.01.03 DESORCIÓN,"",,,,,
Partner Locations / Suppliers,Physical Locations / Joya / Stock,/ Joya / Stock,03,Uniformes e Implementos de Seguridad,110-0116-01,Par,ZAPATOS DE SEGURIDAD TALLA 44,2018-12-08,2018-12-08,12/2018,Joya\IN\02893,01,0002,0003157,ESTHER SANDRA PINEDA LOAYZA,1.000000,0,0.000000,91.53,91.53,0,91.530000,0,603203 - Uniforme e Implemento de Seguridad,252403 - Uniforme e Implemento de Seguridad,,"",,18PO06446,LM-001560,2018-12-08,
Partner Locations / Suppliers,Physical Locations / Joya / Stock,/ Joya / Stock,03,Uniformes e Implementos de Seguridad,110-0117-01,Par,ZAPATOS DIELECTRICOS TALLA 38,2018-12-01,2018-12-01,12/2018,Joya\IN\02933,01,0002,0003203,ESTHER SANDRA PINEDA LOAYZA,2.000000,0,2.000000,166.1000000000000000,332.2,0,332.2,166.1000000000000000,603203 - Uniforme e Implemento de Seguridad,252403 - Uniforme e Implemento de Seguridad,,"",,18PO06654,LM-001642,2018-12-01,
Partner Locations / Suppliers,Physical Locations / Joya / Stock,/ Joya / Stock,03,Uniformes e Implementos de Seguridad,110-0124-01,Par,GUANTES DE NEOPRENO,2018-12-01,2018-12-01,12/2018,Joya\IN\02933,01,0002,0003203,ESTHER SANDRA PINEDA LOAYZA,3.000000,0,3.000000,19.4900000000000000,58.47,0,58.47,19.4900000000000000,603203 - Uniforme e Implemento de Seguridad,252403 - Uniforme e Implemento de Seguridad,,"",,18PO06654,LM-001642,2018-12-01,
Physical Locations / Joya / Stock,Ubicaciones virtuales / Produccion,/ Joya / Stock,07,Suministros Electricos,111-0011-XX,Unit(s),PULSADOR ROJO,2018-12-17,2018-12-17,,Joya\OUT\08932,,,Joya\OUT\08932,ALEX ROGELIO (TRB) MEDINA ZABALAGA,0,2.000000,-2.000000,0,0,0.000000,0.000000,0,"",252404 - Suministros Electricos,20.05.06 PULVERIZADOR ANILLOS,"",,,,2018-12-17,
Physical Locations / Joya / Stock,Ubicaciones virtuales / Produccion,/ Joya / Stock,07,Suministros Electricos,111-0011-XX,Unit(s),PULSADOR ROJO,2018-12-18,2018-12-18,,Joya\OUT\08947,,,Joya\OUT\08947,ALEX ROGELIO (TRB) MEDINA ZABALAGA,0,1.000000,-3.000000,0,0,0.000000,0.000000,0,"",252404 - Suministros Electricos,21.02.03 TANQUE AGITADOR #1 (22'x22'),"",,,,2018-12-18,
Physical Locations / Joya / Stock,Ubicaciones virtuales / Produccion,/ Joya / Stock,07,Suministros Electricos,111-0012-XX,Unit(s),PULSADOR VERDE,2018-12-17,2018-12-17,,Joya\OUT\08932,,,Joya\OUT\08932,ALEX ROGELIO (TRB) MEDINA ZABALAGA,0,2.000000,-2.000000,0,0,0.000000,0.000000,0,"",252404 - Suministros Electricos,20.05.06 PULVERIZADOR ANILLOS,"",,,,2018-12-17,
Physical Locations / Joya / Stock,Ubicaciones virtuales / Produccion,/ Joya / Stock,07,Suministros Electricos,111-0012-XX,Unit(s),PULSADOR VERDE,2018-12-18,2018-12-18,,Joya\OUT\08947,,,Joya\OUT\08947,ALEX ROGELIO (TRB) MEDINA ZABALAGA,0,1.000000,-3.000000,0,0,0.000000,0.000000,0,"",252404 - Suministros Electricos,21.02.03 TANQUE AGITADOR #1 (22'x22'),"",,,,2018-12-18,
Physical Locations / Joya / Stock,Ubicaciones virtuales / Produccion,/ Joya / Stock,07,Suministros Electricos,111-0034-01,Unit(s),"CINTA AISLANTE TEMFLEX 1600 3/4"" COLOR NEGRO",2018-12-14,2018-12-14,,Joya\OUT\08917,,,Joya\OUT\08917,ALEX ROGELIO (TRB) MEDINA ZABALAGA,0,2.000000,-2.000000,0,0,0.000000,0.000000,0,"",252404 - Suministros Electricos,25.01.03 TALLER DE MANTENIMIENTO,"",,,,2018-12-14,
Physical Locations / Joya / Stock,Ubicaciones virtuales / Produccion,/ Joya / Stock,07,Suministros Electricos,111-0034-01,Unit(s),"CINTA AISLANTE TEMFLEX 1600 3/4"" COLOR NEGRO",2018-12-18,2018-12-18,,Joya\OUT\08944,,,Joya\OUT\08944,ALEX ROGELIO (TRB) MEDINA ZABALAGA,0,2.000000,-4.000000,0,0,0.000000,0.000000,0,"",252404 - Suministros Electricos,20.03.03 CHANCADO,"",,,,2018-12-18,
Physical Locations / Joya / Stock,Ubicaciones virtuales / Produccion,/ Joya / Stock,07,Suministros Electricos,111-0034-01,Unit(s),"CINTA AISLANTE TEMFLEX 1600 3/4"" COLOR NEGRO",2018-12-31,2018-12-31,,Joya\OUT\09096,,,Joya\OUT\09096,ALEX ROGELIO (TRB) MEDINA ZABALAGA,0,1.000000,-5.000000,0,0,0.000000,0.000000,0,"",252404 - Suministros Electricos,22.01.03 DESORCIÓN,"",,,,2018-12-31,
Physical Locations / Joya / Stock,Ubicaciones virtuales / Produccion,/ Joya / Stock,07,Suministros Electricos,111-0056-XX,Unit(s),CONTACTOR 12 A TRIFASICO BOBINA 220 V 60 HZ,2018-12-18,2018-12-18,,Joya\OUT\08944,,,Joya\OUT\08944,ALEX ROGELIO (TRB) MEDINA ZABALAGA,0,1.000000,-1.000000,0,0,0.000000,0.000000,0,"",252404 - Suministros Electricos,20.03.03 CHANCADO,"",,,,2018-12-18,
Physical Locations / Joya / Stock,Ubicaciones virtuales / Produccion,/ Joya / Stock,07,Suministros Electricos,111-0057-XX,Unit(s),CONTACTOR 18 A TRIFASICO BOBINA 220 V 60 HZ,2018-12-10,2018-12-10,,Joya\OUT\08858,,,Joya\OUT\08858,,0,1.000000,-1.000000,0,0,0.000000,0.000000,0,"",252404 - Suministros Electricos,22.01.09 TANQUE DE ACONDICIONAMIENTO 1.0 M3,"",,,,2018-12-10,
Physical Locations / Joya / Stock,Ubicaciones virtuales / Produccion,/ Joya / Stock,07,Suministros Electricos,111-0090-01,Unit(s),LIMPIA CONTACTOS,2018-12-14,2018-12-14,,Joya\OUT\08917,,,Joya\OUT\08917,ALEX ROGELIO (TRB) MEDINA ZABALAGA,0,1.000000,-1.000000,0,0,0.000000,0.000000,0,"",252404 - Suministros Electricos,25.01.03 TALLER DE MANTENIMIENTO,"",,,,2018-12-14,
Physical Locations / Joya / Stock,Ubicaciones virtuales / Produccion,/ Joya / Stock,07,Suministros Electricos,111-0119-02,Unit(s),SOLVENTE DIELECTRICO SS25M X 1GL,2018-12-18,2018-12-18,,Joya\OUT\08944,,,Joya\OUT\08944,ALEX ROGELIO (TRB) MEDINA ZABALAGA,0,1.000000,-1.000000,0,0,0.000000,0.000000,0,"",252404 - Suministros Electricos,20.03.03 CHANCADO,"",,,,2018-12-18,
Physical Locations / Joya / Stock,Ubicaciones virtuales / Produccion,/ Joya / Stock,07,Utiles de Oficina,112-0006-03,Unit(s),CUTTER,2018-12-14,2018-12-14,,Joya\OUT\08917,,,Joya\OUT\08917,ALEX ROGELIO (TRB) MEDINA ZABALAGA,0,1.000000,-1.000000,0,0,0.000000,0.000000,0,"",252406 - Utiles de Oficina,25.01.03 TALLER DE MANTENIMIENTO,"",,,,2018-12-14,
Physical Locations / Joya / Stock,Ubicaciones virtuales / Produccion,/ Joya / Stock,07,Herramientas e Instrumentos,112-0009-01,Unit(s),HOJA DE SIERRA,2018-12-16,2018-12-16,,Joya\OUT\08929,,,Joya\OUT\08929,VICTOR URIEL VILCA CENTI,0,2.000000,-2.000000,0,0,0.000000,0.000000,0,"",252405 - Herramientas e Instrumentos,20.05.02 LABORATORIO QUIMICO,"",,,,2018-12-16,
Physical Locations / Joya / Stock,Ubicaciones virtuales / Produccion,/ Joya / Stock,07,Herramientas e Instrumentos,112-0009-01,Unit(s),HOJA DE SIERRA,2018-12-25,2018-12-25,,Joya\OUT\09035,,,Joya\OUT\09035,LUIS FELIPE CARCAMO PALACO,0,10.000000,-12.000000,0,0,0.000000,0.000000,0,"",252405 - Herramientas e Instrumentos,20.03.03 CHANCADO,"",,,,,
Physical Locations / Joya / Stock,Ubicaciones virtuales / Produccion,/ Joya / Stock,07,Uniformes e Implementos de Seguridad,112-0012-01,Unit(s),LENTE PARA SOLDAR OSCURO 12,2018-12-14,2018-12-14,,Joya\OUT\08917,,,Joya\OUT\08917,ALEX ROGELIO (TRB) MEDINA ZABALAGA,0,4.000000,-4.000000,0,0,0.000000,0.000000,0,"",252403 - Uniforme e Implemento de Seguridad,25.01.03 TALLER DE MANTENIMIENTO,"",,,,2018-12-14,
Physical Locations / Joya / Stock,Ubicaciones virtuales / Produccion,/ Joya / Stock,07,Uniformes e Implementos de Seguridad,112-0012-01,Unit(s),LENTE PARA SOLDAR OSCURO 12,2018-12-17,2018-12-17,,Joya\OUT\08933,,,Joya\OUT\08933,ALEX ROGELIO (TRB) MEDINA ZABALAGA,0,4.000000,-8.000000,0,0,0.000000,0.000000,0,"",252403 - Uniforme e Implemento de Seguridad,21.02.03 TANQUE AGITADOR #1 (22'x22'),"",,,,2018-12-17,
Physical Locations / Joya / Stock,Ubicaciones virtuales / Produccion,/ Joya / Stock,07,Materiales de Ferreteria y Construccion,112-0020-01,Unit(s),ESCOBILLA PARA METAL,2018-12-19,2018-12-19,,Joya\OUT\08954,,,Joya\OUT\08954,JOSE SANTOS MATTA BORJAS,0,1.000000,-1.000000,0,0,0.000000,0.000000,0,"",252401 - Materiales de Ferreteria y Construccion,22.01.03 DESORCIÓN,"",,,,2018-12-19,
Physical Locations / Joya / Stock,Ubicaciones virtuales / Produccion,/ Joya / Stock,07,Utiles de Oficina,113-0003-01,Unit(s),CINTA DE EMBALAJE,2018-12-10,2018-12-10,,Joya\OUT\08851,,,Joya\OUT\08851,Harold Zambrano,0,1.000000,-1.000000,0,0,0.000000,0.000000,0,"",252406 - Utiles de Oficina,21.02.01 LIXIVIACIÓN Y ABSORCION,"",,,,,
Physical Locations / Joya / Stock,Ubicaciones virtuales / Produccion,/ Joya / Stock,07,Utiles de Oficina,113-0011-01,Unit(s),CORRECTOR,2018-12-06,2018-12-06,,Joya\OUT\08820,,,Joya\OUT\08820,VICTOR URIEL VILCA CENTI,0,1.000000,-1.000000,0,0,0.000000,0.000000,0,"",252406 - Utiles de Oficina,20.05.03 LABORATORIO METALURGICO,"",,,,2018-12-06,
Physical Locations / Joya / Stock,Ubicaciones virtuales / Produccion,/ Joya / Stock,07,Utiles de Oficina,113-0011-01,Unit(s),CORRECTOR,2018-12-21,2018-12-21,,Joya\OUT\08989,,,Joya\OUT\08989,VICTOR URIEL VILCA CENTI,0,1.000000,-2.000000,0,0,0.000000,0.000000,0,"",252406 - Utiles de Oficina,20.05.02 LABORATORIO QUIMICO,"",,,,2018-12-21,
Physical Locations / Joya / Stock,Ubicaciones virtuales / Produccion,/ Joya / Stock,07,Utiles de Oficina,113-0012-02,Unit(s),CUADERNO A4,2018-12-31,2018-12-31,,Joya\OUT\09151,,,Joya\OUT\09151,GAVINO FELICIANO (TRB) CALISAYA RODRIGUEZ,0,2.000000,-2.000000,0,0,0.000000,0.000000,0,"",252406 - Utiles de Oficina,23.02.01 ALMACENES,"",,,,2018-12-31,
Physical Locations / Joya / Stock,Ubicaciones virtuales / Produccion,/ Joya / Stock,07,Utiles de Oficina,113-0016-01,Unit(s),LAPICERO AZUL,2018-12-04,2018-12-04,,Joya\OUT\08798,,,Joya\OUT\08798,ERNESTO ALVAREZ OSORIO,0,1.000000,-1.000000,0,0,0.000000,0.000000,0,"",252406 - Utiles de Oficina,"21.02.18 BOMBA DE PULPA VERTICAL 1.1/2""X24""  LIXIVIACION","",,,,,
Physical Locations / Joya / Stock,Ubicaciones virtuales / Produccion,/ Joya / Stock,07,Utiles de Oficina,113-0016-01,Unit(s),LAPICERO AZUL,2018-12-05,2018-12-05,,Joya\OUT\08814,,,Joya\OUT\08814,LUZ ESTHER CHAÑI CUTIRE,0,2.000000,-3.000000,0,0,0.000000,0.000000,0,"",252406 - Utiles de Oficina,23.08.08 OTROS COSTOS INDIRECTOS,"",,,,,
Physical Locations / Joya / Stock,Ubicaciones virtuales / Produccion,/ Joya / Stock,07,Utiles de Oficina,113-0016-01,Unit(s),LAPICERO AZUL,2018-12-14,2018-12-14,,Joya\OUT\08914,,,Joya\OUT\08914,VICTOR URIEL VILCA CENTI,0,3.000000,-6.000000,0,0,0.000000,0.000000,0,"",252406 - Utiles de Oficina,20.05.02 LABORATORIO QUIMICO,"",,,,2018-12-14,
Physical Locations / Joya / Stock,Ubicaciones virtuales / Produccion,/ Joya / Stock,07,Utiles de Oficina,113-0016-01,Unit(s),LAPICERO AZUL,2018-12-18,2018-12-18,,Joya\OUT\09017,,,Joya\OUT\09017,Harold Zambrano,0,2.000000,-8.000000,0,0,0.000000,0.000000,0,"",252406 - Utiles de Oficina,20.03.03 CHANCADO,"",,,,2018-12-18,
Physical Locations / Joya / Stock,Ubicaciones virtuales / Produccion,/ Joya / Stock,07,Utiles de Oficina,113-0016-01,Unit(s),LAPICERO AZUL,2018-12-19,2018-12-19,,Joya\OUT\08956,,,Joya\OUT\08956,JOSE SANTOS MATTA BORJAS,0,1.000000,-9.000000,0,0,0.000000,0.000000,0,"",252406 - Utiles de Oficina,21.02.03 TANQUE AGITADOR #1 (22'x22'),"",,,,,
Physical Locations / Joya / Stock,Ubicaciones virtuales / Produccion,/ Joya / Stock,07,Utiles de Oficina,113-0016-01,Unit(s),LAPICERO AZUL,2018-12-21,2018-12-21,,Joya\OUT\08986,,,Joya\OUT\08986,ERNESTO ALVAREZ OSORIO,0,2.000000,-11.000000,0,0,0.000000,0.000000,0,"",252406 - Utiles de Oficina,"21.02.18 BOMBA DE PULPA VERTICAL 1.1/2""X24""  LIXIVIACION","",,,,,
Physical Locations / Joya / Stock,Ubicaciones virtuales / Produccion,/ Joya / Stock,07,Utiles de Oficina,113-0016-01,Unit(s),LAPICERO AZUL,2018-12-21,2018-12-21,,Joya\OUT\08990,,,Joya\OUT\08990,Harold Zambrano,0,2.000000,-13.000000,0,0,0.000000,0.000000,0,"",252406 - Utiles de Oficina,20.03.03 CHANCADO,"",,,,,
Physical Locations / Joya / Stock,Ubicaciones virtuales / Produccion,/ Joya / Stock,07,Utiles de Oficina,113-0016-01,Unit(s),LAPICERO AZUL,2018-12-24,2018-12-24,,Joya\OUT\09033,,,Joya\OUT\09033,GAVINO FELICIANO (TRB) CALISAYA RODRIGUEZ,0,4.000000,-17.000000,0,0,0.000000,0.000000,0,"",252406 - Utiles de Oficina,21.02.01 LIXIVIACIÓN Y ABSORCION,"",,,,2018-12-24,
Physical Locations / Joya / Stock,Ubicaciones virtuales / Produccion,/ Joya / Stock,07,Utiles de Oficina,113-0016-01,Unit(s),LAPICERO AZUL,2018-12-27,2018-12-27,,Joya\OUT\09055,,,Joya\OUT\09055,JOSE SANTOS MATTA BORJAS,0,4.000000,-21.000000,0,0,0.000000,0.000000,0,"",252406 - Utiles de Oficina,21.02.03 TANQUE AGITADOR #1 (22'x22'),"",,,,,
Physical Locations / Joya / Stock,Ubicaciones virtuales / Produccion,/ Joya / Stock,07,Utiles de Oficina,113-0016-01,Unit(s),LAPICERO AZUL,2018-12-31,2018-12-31,,Joya\OUT\09151,,,Joya\OUT\09151,GAVINO FELICIANO (TRB) CALISAYA RODRIGUEZ,0,4.000000,-25.000000,0,0,0.000000,0.000000,0,"",252406 - Utiles de Oficina,23.02.01 ALMACENES,"",,,,2018-12-31,
Physical Locations / Joya / Stock,Ubicaciones virtuales / Produccion,/ Joya / Stock,07,Utiles de Oficina,113-0017-01,Unit(s),LAPICERO NEGRO,2018-12-18,2018-12-18,,Joya\OUT\09017,,,Joya\OUT\09017,Harold Zambrano,0,1.000000,-1.000000,0,0,0.000000,0.000000,0,"",252406 - Utiles de Oficina,20.03.03 CHANCADO,"",,,,2018-12-18,
Physical Locations / Joya / Stock,Ubicaciones virtuales / Produccion,/ Joya / Stock,07,Utiles de Oficina,113-0022-01,Unit(s),MARCADOR PERMANENTE DELGADO,2018-12-26,2018-12-26,,Joya\OUT\09046,,,Joya\OUT\09046,JOSE SANTOS MATTA BORJAS,0,1.000000,-1.000000,0,0,0.000000,0.000000,0,"",252406 - Utiles de Oficina,20.03.03 CHANCADO,"",,,,,
Physical Locations / Joya / Stock,Ubicaciones virtuales / Produccion,/ Joya / Stock,07,Utiles de Oficina,113-0022-01,Unit(s),MARCADOR PERMANENTE DELGADO,2018-12-28,2018-12-28,,Joya\OUT\09060,,,Joya\OUT\09060,JOSE SANTOS MATTA BORJAS,0,1.000000,-2.000000,0,0,0.000000,0.000000,0,"",252406 - Utiles de Oficina,22.01.03 DESORCIÓN,"",,,,,
Physical Locations / Joya / Stock,Ubicaciones virtuales / Produccion,/ Joya / Stock,07,Utiles de Oficina,113-0025-06,Unit(s),PERFORADOR M-73,2018-12-14,2018-12-14,,Joya\OUT\08917,,,Joya\OUT\08917,ALEX ROGELIO (TRB) MEDINA ZABALAGA,0,1.000000,-1.000000,0,0,0.000000,0.000000,0,"",252406 - Utiles de Oficina,25.01.03 TALLER DE MANTENIMIENTO,"",,,,2018-12-14,
Physical Locations / Joya / Stock,Ubicaciones virtuales / Produccion,/ Joya / Stock,07,Utiles de Oficina,113-0027-01,Unit(s),PLUMON ACRILICO 152 AZUL,2018-12-06,2018-12-06,,Joya\OUT\08820,,,Joya\OUT\08820,VICTOR URIEL VILCA CENTI,0,3.000000,-3.000000,0,0,0.000000,0.000000,0,"",252406 - Utiles de Oficina,20.05.03 LABORATORIO METALURGICO,"",,,,2018-12-06,
Physical Locations / Joya / Stock,Ubicaciones virtuales / Produccion,/ Joya / Stock,07,Utiles de Oficina,113-0027-01,Unit(s),PLUMON ACRILICO 152 AZUL,2018-12-21,2018-12-21,,Joya\OUT\08989,,,Joya\OUT\08989,VICTOR URIEL VILCA CENTI,0,3.000000,-6.000000,0,0,0.000000,0.000000,0,"",252406 - Utiles de Oficina,20.05.02 LABORATORIO QUIMICO,"",,,,2018-12-21,
Physical Locations / Joya / Stock,Ubicaciones virtuales / Produccion,/ Joya / Stock,07,Utiles de Oficina,113-0031-01,Unit(s),PLUMON PERMANENTE 23 NEGRO,2018-12-06,2018-12-06,,Joya\OUT\08820,,,Joya\OUT\08820,VICTOR URIEL VILCA CENTI,0,6.000000,-6.000000,0,0,0.000000,0.000000,0,"",252406 - Utiles de Oficina,20.05.03 LABORATORIO METALURGICO,"",,,,2018-12-06,
Physical Locations / Joya / Stock,Ubicaciones virtuales / Produccion,/ Joya / Stock,07,Utiles de Oficina,113-0031-01,Unit(s),PLUMON PERMANENTE 23 NEGRO,2018-12-08,2018-12-08,,Joya\OUT\08845,,,Joya\OUT\08845,JOSE SANTOS MATTA BORJAS,0,1.000000,-7.000000,0,0,0.000000,0.000000,0,"",252406 - Utiles de Oficina,20.03.03 CHANCADO,"",,,,,
Physical Locations / Joya / Stock,Ubicaciones virtuales / Produccion,/ Joya / Stock,07,Utiles de Oficina,113-0031-01,Unit(s),PLUMON PERMANENTE 23 NEGRO,2018-12-18,2018-12-18,,Joya\OUT\09017,,,Joya\OUT\09017,Harold Zambrano,0,4.000000,-11.000000,0,0,0.000000,0.000000,0,"",252406 - Utiles de Oficina,21.02.01 LIXIVIACIÓN Y ABSORCION,"",,,,2018-12-18,
Physical Locations / Joya / Stock,Ubicaciones virtuales / Produccion,/ Joya / Stock,07,Utiles de Oficina,113-0031-01,Unit(s),PLUMON PERMANENTE 23 NEGRO,2018-12-19,2018-12-19,,Joya\OUT\08966,,,Joya\OUT\08966,Harold Zambrano,0,1.000000,-12.000000,0,0,0.000000,0.000000,0,"",252406 - Utiles de Oficina,20.03.03 CHANCADO,"",,,,,
Physical Locations / Joya / Stock,Ubicaciones virtuales / Produccion,/ Joya / Stock,07,Utiles de Oficina,113-0031-01,Unit(s),PLUMON PERMANENTE 23 NEGRO,2018-12-21,2018-12-21,,Joya\OUT\08989,,,Joya\OUT\08989,VICTOR URIEL VILCA CENTI,0,6.000000,-18.000000,0,0,0.000000,0.000000,0,"",252406 - Utiles de Oficina,20.05.02 LABORATORIO QUIMICO,"",,,,2018-12-21,
Physical Locations / Joya / Stock,Ubicaciones virtuales / Produccion,/ Joya / Stock,07,Utiles de Oficina,113-0031-01,Unit(s),PLUMON PERMANENTE 23 NEGRO,2018-12-21,2018-12-21,,Joya\OUT\08990,,,Joya\OUT\08990,Harold Zambrano,0,1.000000,-19.000000,0,0,0.000000,0.000000,0,"",252406 - Utiles de Oficina,20.03.03 CHANCADO,"",,,,,
Physical Locations / Joya / Stock,Ubicaciones virtuales / Produccion,/ Joya / Stock,07,Utiles de Oficina,113-0031-01,Unit(s),PLUMON PERMANENTE 23 NEGRO,2018-12-30,2018-12-30,,Joya\OUT\09081,,,Joya\OUT\09081,VICTOR URIEL VILCA CENTI,0,3.000000,-22.000000,0,0,0.000000,0.000000,0,"",252406 - Utiles de Oficina,20.05.02 LABORATORIO QUIMICO,"",,,,2018-12-30,
Physical Locations / Joya / Stock,Ubicaciones virtuales / Produccion,/ Joya / Stock,07,Utiles de Oficina,113-0038-01,Unit(s),RESALTADOR VERDE,2018-12-06,2018-12-06,,Joya\OUT\08820,,,Joya\OUT\08820,VICTOR URIEL VILCA CENTI,0,2.000000,-2.000000,0,0,0.000000,0.000000,0,"",252406 - Utiles de Oficina,20.05.02 LABORATORIO QUIMICO,"",,,,2018-12-06,
Physical Locations / Joya / Stock,Ubicaciones virtuales / Produccion,/ Joya / Stock,07,Otros Suministros Diversos,113-0044-01,Unit(s),PILAS DURACELL AA,2018-12-25,2018-12-25,,Joya\OUT\09035,,,Joya\OUT\09035,LUIS FELIPE CARCAMO PALACO,0,2.000000,-2.000000,0,0,0.000000,0.000000,0,"",252410 - Otros Suministros Diversos,20.03.03 CHANCADO,"",,,,,
Physical Locations / Joya / Stock,Ubicaciones virtuales / Produccion,/ Joya / Stock,07,Materiales de Limpieza,117-0008-01,Unit(s),ESCOBA,2018-12-12,2018-12-12,,Joya\OUT\08890,,,Joya\OUT\08890,Harold Zambrano,0,3.000000,-3.000000,0,0,0.000000,0.000000,0,"",252409 - Materiales de Limpieza,21.02.01 LIXIVIACIÓN Y ABSORCION,"",,,,,
Physical Locations / Joya / Stock,Ubicaciones virtuales / Produccion,/ Joya / Stock,07,Materiales de Limpieza,117-0008-01,Unit(s),ESCOBA,2018-12-28,2018-12-28,,Joya\OUT\09060,,,Joya\OUT\09060,JOSE SANTOS MATTA BORJAS,0,1.000000,-4.000000,0,0,0.000000,0.000000,0,"",252409 - Materiales de Limpieza,22.01.03 DESORCIÓN,"",,,,,
Physical Locations / Joya / Stock,Ubicaciones virtuales / Produccion,/ Joya / Stock,07,Materiales de Limpieza,117-0008-01,Unit(s),ESCOBA,2018-12-30,2018-12-30,,Joya\OUT\09085,,,Joya\OUT\09085,JOSE SANTOS MATTA BORJAS,0,1.000000,-5.000000,0,0,0.000000,0.000000,0,"",252409 - Materiales de Limpieza,21.02.03 TANQUE AGITADOR #1 (22'x22'),"",,,,,
Physical Locations / Joya / Stock,Ubicaciones virtuales / Produccion,/ Joya / Stock,07,Materiales de Limpieza,117-0009-01,Unit(s),ESCOBONES INDUSTRIALES,2018-12-12,2018-12-12,,Joya\OUT\08890,,,Joya\OUT\08890,Harold Zambrano,0,3.000000,-3.000000,0,0,0.000000,0.000000,0,"",252409 - Materiales de Limpieza,21.02.01 LIXIVIACIÓN Y ABSORCION,"",,,,,
Physical Locations / Joya / Stock,Ubicaciones virtuales / Produccion,/ Joya / Stock,07,Materiales de Limpieza,117-0009-01,Unit(s),ESCOBONES INDUSTRIALES,2018-12-19,2018-12-19,,Joya\OUT\08958,,,Joya\OUT\08958,Harold Zambrano,0,1.000000,-4.000000,0,0,0.000000,0.000000,0,"",252409 - Materiales de Limpieza,"22.01.29	DEPRECIACION DESORCION, FUNDICION Y REFINACION","",,,,,
Physical Locations / Joya / Stock,Ubicaciones virtuales / Produccion,/ Joya / Stock,07,Materiales de Limpieza,117-0009-01,Unit(s),ESCOBONES INDUSTRIALES,2018-12-20,2018-12-20,,Joya\OUT\08974,,,Joya\OUT\08974,JOSE SANTOS MATTA BORJAS,0,3.000000,-7.000000,0,0,0.000000,0.000000,0,"",252409 - Materiales de Limpieza,20.03.03 CHANCADO,"",,,,,
Physical Locations / Joya / Stock,Ubicaciones virtuales / Produccion,/ Joya / Stock,07,Materiales de Limpieza,117-0009-01,Unit(s),ESCOBONES INDUSTRIALES,2018-12-28,2018-12-28,,Joya\OUT\09060,,,Joya\OUT\09060,JOSE SANTOS MATTA BORJAS,0,1.000000,-8.000000,0,0,0.000000,0.000000,0,"",252409 - Materiales de Limpieza,22.01.03 DESORCIÓN,"",,,,,
Physical Locations / Joya / Stock,Ubicaciones virtuales / Produccion,/ Joya / Stock,07,Materiales de Limpieza,117-0012-01,Unit(s),LEJIA X 1 GL,2018-12-04,2018-12-04,,Joya\OUT\08804,,,Joya\OUT\08804,HELBERT ERNESTO CALLE PAYEHUANCA,0,2.000000,-2.000000,0,0,0.000000,0.000000,0,"",252409 - Materiales de Limpieza,23.08.08 OTROS COSTOS INDIRECTOS,"",,,,2018-12-04,
Physical Locations / Joya / Stock,Ubicaciones virtuales / Produccion,/ Joya / Stock,07,Materiales de Limpieza,117-0012-01,Unit(s),LEJIA X 1 GL,2018-12-07,2018-12-07,,Joya\OUT\08828,,,Joya\OUT\08828,FRANK JHONATAN ARIZAPANA CABRERA,0,1.000000,-3.000000,0,0,0.000000,0.000000,0,"",252409 - Materiales de Limpieza,20.02.05 ATENCION A MINERO REC MINERAL,"",,,,2018-12-07,
Physical Locations / Joya / Stock,Ubicaciones virtuales / Produccion,/ Joya / Stock,07,Repuestos de Maquinaria y Equipo,118-0002-XX,Unit(s),"APEX DE 1.1/2"" EN CAUCHO ANTIABRASIVO",2018-12-08,2018-12-08,,Joya\OUT\08845,,,Joya\OUT\08845,JOSE SANTOS MATTA BORJAS,0,2.000000,-2.000000,0,0,0.000000,0.000000,0,"",253102 - Repuestos Maquinaria y Eq,21.01.09 MOLINO 6' X 8' DELTA,"",,,,,
Physical Locations / Joya / Stock,Ubicaciones virtuales / Produccion,/ Joya / Stock,07,Repuestos de Maquinaria y Equipo,118-0034-04,Unit(s),FAJA TRAPEZOIDAL B- 48,2018-12-29,2018-12-29,,Joya\OUT\09067,,,Joya\OUT\09067,MARVIN EDUARDO QUISPE LEIVA,0,2.000000,-2.000000,0,0,0.000000,0.000000,0,"",253102 - Repuestos Maquinaria y Eq,21.02.03 TANQUE AGITADOR #1 (22'x22'),"",,,,2018-12-29,
Physical Locations / Joya / Stock,Ubicaciones virtuales / Produccion,/ Joya / Stock,07,Repuestos de Maquinaria y Equipo,118-0034-04,Unit(s),FAJA TRAPEZOIDAL B- 48,2018-12-31,2018-12-31,,Joya\OUT\09096,,,Joya\OUT\09096,ALEX ROGELIO (TRB) MEDINA ZABALAGA,0,2.000000,-4.000000,0,0,0.000000,0.000000,0,"",253102 - Repuestos Maquinaria y Eq,"21.02.18 BOMBA DE PULPA VERTICAL 1.1/2""X24""  LIXIVIACION","",,,,2018-12-31,
Physical Locations / Joya / Stock,Ubicaciones virtuales / Produccion,/ Joya / Stock,07,Repuestos de Maquinaria y Equipo,118-0036-04,Unit(s),FAJA TRAPEZOIDAL B- 50,2018-12-29,2018-12-29,,Joya\OUT\09067,,,Joya\OUT\09067,MARVIN EDUARDO QUISPE LEIVA,0,3.000000,-3.000000,0,0,0.000000,0.000000,0,"",253102 - Repuestos Maquinaria y Eq,21.01.10 MOLINO 6' X 8' CHINO,"",,,,2018-12-29,
Physical Locations / Joya / Stock,Ubicaciones virtuales / Produccion,/ Joya / Stock,07,Repuestos de Maquinaria y Equipo,118-0042-04,Unit(s),FAJA TRAPEZOIDAL D - 180,2018-12-29,2018-12-29,,Joya\OUT\09067,,,Joya\OUT\09067,MARVIN EDUARDO QUISPE LEIVA,0,5.000000,-5.000000,0,0,0.000000,0.000000,0,"",253102 - Repuestos Maquinaria y Eq,20.03.17 CHANCADORA CONICA DANKER 3',"",,,,2018-12-29,
Physical Locations / Joya / Stock,Ubicaciones virtuales / Produccion,/ Joya / Stock,07,Repuestos de Maquinaria y Equipo,118-0042-04,Unit(s),FAJA TRAPEZOIDAL D - 180,2018-12-31,2018-12-31,,Joya\OUT\09096,,,Joya\OUT\09096,ALEX ROGELIO (TRB) MEDINA ZABALAGA,0,5.000000,-10.000000,0,0,0.000000,0.000000,0,"",253102 - Repuestos Maquinaria y Eq,20.03.17 CHANCADORA CONICA DANKER 3',"",,,,2018-12-31,
Physical Locations / Joya / Stock,Ubicaciones virtuales / Produccion,/ Joya / Stock,07,Repuestos de Maquinaria y Equipo,118-0054-02,Unit(s),FILTRO CAT 156-1200,2018-12-31,2018-12-31,,Joya\OUT\09096,,,Joya\OUT\09096,ALEX ROGELIO (TRB) MEDINA ZABALAGA,0,1.000000,-1.000000,0,0,0.000000,0.000000,0,"",253102 - Repuestos Maquinaria y Eq,20.03.06 MINICARGADOR - BOBCAT (CAT 242) ,"",,,,2018-12-31,
Physical Locations / Joya / Stock,Ubicaciones virtuales / Produccion,/ Joya / Stock,07,Repuestos de Maquinaria y Equipo,118-0063-02,Unit(s),FILTRO DONALDSON P827653,2018-12-31,2018-12-31,,Joya\OUT\09096,,,Joya\OUT\09096,ALEX ROGELIO (TRB) MEDINA ZABALAGA,0,1.000000,-1.000000,0,0,0.000000,0.000000,0,"",253102 - Repuestos Maquinaria y Eq,20.03.06 MINICARGADOR - BOBCAT (CAT 242) ,"",,,,2018-12-31,
Physical Locations / Joya / Stock,Ubicaciones virtuales / Produccion,/ Joya / Stock,07,Repuestos de Maquinaria y Equipo,118-0067-02,Unit(s),FILTRO FLEETGUARD HF6555,2018-12-20,2018-12-20,,Joya\OUT\08977,,,Joya\OUT\08977,ALEX ROGELIO (TRB) MEDINA ZABALAGA,0,1.000000,-1.000000,0,0,0.000000,0.000000,0,"",253102 - Repuestos Maquinaria y Eq,20.03.04 CARGADOR FRONTAL (CAT 950),"",,,,2018-12-20,
Partner Locations / Suppliers,Physical Locations / Joya / Stock,/ Joya / Stock,07,Repuestos de Maquinaria y Equipo,118-0071-02,Unit(s),FILTRO FLEETGUARD LF3335,2018-12-21,2018-12-21,12/2018,Joya\IN\02872,01,F009,0001282,ROBERTO A TORRES S A -ROATSA,1.000000,0,1.000000,19.2900000000000000,19.29,0,19.29,19.2900000000000000,603302 - Repuesto de Maq y Equipo,253102 - Repuestos Maquinaria y Eq,,"",,18PO06301,LM-001580,2018-12-21,
Physical Locations / Joya / Stock,Ubicaciones virtuales / Produccion,/ Joya / Stock,07,Repuestos de Maquinaria y Equipo,118-0071-02,Unit(s),FILTRO FLEETGUARD LF3335,2018-12-31,2018-12-31,,Joya\OUT\09096,,,Joya\OUT\09096,ALEX ROGELIO (TRB) MEDINA ZABALAGA,0,1.000000,0.000000,19.2900000000000000,0,19.2900000000000000000000,0.0000000000000000000000,0,"",253102 - Repuestos Maquinaria y Eq,20.03.06 MINICARGADOR - BOBCAT (CAT 242) ,"",,,,2018-12-31,
Partner Locations / Suppliers,Physical Locations / Joya / Stock,/ Joya / Stock,03,Repuestos de Maquinaria y Equipo,118-0083-03,Unit(s),IMPULSOR GRUNDFOS,2018-12-06,2018-12-06,11/2018,Joya\IN\02848,01,0001,0000670,SUMINISTROS INDUSTRIALES AQP SOCIEDAD ANONIMA CERRADA - SUMIN AQP S.A.C.,5.000000,0,5.000000,208.6980000000000000,1043.49,0,1043.49,208.6980000000000000,603302 - Repuesto de Maq y Equipo,253102 - Repuestos Maquinaria y Eq,,"",,18PO06158,LM-001498,2018-12-06,
Physical Locations / Joya / Stock,Ubicaciones virtuales / Produccion,/ Joya / Stock,07,Repuestos de Maquinaria y Equipo,118-0083-03,Unit(s),IMPULSOR GRUNDFOS,2018-12-18,2018-12-18,,Joya\OUT\08945,,,Joya\OUT\08945,ALEX ROGELIO (TRB) MEDINA ZABALAGA,0,1.000000,4.000000,208.6980000000000000,0,208.6980000000000000000000,834.7920000000000000000000,208.6980000000000000,"",253102 - Repuestos Maquinaria y Eq,"21.02.23 BOMBA CENTRIFUGA 2""X2"" - RECIRCULACION","",,,,2018-12-18,
Physical Locations / Joya / Stock,Ubicaciones virtuales / Produccion,/ Joya / Stock,07,Repuestos de Maquinaria y Equipo,118-0083-03,Unit(s),IMPULSOR GRUNDFOS,2018-12-20,2018-12-20,,Joya\OUT\08977,,,Joya\OUT\08977,ALEX ROGELIO (TRB) MEDINA ZABALAGA,0,1.000000,3.000000,208.6980000000000000,0,208.6980000000000000000000,626.0940000000000000000000,208.6980000000000000,"",253102 - Repuestos Maquinaria y Eq,"21.02.23 BOMBA CENTRIFUGA 2""X2"" - RECIRCULACION","",,,,2018-12-20,
Partner Locations / Suppliers,Physical Locations / Joya / Stock,/ Joya / Stock,03,Repuestos de Maquinaria y Equipo,118-0087-03,Unit(s),KIT SELLOS GRUNDFOS,2018-12-01,2018-12-01,11/2018,Joya\IN\02770,01,0001,0000653,SUMINISTROS INDUSTRIALES AQP SOCIEDAD ANONIMA CERRADA - SUMIN AQP S.A.C.,1.000000,0,1.000000,740.7500000000000000,740.75,0,740.75,740.7500000000000000,603302 - Repuesto de Maq y Equipo,253102 - Repuestos Maquinaria y Eq,,"",,18PO05568,LM-001400,2018-12-01,
Physical Locations / Joya / Stock,Ubicaciones virtuales / Produccion,/ Joya / Stock,07,Repuestos de Maquinaria y Equipo,118-0087-03,Unit(s),KIT SELLOS GRUNDFOS,2018-12-18,2018-12-18,,Joya\OUT\08945,,,Joya\OUT\08945,ALEX ROGELIO (TRB) MEDINA ZABALAGA,0,1.000000,0.000000,740.7500000000000000,0,740.7500000000000000000000,0.0000000000000000000000,0,"",253102 - Repuestos Maquinaria y Eq,"21.02.23 BOMBA CENTRIFUGA 2""X2"" - RECIRCULACION","",,,,2018-12-18,
Physical Locations / Joya / Stock,Ubicaciones virtuales / Produccion,/ Joya / Stock,07,Materiales de Limpieza,119-0002-02,Unit(s),CREMA LIMPIADORA CITRICA X 1 GL,2018-12-31,2018-12-31,,Joya\OUT\09087,,,Joya\OUT\09087,ALEX ROGELIO (TRB) MEDINA ZABALAGA,0,1.000000,-1.000000,0,0,0.000000,0.000000,0,"",252409 - Materiales de Limpieza,21.02.01 LIXIVIACIÓN Y ABSORCION,"",,,,2018-12-31,
Partner Locations / Suppliers,Physical Locations / Joya / Stock,/ Joya / Stock,03,Otros Suministros Diversos,114-0001-01,Unit(s),AGUA SAN LUIS X 20 LT,2018-12-01,2018-12-01,12/2018,Joya\IN\02926,01,F002,0001107,DISTRIBUCIONES SAN JUAN MASIAS S.A.C.,30.000000,0,30.000000,21.8800000000000000,656.4,0,656.4,21.8800000000000000,603210 - Otros Suministros Diversos,252410 - Otros Suministros Diversos,,"",,18PO06706,LM-001642,2018-12-01,
Physical Locations / Joya / Stock,Ubicaciones virtuales / Produccion,/ Joya / Stock,07,Otros Suministros Diversos,114-0001-01,Unit(s),AGUA SAN LUIS X 20 LT,2018-12-03,2018-12-03,,Joya\OUT\08784,,,Joya\OUT\08784,HAROL ZAMBRANO RAMOS,0,1.000000,29.000000,21.8800000000000000,0,21.8800000000000000000000,634.5200000000000000000000,21.8800000000000000,"",252410 - Otros Suministros Diversos,23.08.05 ELECTRICIDAD OFICINA,"",,,,,
Physical Locations / Joya / Stock,Ubicaciones virtuales / Produccion,/ Joya / Stock,07,Otros Suministros Diversos,114-0001-01,Unit(s),AGUA SAN LUIS X 20 LT,2018-12-04,2018-12-04,,Joya\OUT\08798,,,Joya\OUT\08798,ERNESTO ALVAREZ OSORIO,0,1.000000,28.000000,21.8800000000000000,0,21.8800000000000000000000,612.6400000000000000000000,21.8800000000000000,"",252410 - Otros Suministros Diversos,21.02.01 LIXIVIACIÓN Y ABSORCION,"",,,,,
Physical Locations / Joya / Stock,Ubicaciones virtuales / Produccion,/ Joya / Stock,07,Otros Suministros Diversos,114-0001-01,Unit(s),AGUA SAN LUIS X 20 LT,2018-12-04,2018-12-04,,Joya\OUT\08801,,,Joya\OUT\08801,VICTOR URIEL VILCA CENTI,0,2.000000,26.000000,21.8800000000000000,0,43.7600000000000000000000,568.8800000000000000000000,21.8800000000000000,"",252410 - Otros Suministros Diversos,20.05.02 LABORATORIO QUIMICO,"",,,,2018-12-04,
,,/ Joya / Stock,"",Otros Suministros Diversos,"","",AGUA SAN LUIS X 20 LT,,2018-12-05,12/2018,,01,0003,0002020,WILMER ABEL CHOQUE VILCA,0,0,26.000000,30.4523076923076923076923,222.88,0,791.7600000000000000000000,30.4523076923076923076923,603210,252410 - Otros Suministros Diversos,"",,,,,,
Partner Locations / Suppliers,Physical Locations / Joya / Stock,/ Joya / Stock,03,Otros Suministros Diversos,114-0001-01,Unit(s),AGUA SAN LUIS X 20 LT,2018-12-06,2018-12-06,12/2018,Joya\IN\02889,01,F002,0001070,DISTRIBUCIONES SAN JUAN MASIAS S.A.C.,30.000000,0,56.000000,21.8800000000000000,656.4,0,1448.1600000000000000000000,25.8600000000000000000000,603210 - Otros Suministros Diversos,252410 - Otros Suministros Diversos,,"",,18PO06428,LM-001588,2018-12-06,
Physical Locations / Joya / Stock,Ubicaciones virtuales / Produccion,/ Joya / Stock,07,Otros Suministros Diversos,114-0001-01,Unit(s),AGUA SAN LUIS X 20 LT,2018-12-06,2018-12-06,,Joya\OUT\08816,,,Joya\OUT\08816,HELBERT ERNESTO CALLE PAYEHUANCA,0,1.000000,55.000000,25.8600000000000000000000,0,25.8600000000000000000000000000,1422.3000000000000000000000000000,25.8600000000000000000000,"",252410 - Otros Suministros Diversos,21.02.01 LIXIVIACIÓN Y ABSORCION,"",,,,2018-12-06,
Physical Locations / Joya / Stock,Ubicaciones virtuales / Produccion,/ Joya / Stock,07,Otros Suministros Diversos,114-0001-01,Unit(s),AGUA SAN LUIS X 20 LT,2018-12-06,2018-12-06,,Joya\OUT\08820,,,Joya\OUT\08820,VICTOR URIEL VILCA CENTI,0,2.000000,53.000000,25.8600000000000000000000,0,51.7200000000000000000000000000,1370.5800000000000000000000000000,25.8600000000000000000000,"",252410 - Otros Suministros Diversos,20.05.03 LABORATORIO METALURGICO,"",,,,2018-12-06,
Physical Locations / Joya / Stock,Ubicaciones virtuales / Produccion,/ Joya / Stock,08,Otros Suministros Diversos,114-0001-01,Unit(s),AGUA SAN LUIS X 20 LT,2018-12-07,2018-12-07,,Joya\OUT\08824,,,Joya\OUT\08824,Harold Zambrano,0,2.000000,51.000000,25.8600000000000000000000,0,51.7200000000000000000000000000,1318.8600000000000000000000000000,25.8600000000000000000000,"",252410 - Otros Suministros Diversos,20.03.03 CHANCADO,"",,,,,
Physical Locations / Joya / Stock,Ubicaciones virtuales / Produccion,/ Joya / Stock,07,Otros Suministros Diversos,114-0001-01,Unit(s),AGUA SAN LUIS X 20 LT,2018-12-07,2018-12-07,,Joya\OUT\08826,,,Joya\OUT\08826,MISHELLE GABRIELA TAPIA ZEGARRA,0,1.000000,50.000000,25.8600000000000000000000,0,25.8600000000000000000000000000,1293.0000000000000000000000000000,25.8600000000000000000000,"",252410 - Otros Suministros Diversos,01.01.04 RECURSOS HUMANOS,"",,,,2018-12-07,
Physical Locations / Joya / Stock,Ubicaciones virtuales / Produccion,/ Joya / Stock,07,Otros Suministros Diversos,114-0001-01,Unit(s),AGUA SAN LUIS X 20 LT,2018-12-08,2018-12-08,,Joya\OUT\08843,,,Joya\OUT\08843,HELBERT ERNESTO CALLE PAYEHUANCA,0,1.000000,49.000000,25.8600000000000000000000,0,25.8600000000000000000000000000,1267.1400000000000000000000000000,25.8600000000000000000000,"",252410 - Otros Suministros Diversos,23.08.08 OTROS COSTOS INDIRECTOS,"",,,,2018-12-08,
Physical Locations / Joya / Stock,Ubicaciones virtuales / Produccion,/ Joya / Stock,07,Otros Suministros Diversos,114-0001-01,Unit(s),AGUA SAN LUIS X 20 LT,2018-12-09,2018-12-09,,Joya\OUT\08846,,,Joya\OUT\08846,MARVIN EDUARDO QUISPE LEIVA,0,1.000000,48.000000,25.8600000000000000000000,0,25.8600000000000000000000000000,1241.2800000000000000000000000000,25.8600000000000000000000,"",252410 - Otros Suministros Diversos,25.01.03 TALLER DE MANTENIMIENTO,"",,,,2018-12-09,
Physical Locations / Joya / Stock,Ubicaciones virtuales / Produccion,/ Joya / Stock,07,Otros Suministros Diversos,114-0001-01,Unit(s),AGUA SAN LUIS X 20 LT,2018-12-10,2018-12-10,,Joya\OUT\08851,,,Joya\OUT\08851,Harold Zambrano,0,2.000000,46.000000,25.8600000000000000000000,0,51.7200000000000000000000000000,1189.5600000000000000000000000000,25.8600000000000000000000,"",252410 - Otros Suministros Diversos,21.02.01 LIXIVIACIÓN Y ABSORCION,"",,,,,
Physical Locations / Joya / Stock,Ubicaciones virtuales / Produccion,/ Joya / Stock,07,Otros Suministros Diversos,114-0001-01,Unit(s),AGUA SAN LUIS X 20 LT,2018-12-10,2018-12-10,,Joya\OUT\08859,,,Joya\OUT\08859,HELBERT ERNESTO CALLE PAYEHUANCA,0,1.000000,45.000000,25.8600000000000000000000,0,25.8600000000000000000000000000,1163.7000000000000000000000000000,25.8600000000000000000000,"",252410 - Otros Suministros Diversos,29.01.32 AMPLIACION DEL AREA DE DESORCION - REFINACION,"",,,,2018-12-10,
Physical Locations / Joya / Stock,Ubicaciones virtuales / Produccion,/ Joya / Stock,08,Otros Suministros Diversos,114-0001-01,Unit(s),AGUA SAN LUIS X 20 LT,2018-12-12,2018-12-12,,Joya\OUT\08884,,,Joya\OUT\08884,EDISON (TRB) RAMOS HACHIRI,0,1.000000,44.000000,25.8600000000000000000000,0,25.8600000000000000000000000000,1137.8400000000000000000000000000,25.8600000000000000000000,"",252410 - Otros Suministros Diversos,29.01.82 TANQUE NUEVO DE 22X22',"",,,,2018-12-12,
Physical Locations / Joya / Stock,Ubicaciones virtuales / Produccion,/ Joya / Stock,07,Otros Suministros Diversos,114-0001-01,Unit(s),AGUA SAN LUIS X 20 LT,2018-12-13,2018-12-13,,Joya\OUT\08909,,,Joya\OUT\08909,HELBERT ERNESTO CALLE PAYEHUANCA,0,2.000000,42.000000,25.8600000000000000000000,0,51.7200000000000000000000000000,1086.1200000000000000000000000000,25.8600000000000000000000,"",252410 - Otros Suministros Diversos,20.03.03 CHANCADO,"",,,,2018-12-13,
Physical Locations / Joya / Stock,Ubicaciones virtuales / Produccion,/ Joya / Stock,07,Otros Suministros Diversos,114-0001-01,Unit(s),AGUA SAN LUIS X 20 LT,2018-12-13,2018-12-13,,Joya\OUT\08910,,,Joya\OUT\08910,LUZ ESTHER CHAÑI CUTIRE,0,1.000000,41.000000,25.8600000000000000000000,0,25.8600000000000000000000000000,1060.2600000000000000000000000000,25.8600000000000000000000,"",252410 - Otros Suministros Diversos,23.05.01 SEGURIDAD Y MEDIO AMBIENTE,"",,,,,
Physical Locations / Joya / Stock,Ubicaciones virtuales / Produccion,/ Joya / Stock,07,Otros Suministros Diversos,114-0001-01,Unit(s),AGUA SAN LUIS X 20 LT,2018-12-14,2018-12-14,,Joya\OUT\08913,,,Joya\OUT\08913,Harold Zambrano,0,2.000000,39.000000,25.8600000000000000000000,0,51.7200000000000000000000000000,1008.5400000000000000000000000000,25.8600000000000000000000,"",252410 - Otros Suministros Diversos,"22.01.29	DEPRECIACION DESORCION, FUNDICION Y REFINACION","",,,,,
Physical Locations / Joya / Stock,Ubicaciones virtuales / Produccion,/ Joya / Stock,07,Otros Suministros Diversos,114-0001-01,Unit(s),AGUA SAN LUIS X 20 LT,2018-12-16,2018-12-16,,Joya\OUT\08925,,,Joya\OUT\08925,Harold Zambrano,0,3.000000,36.000000,25.8600000000000000000000,0,77.5800000000000000000000000000,930.9600000000000000000000000000,25.8600000000000000000000,"",252410 - Otros Suministros Diversos,21.01.01 MOLIENDA,"",,,,,
Physical Locations / Joya / Stock,Ubicaciones virtuales / Produccion,/ Joya / Stock,07,Otros Suministros Diversos,114-0001-01,Unit(s),AGUA SAN LUIS X 20 LT,2018-12-18,2018-12-18,,Joya\OUT\08944,,,Joya\OUT\08944,ALEX ROGELIO (TRB) MEDINA ZABALAGA,0,1.000000,35.000000,25.8600000000000000000000,0,25.8600000000000000000000000000,905.1000000000000000000000000000,25.8600000000000000000000,"",252410 - Otros Suministros Diversos,23.04.04 OTROS GASTOS INDIRECTOS PERSONAL,"",,,,2018-12-18,
Physical Locations / Joya / Stock,Ubicaciones virtuales / Produccion,/ Joya / Stock,07,Otros Suministros Diversos,114-0001-01,Unit(s),AGUA SAN LUIS X 20 LT,2018-12-18,2018-12-18,,Joya\OUT\09017,,,Joya\OUT\09017,Harold Zambrano,0,2.000000,33.000000,25.8600000000000000000000,0,51.7200000000000000000000000000,853.3800000000000000000000000000,25.8600000000000000000000,"",252410 - Otros Suministros Diversos,20.03.03 CHANCADO,"",,,,2018-12-18,
,,/ Joya / Stock,"",Otros Suministros Diversos,"","",AGUA SAN LUIS X 20 LT,,2018-12-19,12/2018,,01,0003,0002027,WILMER ABEL CHOQUE VILCA,0,0,33.000000,28.3424242424242424242424242424,81.92,0,935.3000000000000000000000000000,28.3424242424242424242424242424,603210,252410 - Otros Suministros Diversos,"",,,,,,
Physical Locations / Joya / Stock,Ubicaciones virtuales / Produccion,/ Joya / Stock,07,Otros Suministros Diversos,114-0001-01,Unit(s),AGUA SAN LUIS X 20 LT,2018-12-19,2018-12-19,,Joya\OUT\08967,,,Joya\OUT\08967,Harold Zambrano,0,10.000000,23.000000,28.3424242424242424242424242424,0,283.4242424242424242424242424240000000,651.8757575757575757575757575760000000,28.3424242424242424242424242424,"",252410 - Otros Suministros Diversos,20.03.03 CHANCADO,"",,,,2018-12-19,
Physical Locations / Joya / Stock,Ubicaciones virtuales / Produccion,/ Joya / Stock,07,Otros Suministros Diversos,114-0001-01,Unit(s),AGUA SAN LUIS X 20 LT,2018-12-19,2018-12-19,,Joya\OUT\08967,,,Joya\OUT\08967,Harold Zambrano,0,9.000000,14.000000,28.3424242424242424242424242424,0,255.0818181818181818181818181816000000,396.7939393939393939393939393944000000,28.3424242424242424242424242424,"",252410 - Otros Suministros Diversos,21.02.01 LIXIVIACIÓN Y ABSORCION,"",,,,2018-12-19,
Physical Locations / Joya / Stock,Ubicaciones virtuales / Produccion,/ Joya / Stock,07,Otros Suministros Diversos,114-0001-01,Unit(s),AGUA SAN LUIS X 20 LT,2018-12-24,2018-12-24,,Joya\OUT\09028,,,Joya\OUT\09028,,0,2.000000,12.000000,28.3424242424242424242424242424,0,56.6848484848484848484848484848000000,340.1090909090909090909090909096000000,28.3424242424242424242424242424,"",252410 - Otros Suministros Diversos,21.02.01 LIXIVIACIÓN Y ABSORCION,"",,,,,
Physical Locations / Joya / Stock,Ubicaciones virtuales / Produccion,/ Joya / Stock,07,Otros Suministros Diversos,114-0001-01,Unit(s),AGUA SAN LUIS X 20 LT,2018-12-24,2018-12-24,,Joya\OUT\09034,,,Joya\OUT\09034,VICTOR URIEL VILCA CENTI,0,2.000000,10.000000,28.3424242424242424242424242424,0,56.6848484848484848484848484848000000,283.4242424242424242424242424248000000,28.3424242424242424242424242424,"",252410 - Otros Suministros Diversos,20.05.02 LABORATORIO QUIMICO,"",,,,2018-12-24,
Physical Locations / Joya / Stock,Ubicaciones virtuales / Produccion,/ Joya / Stock,07,Otros Suministros Diversos,114-0001-01,Unit(s),AGUA SAN LUIS X 20 LT,2018-12-25,2018-12-25,,Joya\OUT\09036,,,Joya\OUT\09036,VICTOR URIEL VILCA CENTI,0,2.000000,8.000000,28.3424242424242424242424242424,0,56.6848484848484848484848484848000000,226.7393939393939393939393939400000000,28.3424242424242424242424242424,"",252410 - Otros Suministros Diversos,20.05.02 LABORATORIO QUIMICO,"",,,,2018-12-25,
Partner Locations / Suppliers,Physical Locations / Joya / Stock,/ Joya / Stock,03,Otros Suministros Diversos,114-0001-01,Unit(s),AGUA SAN LUIS X 20 LT,2018-12-26,2018-12-26,12/2018,Joya\IN\02918,01,F005,0001105,DISTRIBUCIONES SAN JUAN MASIAS S.A.C.,30.000000,0,38.000000,21.8800000000000000,656.4,0,883.1393939393939393939393939400000000,23.2405103668261562998405103668421053,603210 - Otros Suministros Diversos,252410 - Otros Suministros Diversos,,"",,18PO06765,LM-001652,,
,,/ Joya / Stock,"",Otros Suministros Diversos,"","",AGUA SAN LUIS X 20 LT,,2018-12-26,12/2018,,01,0003,0002035,WILMER ABEL CHOQUE VILCA,0,0,38.000000,28.2584051036682615629984051036842105,190.68,0,1073.8193939393939393939393939400000000,28.2584051036682615629984051036842105,603210,252410 - Otros Suministros Diversos,"",,,,,,
Physical Locations / Joya / Stock,Ubicaciones virtuales / Produccion,/ Joya / Stock,07,Otros Suministros Diversos,114-0001-01,Unit(s),AGUA SAN LUIS X 20 LT,2018-12-26,2018-12-26,,Joya\OUT\09041,,,Joya\OUT\09041,Harold Zambrano,0,3.000000,35.000000,28.2584051036682615629984051036842105,0,84.7752153110047846889952153110526315000000,989.0441786283891547049441786289473685000000,28.2584051036682615629984051036842105,"",252410 - Otros Suministros Diversos,20.03.03 CHANCADO,"",,,,,
Physical Locations / Joya / Stock,Ubicaciones virtuales / Produccion,/ Joya / Stock,07,Otros Suministros Diversos,114-0001-01,Unit(s),AGUA SAN LUIS X 20 LT,2018-12-26,2018-12-26,,Joya\OUT\09044,,,Joya\OUT\09044,LUZ ESTHER CHAÑI CUTIRE,0,1.000000,34.000000,28.2584051036682615629984051036842105,0,28.2584051036682615629984051036842105000000,960.7857735247208931419457735252631580000000,28.2584051036682615629984051036842105,"",252410 - Otros Suministros Diversos,23.05.01 SEGURIDAD Y MEDIO AMBIENTE,"",,,,,
Physical Locations / Joya / Stock,Ubicaciones virtuales / Produccion,/ Joya / Stock,07,Otros Suministros Diversos,114-0001-01,Unit(s),AGUA SAN LUIS X 20 LT,2018-12-26,2018-12-26,,Joya\OUT\09045,,,Joya\OUT\09045,LUZ ESTHER CHAÑI CUTIRE,0,1.000000,33.000000,28.2584051036682615629984051036842105,0,28.2584051036682615629984051036842105000000,932.5273684210526315789473684215789475000000,28.2584051036682615629984051036842105,"",252410 - Otros Suministros Diversos,20.02.05 ATENCION A MINERO REC MINERAL,"",,,,,
Physical Locations / Joya / Stock,Ubicaciones virtuales / Produccion,/ Joya / Stock,07,Otros Suministros Diversos,114-0001-01,Unit(s),AGUA SAN LUIS X 20 LT,2018-12-29,2018-12-29,,Joya\OUT\09065,,,Joya\OUT\09065,Harold Zambrano,0,3.000000,30.000000,28.2584051036682615629984051036842105,0,84.7752153110047846889952153110526315000000,847.7521531100478468899521531105263160000000,28.2584051036682615629984051036842105,"",252410 - Otros Suministros Diversos,20.03.03 CHANCADO,"",,,,,
Physical Locations / Joya / Stock,Ubicaciones virtuales / Produccion,/ Joya / Stock,07,Envases y Embalajes,119-0013-01,Unit(s),BOLSA DESGLOSABLE 6X12 (Und x 1kg),2018-12-07,2018-12-07,,Joya\OUT\08837,,,Joya\OUT\08837,VICTOR URIEL VILCA CENTI,0,4.000000,-4.000000,0,0,0.000000,0.000000,0,"",261101 - Envases,20.05.02 LABORATORIO QUIMICO,"",,,,2018-12-07,
Partner Locations / Suppliers,Physical Locations / Joya / Stock,/ Joya / Stock,03,Envases y Embalajes,119-0013-01,Unit(s),BOLSA DESGLOSABLE 6X12 (Und x 1kg),2018-12-08,2018-12-08,12/2018,Joya\IN\02885,01,F002,0001078,DISTRIBUCIONES SAN JUAN MASIAS S.A.C.,18.000000,0,14.000000,8.6000000000000000,154.8,0,154.800000,11.0571428571428571,604101 - Envases,261101 - Envases,,"",,18PO06356,LM-001573,2018-12-08,
Physical Locations / Joya / Stock,Ubicaciones virtuales / Produccion,/ Joya / Stock,07,Envases y Embalajes,119-0013-01,Unit(s),BOLSA DESGLOSABLE 6X12 (Und x 1kg),2018-12-21,2018-12-21,,Joya\OUT\08989,,,Joya\OUT\08989,VICTOR URIEL VILCA CENTI,0,3.000000,11.000000,11.0571428571428571,0,33.1714285714285713000000,121.6285714285714287000000,11.0571428571428571,"",261101 - Envases,20.05.02 LABORATORIO QUIMICO,"",,,,2018-12-21,
Physical Locations / Joya / Stock,Ubicaciones virtuales / Produccion,/ Joya / Stock,07,Envases y Embalajes,119-0013-01,Unit(s),BOLSA DESGLOSABLE 6X12 (Und x 1kg),2018-12-31,2018-12-31,,Joya\OUT\09097,,,Joya\OUT\09097,VICTOR URIEL VILCA CENTI,0,3.000000,8.000000,11.0571428571428571,0,33.1714285714285713000000,88.4571428571428574000000,11.0571428571428571,"",261101 - Envases,20.05.02 LABORATORIO QUIMICO,"",,,,2018-12-31,
Physical Locations / Joya / Stock,Ubicaciones virtuales / Produccion,/ Joya / Stock,07,Envases y Embalajes,119-0014-01,Unit(s),BOLSA DESGLOSABLE 8X12(Und X 1kg),2018-12-07,2018-12-07,,Joya\OUT\08837,,,Joya\OUT\08837,VICTOR URIEL VILCA CENTI,0,4.000000,-4.000000,0,0,0.000000,0.000000,0,"",261101 - Envases,20.05.02 LABORATORIO QUIMICO,"",,,,2018-12-07,
Partner Locations / Suppliers,Physical Locations / Joya / Stock,/ Joya / Stock,03,Envases y Embalajes,119-0014-01,Unit(s),BOLSA DESGLOSABLE 8X12(Und X 1kg),2018-12-08,2018-12-08,12/2018,Joya\IN\02885,01,F002,0001078,DISTRIBUCIONES SAN JUAN MASIAS S.A.C.,18.000000,0,14.000000,8.6000000000000000,154.8,0,154.800000,11.0571428571428571,604101 - Envases,261101 - Envases,,"",,18PO06356,LM-001573,2018-12-08,
Physical Locations / Joya / Stock,Ubicaciones virtuales / Produccion,/ Joya / Stock,07,Envases y Embalajes,119-0014-01,Unit(s),BOLSA DESGLOSABLE 8X12(Und X 1kg),2018-12-19,2018-12-19,,Joya\OUT\08958,,,Joya\OUT\08958,Harold Zambrano,0,2.000000,12.000000,11.0571428571428571,0,22.1142857142857142000000,132.6857142857142858000000,11.0571428571428571,"",261101 - Envases,22.01.03 DESORCIÓN,"",,,,,
Physical Locations / Joya / Stock,Ubicaciones virtuales / Produccion,/ Joya / Stock,07,Envases y Embalajes,119-0014-01,Unit(s),BOLSA DESGLOSABLE 8X12(Und X 1kg),2018-12-21,2018-12-21,,Joya\OUT\08989,,,Joya\OUT\08989,VICTOR URIEL VILCA CENTI,0,3.000000,9.000000,11.0571428571428571,0,33.1714285714285713000000,99.5142857142857145000000,11.0571428571428571,"",261101 - Envases,20.05.02 LABORATORIO QUIMICO,"",,,,2018-12-21,
Physical Locations / Joya / Stock,Ubicaciones virtuales / Produccion,/ Joya / Stock,07,Envases y Embalajes,119-0014-01,Unit(s),BOLSA DESGLOSABLE 8X12(Und X 1kg),2018-12-30,2018-12-30,,Joya\OUT\09083,,,Joya\OUT\09083,JOSE SANTOS MATTA BORJAS,0,2.000000,7.000000,11.0571428571428571,0,22.1142857142857142000000,77.4000000000000003000000,11.0571428571428571,"",261101 - Envases,22.01.03 DESORCIÓN,"",,,,,
Physical Locations / Joya / Stock,Ubicaciones virtuales / Produccion,/ Joya / Stock,07,Envases y Embalajes,119-0014-01,Unit(s),BOLSA DESGLOSABLE 8X12(Und X 1kg),2018-12-31,2018-12-31,,Joya\OUT\09097,,,Joya\OUT\09097,VICTOR URIEL VILCA CENTI,0,3.000000,4.000000,11.0571428571428571,0,33.1714285714285713000000,44.2285714285714290000000,11.0571428571428571,"",261101 - Envases,20.05.02 LABORATORIO QUIMICO,"",,,,2018-12-31,
Physical Locations / Joya / Stock,Ubicaciones virtuales / Produccion,/ Joya / Stock,07,Materiales de Limpieza,119-0017-01,Rollo,PAPEL TOALLA,2018-12-05,2018-12-05,,Joya\OUT\08809,,,Joya\OUT\08809,HELBERT ERNESTO CALLE PAYEHUANCA,0,1.000000,-1.000000,0,0,0.000000,0.000000,0,"",252409 - Materiales de Limpieza,23.08.08 OTROS COSTOS INDIRECTOS,"",,,,2018-12-05,
Physical Locations / Joya / Stock,Ubicaciones virtuales / Produccion,/ Joya / Stock,07,Materiales de Limpieza,119-0017-01,Rollo,PAPEL TOALLA,2018-12-19,2018-12-19,,Joya\OUT\08959,,,Joya\OUT\08959,GAVINO FELICIANO (TRB) CALISAYA RODRIGUEZ,0,6.000000,-7.000000,0,0,0.000000,0.000000,0,"",252409 - Materiales de Limpieza,23.04.04 OTROS GASTOS INDIRECTOS PERSONAL,"",,,,2018-12-19,
Physical Locations / Joya / Stock,Ubicaciones virtuales / Produccion,/ Joya / Stock,07,Materiales de Limpieza,119-0017-01,Rollo,PAPEL TOALLA,2018-12-21,2018-12-21,,Joya\OUT\08993,,,Joya\OUT\08993,Harold Zambrano,0,2.000000,-9.000000,0,0,0.000000,0.000000,0,"",252409 - Materiales de Limpieza,40.10.04	DEPRECIACION AREA COMERCIAL,"",,,,,
Physical Locations / Joya / Stock,Ubicaciones virtuales / Produccion,/ Joya / Stock,07,Materiales de Limpieza,119-0018-01,Rollo,PAPEL HIGIENICO,2018-12-05,2018-12-05,,Joya\OUT\08809,,,Joya\OUT\08809,HELBERT ERNESTO CALLE PAYEHUANCA,0,2.000000,-2.000000,0,0,0.000000,0.000000,0,"",252409 - Materiales de Limpieza,23.08.08 OTROS COSTOS INDIRECTOS,"",,,,2018-12-05,
Physical Locations / Joya / Stock,Ubicaciones virtuales / Produccion,/ Joya / Stock,07,Materiales de Limpieza,119-0018-01,Rollo,PAPEL HIGIENICO,2018-12-19,2018-12-19,,Joya\OUT\08959,,,Joya\OUT\08959,GAVINO FELICIANO (TRB) CALISAYA RODRIGUEZ,0,10.000000,-12.000000,0,0,0.000000,0.000000,0,"",252409 - Materiales de Limpieza,23.04.04 OTROS GASTOS INDIRECTOS PERSONAL,"",,,,2018-12-19,
Physical Locations / Joya / Stock,Ubicaciones virtuales / Produccion,/ Joya / Stock,07,Envases y Embalajes,119-0020-01,Paquete,BOLSAS LJ X 100,2018-12-30,2018-12-30,,Joya\OUT\09085,,,Joya\OUT\09085,JOSE SANTOS MATTA BORJAS,0,10.000000,-10.000000,0,0,0.000000,0.000000,0,"",261101 - Envases,20.03.03 CHANCADO,"",,,,,
Physical Locations / Joya / Stock,Ubicaciones virtuales / Produccion,/ Joya / Stock,07,Herramientas e Instrumentos,112-0050-XX,Unit(s),CAJA DE HERRAMIENTA N 19,2018-12-04,2018-12-04,,Joya\OUT\08800,,,Joya\OUT\08800,CARLOS ABRAHAN HUAMAN MAMANI,0,6.000000,-6.000000,0,0,0.000000,0.000000,0,"",252405 - Herramientas e Instrumentos,22.01.03 DESORCIÓN,"",,,,2018-12-04,
Physical Locations / Joya / Stock,Ubicaciones virtuales / Produccion,/ Joya / Stock,07,Herramientas e Instrumentos,112-0050-XX,Unit(s),CAJA DE HERRAMIENTA N 19,2018-12-27,2018-12-27,,Joya\OUT\09054,,,Joya\OUT\09054,JOSE SANTOS MATTA BORJAS,0,4.000000,-10.000000,0,0,0.000000,0.000000,0,"",252405 - Herramientas e Instrumentos,22.01.03 DESORCIÓN,"",,,,,
Physical Locations / Joya / Stock,Ubicaciones virtuales / Produccion,/ Joya / Stock,07,Suministro Desgaste(Bolas de Aceros),104-0001-01,t,"BOLAS DE ACERO DE 1 1/2""",2018-12-07,2018-12-07,,Joya\OUT\08835,,,Joya\OUT\08835,JOSE SANTOS MATTA BORJAS,0,1.000000,-1.000000,0,0,0.000000,0.000000,0,"",253101 - Bolas de Acero,21.01.10 MOLINO 6' X 8' CHINO,"",,,,,
Physical Locations / Joya / Stock,Ubicaciones virtuales / Produccion,/ Joya / Stock,07,Suministro Desgaste(Bolas de Aceros),104-0002-01,t,"BOLAS DE ACERO DE 3""",2018-12-07,2018-12-07,,Joya\OUT\08835,,,Joya\OUT\08835,JOSE SANTOS MATTA BORJAS,0,1.000000,-1.000000,0,0,0.000000,0.000000,0,"",253101 - Bolas de Acero,21.01.09 MOLINO 6' X 8' DELTA,"",,,,,
Physical Locations / Joya / Stock,Ubicaciones virtuales / Produccion,/ Joya / Stock,07,Suministro Desgaste(Bolas de Aceros),104-0002-01,t,"BOLAS DE ACERO DE 3""",2018-12-16,2018-12-16,,Joya\OUT\08925,,,Joya\OUT\08925,Harold Zambrano,0,1.000000,-2.000000,0,0,0.000000,0.000000,0,"",253101 - Bolas de Acero,21.01.01 MOLIENDA,"",,,,,
Physical Locations / Joya / Stock,Ubicaciones virtuales / Produccion,/ Joya / Stock,07,Suministro Desgaste(Bolas de Aceros),104-0003-01,t,"BOLAS DE ACERO 2""",2018-12-07,2018-12-07,,Joya\OUT\08835,,,Joya\OUT\08835,JOSE SANTOS MATTA BORJAS,0,1.000000,-1.000000,0,0,0.000000,0.000000,0,"",253101 - Bolas de Acero,21.01.10 MOLINO 6' X 8' CHINO,"",,,,,
Physical Locations / Joya / Stock,Ubicaciones virtuales / Produccion,/ Joya / Stock,07,Suministro Desgaste(Bolas de Aceros),104-0004-01,t,"BOLAS DE ACERO 3.5""",2018-12-31,2018-12-31,,Joya\OUT\09094,,,Joya\OUT\09094,JOSE SANTOS MATTA BORJAS,0,1.000000,-1.000000,0,0,0.000000,0.000000,0,"",253101 - Bolas de Acero,21.01.09 MOLINO 6' X 8' DELTA,"",,,,,
Physical Locations / Joya / Stock,Ubicaciones virtuales / Produccion,/ Joya / Stock,07,Envases y Embalajes,120-0002-01,Unit(s),SACOS MINEROS GRUESOS (SACMIN),2018-12-01,2018-12-01,,Joya\OUT\08770,,,Joya\OUT\08770,ANGELA PACO ZEA,0,1000.000000,-1000.000000,0,0,0.000000,0.000000,0,"",261101 - Envases,40.01.02 ACOPIO UNTUCA,"",,,,,
Physical Locations / Joya / Stock,Ubicaciones virtuales / Produccion,/ Joya / Stock,07,Envases y Embalajes,120-0002-01,Unit(s),SACOS MINEROS GRUESOS (SACMIN),2018-12-03,2018-12-03,,Joya\OUT\08791,,,Joya\OUT\08791,ANGELA PACO ZEA,0,1500.000000,-2500.000000,0,0,0.000000,0.000000,0,"",261101 - Envases,40.02.09	ACOPIO VELILLE,"",,,,,
Physical Locations / Joya / Stock,Ubicaciones virtuales / Produccion,/ Joya / Stock,07,Envases y Embalajes,120-0002-01,Unit(s),SACOS MINEROS GRUESOS (SACMIN),2018-12-03,2018-12-03,,Joya\OUT\08792,,,Joya\OUT\08792,ANGELA PACO ZEA,0,1500.000000,-4000.000000,0,0,0.000000,0.000000,0,"",261101 - Envases,40.02.08	ACOPIO ALCCAVICTORIA,"",,,,,
Physical Locations / Joya / Stock,Ubicaciones virtuales / Produccion,/ Joya / Stock,07,Envases y Embalajes,120-0002-01,Unit(s),SACOS MINEROS GRUESOS (SACMIN),2018-12-03,2018-12-03,,Joya\OUT\08793,,,Joya\OUT\08793,ANGELA PACO ZEA,0,1000.000000,-5000.000000,0,0,0.000000,0.000000,0,"",261101 - Envases,40.02.03 ACOPIO CHUMBIVILCAS,"",,,,,
Partner Locations / Suppliers,Physical Locations / Joya / Stock,/ Joya / Stock,03,Envases y Embalajes,120-0002-01,Unit(s),SACOS MINEROS GRUESOS (SACMIN),2018-12-06,2018-12-06,12/2018,Joya\IN\02917,01,E001,0000001,INCAX SOCIEDAD COMERCIAL DE RESPONSABILIDAD LIMITADA - INCAX S.R.L.,10000.000000,0,5000.000000,1.11020000000000000000,11102,0,11102.000000,2.2204000000000000,604101 - Envases,261101 - Envases,,"",,18PO06436,LM-001470,,
Partner Locations / Suppliers,Physical Locations / Joya / Stock,/ Joya / Stock,03,Envases y Embalajes,120-0002-01,Unit(s),SACOS MINEROS GRUESOS (SACMIN),2018-12-07,2018-12-07,11/2018,Joya\IN\02806,01,0001,0000757,MAURA EVELYN SARAVIA  CHAVEZ,10000.000000,0,15000.000000,1.13559300000000000000,11355.93,0,22457.930000,1.4971953333333333,604101 - Envases,261101 - Envases,,"",,18PO05926,LM-001541,,
Physical Locations / Joya / Stock,Ubicaciones virtuales / Produccion,/ Joya / Stock,07,Envases y Embalajes,120-0002-01,Unit(s),SACOS MINEROS GRUESOS (SACMIN),2018-12-13,2018-12-13,,Joya\OUT\08907,,,Joya\OUT\08907,JOSE ARENAS ALVAREZ,0,1000.000000,14000.000000,1.4971953333333333,0,1497.1953333333333000000000,20960.7346666666667000000000,1.4971953333333333,"",261101 - Envases,40.07.01 ACOPIO ABANCAY,"",,,,,
Physical Locations / Joya / Stock,Ubicaciones virtuales / Produccion,/ Joya / Stock,07,Envases y Embalajes,120-0002-01,Unit(s),SACOS MINEROS GRUESOS (SACMIN),2018-12-13,2018-12-13,,Joya\OUT\08908,,,Joya\OUT\08908,JOSE ARENAS ALVAREZ,0,200.000000,13800.000000,1.4971953333333333,0,299.4390666666666600000000,20661.2956000000000400000000,1.4971953333333333,"",261101 - Envases,40.05.03 ACOPIO IMATA,"",,,,,
Physical Locations / Joya / Stock,Ubicaciones virtuales / Produccion,/ Joya / Stock,07,Envases y Embalajes,120-0002-01,Unit(s),SACOS MINEROS GRUESOS (SACMIN),2018-12-20,2018-12-20,,Joya\OUT\08976,,,Joya\OUT\08976,JOSE ARENAS ALVAREZ,0,500.000000,13300.000000,1.4971953333333333,0,748.5976666666666500000000,19912.6979333333333900000000,1.4971953333333333,"",261101 - Envases,40.05.03 ACOPIO IMATA,"",,,,,
Physical Locations / Joya / Stock,Ubicaciones virtuales / Produccion,/ Joya / Stock,07,Envases y Embalajes,120-0002-01,Unit(s),SACOS MINEROS GRUESOS (SACMIN),2018-12-20,2018-12-20,,Joya\OUT\08982,,,Joya\OUT\08982,JOSE ARENAS ALVAREZ,0,175.000000,13125.000000,1.4971953333333333,0,262.0091833333333275000000,19650.6887500000000625000000,1.4971953333333333,"",261101 - Envases,40.05.02 ACOPIO PEDREGAL,"",,,,,
Physical Locations / Joya / Stock,Ubicaciones virtuales / Produccion,/ Joya / Stock,07,Envases y Embalajes,120-0002-01,Unit(s),SACOS MINEROS GRUESOS (SACMIN),2018-12-21,2018-12-21,,Joya\OUT\08996,,,Joya\OUT\08996,JOSE ARENAS ALVAREZ,0,1000.000000,12125.000000,1.4971953333333333,0,1497.1953333333333000000000,18153.4934166666667625000000,1.4971953333333333,"",261101 - Envases,40.04.02 ACOPIO ARIRAHUA,"",,,,,
Physical Locations / Joya / Stock,Ubicaciones virtuales / Produccion,/ Joya / Stock,07,Envases y Embalajes,120-0002-01,Unit(s),SACOS MINEROS GRUESOS (SACMIN),2018-12-24,2018-12-24,,Joya\OUT\09030,,,Joya\OUT\09030,JOSE ARENAS ALVAREZ,0,500.000000,11625.000000,1.4971953333333333,0,748.5976666666666500000000,17404.8957500000001125000000,1.4971953333333333,"",261101 - Envases,40.05.03 ACOPIO IMATA,"",,,,,
Physical Locations / Joya / Stock,Ubicaciones virtuales / Produccion,/ Joya / Stock,07,Envases y Embalajes,120-0002-01,Unit(s),SACOS MINEROS GRUESOS (SACMIN),2018-12-26,2018-12-26,,Joya\OUT\09050,,,Joya\OUT\09050,JOSE ARENAS ALVAREZ,0,1000.000000,10625.000000,1.4971953333333333,0,1497.1953333333333000000000,15907.7004166666668125000000,1.4971953333333333,"",261101 - Envases,40.01.04 ACOPIO OLLACHEA,"",,,,,
Physical Locations / Joya / Stock,Ubicaciones virtuales / Produccion,/ Joya / Stock,07,Envases y Embalajes,120-0002-01,Unit(s),SACOS MINEROS GRUESOS (SACMIN),2018-12-31,2018-12-31,,Joya\OUT\09088,,,Joya\OUT\09088,JOSE ARENAS ALVAREZ,0,1000.000000,9625.000000,1.4971953333333333,0,1497.1953333333333000000000,14410.5050833333335125000000,1.4971953333333333,"",261101 - Envases,40.02.09	ACOPIO VELILLE,"",,,,,
Physical Locations / Joya / Stock,Ubicaciones virtuales / Produccion,/ Joya / Stock,07,Reactivo Soda,102-0002-01,t,Soda Caustica,2018-12-02,2018-12-02,,Joya\OUT\08779,,,Joya\OUT\08779,CARLOS ABRAHAN HUAMAN MAMANI,0,0.250000,-0.250000,0,0,0.000000,0.000000,0,"",251102 - Soda Caustica,22.01.03 DESORCIÓN,"",,,,2018-12-02,
Physical Locations / Joya / Stock,Ubicaciones virtuales / Produccion,/ Joya / Stock,07,Reactivo Soda,102-0002-01,t,Soda Caustica,2018-12-02,2018-12-02,,Joya\OUT\08780,,,Joya\OUT\08780,ERNESTO ALVAREZ OSORIO,0,0.400000,-0.650000,0,0,0.000000,0.000000,0,"",251102 - Soda Caustica,21.02.01 LIXIVIACIÓN Y ABSORCION,"",,,,,
Physical Locations / Joya / Stock,Ubicaciones virtuales / Produccion,/ Joya / Stock,07,Reactivo Soda,102-0002-01,t,Soda Caustica,2018-12-03,2018-12-03,,Joya\OUT\08784,,,Joya\OUT\08784,HAROL ZAMBRANO RAMOS,0,0.400000,-1.050000,0,0,0.000000,0.000000,0,"",251102 - Soda Caustica,21.02.01 LIXIVIACIÓN Y ABSORCION,"",,,,,
Physical Locations / Joya / Stock,Ubicaciones virtuales / Produccion,/ Joya / Stock,07,Reactivo Soda,102-0002-01,t,Soda Caustica,2018-12-04,2018-12-04,,Joya\OUT\08798,,,Joya\OUT\08798,ERNESTO ALVAREZ OSORIO,0,0.400000,-1.450000,0,0,0.000000,0.000000,0,"",251102 - Soda Caustica,"21.02.18 BOMBA DE PULPA VERTICAL 1.1/2""X24""  LIXIVIACION","",,,,,
Physical Locations / Joya / Stock,Ubicaciones virtuales / Produccion,/ Joya / Stock,07,Reactivo Soda,102-0002-01,t,Soda Caustica,2018-12-06,2018-12-06,,Joya\OUT\08822,,,Joya\OUT\08822,JOSE SANTOS MATTA BORJAS,0,0.400000,-1.850000,0,0,0.000000,0.000000,0,"",251102 - Soda Caustica,21.02.03 TANQUE AGITADOR #1 (22'x22'),"",,,,,
Physical Locations / Joya / Stock,Ubicaciones virtuales / Produccion,/ Joya / Stock,07,Reactivo Soda,102-0002-01,t,Soda Caustica,2018-12-07,2018-12-07,,Joya\OUT\08829,,,Joya\OUT\08829,JOSE SANTOS MATTA BORJAS,0,0.250000,-2.100000,0,0,0.000000,0.000000,0,"",251102 - Soda Caustica,22.01.03 DESORCIÓN,"",,,,,
Physical Locations / Joya / Stock,Ubicaciones virtuales / Produccion,/ Joya / Stock,07,Reactivo Soda,102-0002-01,t,Soda Caustica,2018-12-07,2018-12-07,,Joya\OUT\08833,,,Joya\OUT\08833,JOSE SANTOS MATTA BORJAS,0,0.400000,-2.500000,0,0,0.000000,0.000000,0,"",251102 - Soda Caustica,21.02.03 TANQUE AGITADOR #1 (22'x22'),"",,,,,
Physical Locations / Joya / Stock,Ubicaciones virtuales / Produccion,/ Joya / Stock,07,Reactivo Soda,102-0002-01,t,Soda Caustica,2018-12-08,2018-12-08,,Joya\OUT\08845,,,Joya\OUT\08845,JOSE SANTOS MATTA BORJAS,0,0.300000,-2.800000,0,0,0.000000,0.000000,0,"",251102 - Soda Caustica,21.02.03 TANQUE AGITADOR #1 (22'x22'),"",,,,,
Physical Locations / Joya / Stock,Ubicaciones virtuales / Produccion,/ Joya / Stock,07,Reactivo Soda,102-0002-01,t,Soda Caustica,2018-12-09,2018-12-09,,Joya\OUT\08848,,,Joya\OUT\08848,JOSE SANTOS MATTA BORJAS,0,0.300000,-3.100000,0,0,0.000000,0.000000,0,"",251102 - Soda Caustica,21.02.03 TANQUE AGITADOR #1 (22'x22'),"",,,,,
Physical Locations / Joya / Stock,Ubicaciones virtuales / Produccion,/ Joya / Stock,07,Reactivo Soda,102-0002-01,t,Soda Caustica,2018-12-10,2018-12-10,,Joya\OUT\08861,,,Joya\OUT\08861,JOSE SANTOS MATTA BORJAS,0,0.450000,-3.550000,0,0,0.000000,0.000000,0,"",251102 - Soda Caustica,21.02.03 TANQUE AGITADOR #1 (22'x22'),"",,,,,
Physical Locations / Joya / Stock,Ubicaciones virtuales / Produccion,/ Joya / Stock,07,Reactivo Soda,102-0002-01,t,Soda Caustica,2018-12-11,2018-12-11,,Joya\OUT\08863,,,Joya\OUT\08863,JOSE SANTOS MATTA BORJAS,0,0.200000,-3.750000,0,0,0.000000,0.000000,0,"",251102 - Soda Caustica,21.02.03 TANQUE AGITADOR #1 (22'x22'),"",,,,,
Physical Locations / Joya / Stock,Ubicaciones virtuales / Produccion,/ Joya / Stock,07,Reactivo Soda,102-0002-01,t,Soda Caustica,2018-12-13,2018-12-13,,Joya\OUT\08906,,,Joya\OUT\08906,Harold Zambrano,0,0.250000,-4.000000,0,0,0.000000,0.000000,0,"",251102 - Soda Caustica,22.01.03 DESORCIÓN,"",,,,,
Physical Locations / Joya / Stock,Ubicaciones virtuales / Produccion,/ Joya / Stock,07,Reactivo Soda,102-0002-01,t,Soda Caustica,2018-12-15,2018-12-15,,Joya\OUT\08938,,,Joya\OUT\08938,Harold Zambrano,0,0.400000,-4.400000,0,0,0.000000,0.000000,0,"",251102 - Soda Caustica,21.02.01 LIXIVIACIÓN Y ABSORCION,"",,,,2018-12-15,
Physical Locations / Joya / Stock,Ubicaciones virtuales / Produccion,/ Joya / Stock,07,Reactivo Soda,102-0002-01,t,Soda Caustica,2018-12-16,2018-12-16,,Joya\OUT\08926,,,Joya\OUT\08926,Harold Zambrano,0,0.600000,-5.000000,0,0,0.000000,0.000000,0,"",251102 - Soda Caustica,21.02.01 LIXIVIACIÓN Y ABSORCION,"",,,,,
Partner Locations / Suppliers,Physical Locations / Joya / Stock,/ Joya / Stock,03,Reactivo Soda,102-0002-01,t,Soda Caustica,2018-12-17,2018-12-17,12/2018,Joya\IN\02908,01,F015,0005465,QUIMICOS GOICOCHEA S.A.C.,4.000000,0,-1.000000,2818.2,11272.8,0,11272.800000,0,603102 - Soda Caustica,251102 - Soda Caustica,,"",,18PO06609,LM-001630,2018-12-17,
Physical Locations / Joya / Stock,Ubicaciones virtuales / Produccion,/ Joya / Stock,07,Reactivo Soda,102-0002-01,t,Soda Caustica,2018-12-17,2018-12-17,,Joya\OUT\08937,,,Joya\OUT\08937,Harold Zambrano,0,0.300000,-1.300000,0,0,0.000000,11272.800000,0,"",251102 - Soda Caustica,21.02.01 LIXIVIACIÓN Y ABSORCION,"",,,,,
Physical Locations / Joya / Stock,Ubicaciones virtuales / Produccion,/ Joya / Stock,07,Reactivo Soda,102-0002-01,t,Soda Caustica,2018-12-18,2018-12-18,,Joya\OUT\08946,,,Joya\OUT\08946,Harold Zambrano,0,0.400000,-1.700000,0,0,0.000000,11272.800000,0,"",251102 - Soda Caustica,21.02.01 LIXIVIACIÓN Y ABSORCION,"",,,,,
Partner Locations / Suppliers,Physical Locations / Joya / Stock,/ Joya / Stock,03,Reactivo Soda,102-0002-01,t,Soda Caustica,2018-12-19,2018-12-19,12/2018,Joya\IN\02924,01,F015,0005485,QUIMICOS GOICOCHEA S.A.C.,4.000000,0,2.300000,2810.6400000000000000,11242.56,0,22515.360000,9789.2869565217391304,603102 - Soda Caustica,251102 - Soda Caustica,,"",,18PO06664,LM-001630,,
Partner Locations / Suppliers,Physical Locations / Joya / Stock,/ Joya / Stock,03,Reactivo Soda,102-0002-01,t,Soda Caustica,2018-12-19,2018-12-19,12/2018,Joya\IN\02923,01,F015,0005527,QUIMICOS GOICOCHEA S.A.C.,4.000000,0,6.300000,2829.9600000000000000,11319.84,0,33835.200000,5370.6666666666666667,603102 - Soda Caustica,251102 - Soda Caustica,,"",,18PO06665,LM-001630,,
Physical Locations / Joya / Stock,Ubicaciones virtuales / Produccion,/ Joya / Stock,07,Reactivo Soda,102-0002-01,t,Soda Caustica,2018-12-19,2018-12-19,,Joya\OUT\08956,,,Joya\OUT\08956,JOSE SANTOS MATTA BORJAS,0,0.500000,5.800000,5370.6666666666666667,0,2685.3333333333333333500000,31149.8666666666666666500000,5370.6666666666666667,"",251102 - Soda Caustica,21.02.03 TANQUE AGITADOR #1 (22'x22'),"",,,,,
Physical Locations / Joya / Stock,Ubicaciones virtuales / Produccion,/ Joya / Stock,07,Reactivo Soda,102-0002-01,t,Soda Caustica,2018-12-20,2018-12-20,,Joya\OUT\08994,,,Joya\OUT\08994,ERNESTO ALVAREZ OSORIO,0,0.400000,5.400000,5370.6666666666666667,0,2148.2666666666666666800000,29001.5999999999999999700000,5370.6666666666666667,"",251102 - Soda Caustica,21.02.01 LIXIVIACIÓN Y ABSORCION,"",,,,,
Physical Locations / Joya / Stock,Ubicaciones virtuales / Produccion,/ Joya / Stock,07,Reactivo Soda,102-0002-01,t,Soda Caustica,2018-12-21,2018-12-21,,Joya\OUT\08986,,,Joya\OUT\08986,ERNESTO ALVAREZ OSORIO,0,0.400000,5.000000,5370.6666666666666667,0,2148.2666666666666666800000,26853.3333333333333332900000,5370.6666666666666667,"",251102 - Soda Caustica,21.02.01 LIXIVIACIÓN Y ABSORCION,"",,,,,
Physical Locations / Joya / Stock,Ubicaciones virtuales / Produccion,/ Joya / Stock,07,Reactivo Soda,102-0002-01,t,Soda Caustica,2018-12-22,2018-12-22,,Joya\OUT\09009,,,Joya\OUT\09009,ERNESTO ALVAREZ OSORIO,0,0.400000,4.600000,5370.6666666666666667,0,2148.2666666666666666800000,24705.0666666666666666100000,5370.6666666666666667,"",251102 - Soda Caustica,"21.02.18 BOMBA DE PULPA VERTICAL 1.1/2""X24""  LIXIVIACION","",,,,,
Physical Locations / Joya / Stock,Ubicaciones virtuales / Produccion,/ Joya / Stock,07,Reactivo Soda,102-0002-01,t,Soda Caustica,2018-12-22,2018-12-22,,Joya\OUT\09011,,,Joya\OUT\09011,JOSE SANTOS MATTA BORJAS,0,0.250000,4.350000,5370.6666666666666667,0,1342.6666666666666666750000,23362.3999999999999999350000,5370.6666666666666667,"",251102 - Soda Caustica,22.01.03 DESORCIÓN,"",,,,,
Physical Locations / Joya / Stock,Ubicaciones virtuales / Produccion,/ Joya / Stock,07,Reactivo Soda,102-0002-01,t,Soda Caustica,2018-12-23,2018-12-23,,Joya\OUT\09019,,,Joya\OUT\09019,LUIS FELIPE CARCAMO PALACO,0,0.400000,3.950000,5370.6666666666666667,0,2148.2666666666666666800000,21214.1333333333333332550000,5370.6666666666666667,"",251102 - Soda Caustica,21.02.01 LIXIVIACIÓN Y ABSORCION,"",,,,,
Physical Locations / Joya / Stock,Ubicaciones virtuales / Produccion,/ Joya / Stock,07,Reactivo Soda,102-0002-01,t,Soda Caustica,2018-12-24,2018-12-24,,Joya\OUT\09032,,,Joya\OUT\09032,LUIS FELIPE CARCAMO PALACO,0,0.400000,3.550000,5370.6666666666666667,0,2148.2666666666666666800000,19065.8666666666666665750000,5370.6666666666666667,"",251102 - Soda Caustica,21.02.01 LIXIVIACIÓN Y ABSORCION,"",,,,2018-12-24,
Physical Locations / Joya / Stock,Ubicaciones virtuales / Produccion,/ Joya / Stock,07,Reactivo Soda,102-0002-01,t,Soda Caustica,2018-12-25,2018-12-25,,Joya\OUT\09035,,,Joya\OUT\09035,LUIS FELIPE CARCAMO PALACO,0,0.600000,2.950000,5370.6666666666666667,0,3222.4000000000000000200000,15843.4666666666666665550000,5370.6666666666666667,"",251102 - Soda Caustica,21.02.01 LIXIVIACIÓN Y ABSORCION,"",,,,,
Physical Locations / Joya / Stock,Ubicaciones virtuales / Produccion,/ Joya / Stock,07,Reactivo Soda,102-0002-01,t,Soda Caustica,2018-12-26,2018-12-26,,Joya\OUT\09046,,,Joya\OUT\09046,JOSE SANTOS MATTA BORJAS,0,0.500000,2.450000,5370.6666666666666667,0,2685.3333333333333333500000,13158.1333333333333332050000,5370.6666666666666667,"",251102 - Soda Caustica,21.02.03 TANQUE AGITADOR #1 (22'x22'),"",,,,,
Physical Locations / Joya / Stock,Ubicaciones virtuales / Produccion,/ Joya / Stock,07,Reactivo Soda,102-0002-01,t,Soda Caustica,2018-12-27,2018-12-27,,Joya\OUT\09054,,,Joya\OUT\09054,JOSE SANTOS MATTA BORJAS,0,0.250000,2.200000,5370.6666666666666667,0,1342.6666666666666666750000,11815.4666666666666665300000,5370.6666666666666667,"",251102 - Soda Caustica,22.01.03 DESORCIÓN,"",,,,,
Physical Locations / Joya / Stock,Ubicaciones virtuales / Produccion,/ Joya / Stock,07,Reactivo Soda,102-0002-01,t,Soda Caustica,2018-12-27,2018-12-27,,Joya\OUT\09055,,,Joya\OUT\09055,JOSE SANTOS MATTA BORJAS,0,0.500000,1.700000,5370.6666666666666667,0,2685.3333333333333333500000,9130.1333333333333331800000,5370.6666666666666667,"",251102 - Soda Caustica,21.02.03 TANQUE AGITADOR #1 (22'x22'),"",,,,,
Physical Locations / Joya / Stock,Ubicaciones virtuales / Produccion,/ Joya / Stock,07,Reactivo Soda,102-0002-01,t,Soda Caustica,2018-12-28,2018-12-28,,Joya\OUT\09058,,,Joya\OUT\09058,JOSE SANTOS MATTA BORJAS,0,0.400000,1.300000,5370.6666666666666667,0,2148.2666666666666666800000,6981.8666666666666665000000,5370.6666666666666667,"",251102 - Soda Caustica,21.02.03 TANQUE AGITADOR #1 (22'x22'),"",,,,,
Physical Locations / Joya / Stock,Ubicaciones virtuales / Produccion,/ Joya / Stock,07,Reactivo Soda,102-0002-01,t,Soda Caustica,2018-12-29,2018-12-29,,Joya\OUT\09070,,,Joya\OUT\09070,JOSE SANTOS MATTA BORJAS,0,0.400000,0.900000,5370.6666666666666667,0,2148.2666666666666666800000,4833.5999999999999998200000,5370.6666666666666667,"",251102 - Soda Caustica,21.02.01 LIXIVIACIÓN Y ABSORCION,"",,,,2018-12-29,
Physical Locations / Joya / Stock,Ubicaciones virtuales / Produccion,/ Joya / Stock,07,Reactivo Soda,102-0002-01,t,Soda Caustica,2018-12-30,2018-12-30,,Joya\OUT\09085,,,Joya\OUT\09085,JOSE SANTOS MATTA BORJAS,0,0.400000,0.500000,5370.6666666666666667,0,2148.2666666666666666800000,2685.3333333333333331400000,5370.6666666666666667,"",251102 - Soda Caustica,21.02.03 TANQUE AGITADOR #1 (22'x22'),"",,,,,
Physical Locations / Joya / Stock,Ubicaciones virtuales / Produccion,/ Joya / Stock,07,Reactivo Soda,102-0002-01,t,Soda Caustica,2018-12-31,2018-12-31,,Joya\OUT\09094,,,Joya\OUT\09094,JOSE SANTOS MATTA BORJAS,0,0.400000,0.100000,5370.6666666666666667,0,2148.2666666666666666800000,537.0666666666666664600000,5370.6666666666666667,"",251102 - Soda Caustica,21.02.03 TANQUE AGITADOR #1 (22'x22'),"",,,,,
Partner Locations / Suppliers,Physical Locations / Joya / Stock,/ Joya / Stock,03,Repuestos de Maquinaria y Equipo,118-0133-XX,Unit(s),"FORRO DE BOMBA 3"" GLAND",2018-12-03,2018-12-03,11/2018,Joya\IN\02845,01,E001,0000376, INDUSTRIAL CARRERA INGENIEROS S.R.L.,3.000000,0,3.000000,439.4000000000000000,1318.2,0,1318.2,439.4000000000000000,603302 - Repuesto de Maq y Equipo,253102 - Repuestos Maquinaria y Eq,,"",,18PO06151,LM-001554,2018-12-03,
Physical Locations / Joya / Stock,Ubicaciones virtuales / Produccion,/ Joya / Stock,07,Repuestos de Maquinaria y Equipo,118-0134-XX,Unit(s),"FORRO DE BOMBA 3"" SUCCION",2018-12-02,2018-12-02,,Joya\OUT\08751,,,Joya\OUT\08751,ALEX ROGELIO (TRB) MEDINA ZABALAGA,0,1.000000,-1.000000,0,0,0.000000,0.000000,0,"",253102 - Repuestos Maquinaria y Eq,"21.01.13 BOMBA DE PULPA 3"" X 3"" MOLIENDA (4 UND)","",,,,2018-12-02,
Physical Locations / Joya / Stock,Ubicaciones virtuales / Produccion,/ Joya / Stock,07,Otros Suministros Diversos,107-0152-XX,kg,"SOLDADURA CELLOCORD AP 3,25 X 350 1/8""",2018-12-08,2018-12-08,,Joya\OUT\08844,,,Joya\OUT\08844,EDISON (TRB) RAMOS HACHIRI,0,5.000000,-5.000000,0,0,0.000000,0.000000,0,"",252410 - Otros Suministros Diversos,21.02.03 TANQUE AGITADOR #1 (22'x22'),"",,,,2018-12-08,
Physical Locations / Joya / Stock,Ubicaciones virtuales / Produccion,/ Joya / Stock,07,Otros Suministros Diversos,107-0152-XX,kg,"SOLDADURA CELLOCORD AP 3,25 X 350 1/8""",2018-12-14,2018-12-14,,Joya\OUT\08917,,,Joya\OUT\08917,ALEX ROGELIO (TRB) MEDINA ZABALAGA,0,5.000000,-10.000000,0,0,0.000000,0.000000,0,"",252410 - Otros Suministros Diversos,25.01.03 TALLER DE MANTENIMIENTO,"",,,,2018-12-14,
Physical Locations / Joya / Stock,Ubicaciones virtuales / Produccion,/ Joya / Stock,07,Otros Suministros Diversos,107-0152-XX,kg,"SOLDADURA CELLOCORD AP 3,25 X 350 1/8""",2018-12-17,2018-12-17,,Joya\OUT\08933,,,Joya\OUT\08933,ALEX ROGELIO (TRB) MEDINA ZABALAGA,0,5.000000,-15.000000,0,0,0.000000,0.000000,0,"",252410 - Otros Suministros Diversos,21.02.03 TANQUE AGITADOR #1 (22'x22'),"",,,,2018-12-17,
Physical Locations / Joya / Stock,Ubicaciones virtuales / Produccion,/ Joya / Stock,07,Materiales de Limpieza,117-0022-01,kg,TRAPO INDUSTRIAL,2018-12-18,2018-12-18,,Joya\OUT\08945,,,Joya\OUT\08945,ALEX ROGELIO (TRB) MEDINA ZABALAGA,0,4.000000,-4.000000,0,0,0.000000,0.000000,0,"",252409 - Materiales de Limpieza,21.01.01 MOLIENDA,"",,,,2018-12-18,
Partner Locations / Suppliers,Physical Locations / Joya / Stock,/ Joya / Stock,03,Envases y Embalajes,120-0004-01,Paquete,BOLSA DESGLOSABLES 10X15 ROLLO x 1 Kg,2018-12-08,2018-12-08,12/2018,Joya\IN\02885,01,F002,0001078,DISTRIBUCIONES SAN JUAN MASIAS S.A.C.,6.000000,0,6.000000,8.6000000000000000,51.6,0,51.6,8.6000000000000000,604101 - Envases,261101 - Envases,,"",,18PO06356,LM-001573,2018-12-08,
Partner Locations / Suppliers,Physical Locations / Joya / Stock,/ Joya / Stock,03,Combustible,105-0005-01,Unit(s),GAS PROPANO BALON GRANDE X 45 KG. (100 LB.),2018-12-01,2018-12-01,12/2018,Joya\IN\02897,01,0001,0003094,GRUPO S & G MANRIQUE REPRESENTACIONES E.I.R.L.,8.000000,0,8.000000,127.1187500000000000,1016.95,0,1016.95,127.1187500000000000,603221 - Combustibles,252101 - Combustibles,,"",,18PO06525,LM-001570,2018-12-01,
Partner Locations / Suppliers,Physical Locations / Joya / Stock,/ Joya / Stock,03,Combustible,105-0005-01,Unit(s),GAS PROPANO BALON GRANDE X 45 KG. (100 LB.),2018-12-01,2018-12-01,12/2018,Joya\IN\02920,01,0001,0003104,GRUPO S & G MANRIQUE REPRESENTACIONES E.I.R.L.,7.000000,0,15.000000,127.1185714285714286,889.83,0,1906.78,127.1186666666666667,603221 - Combustibles,252101 - Combustibles,,"",,18PO06768,LM-001636,2018-12-01,
Partner Locations / Suppliers,Physical Locations / Joya / Stock,/ Joya / Stock,03,Combustible,105-0005-01,Unit(s),GAS PROPANO BALON GRANDE X 45 KG. (100 LB.),2018-12-01,2018-12-01,12/2018,Joya\IN\02921,01,0001,0003107,GRUPO S & G MANRIQUE REPRESENTACIONES E.I.R.L.,9.000000,0,24.000000,127.1188888888888889,1144.07,0,3050.85,127.1187500000000000,603221 - Combustibles,252101 - Combustibles,,"",,18PO06769,,2018-12-01,
Partner Locations / Suppliers,Physical Locations / Joya / Stock,/ Joya / Stock,03,Combustible,105-0005-01,Unit(s),GAS PROPANO BALON GRANDE X 45 KG. (100 LB.),2018-12-04,2018-12-04,11/2018,Joya\IN\02890,01,0001,0003074,GRUPO S & G MANRIQUE REPRESENTACIONES E.I.R.L.,7.000000,0,31.000000,127.1185714285714286,889.83,0,3940.68,127.1187096774193548,603221 - Combustibles,252101 - Combustibles,,"",,18PO06425,LM-001578,2018-12-04,
Physical Locations / Joya / Stock,Ubicaciones virtuales / Produccion,/ Joya / Stock,07,Combustible,105-0005-01,Unit(s),GAS PROPANO BALON GRANDE X 45 KG. (100 LB.),2018-12-04,2018-12-04,,Joya\OUT\08800,,,Joya\OUT\08800,CARLOS ABRAHAN HUAMAN MAMANI,0,4.000000,27.000000,127.1187096774193548,0,508.4748387096774192000000,3432.2051612903225808000000,127.1187096774193548,"",252101 - Combustibles,22.01.25 HORNO DE FUNDICION 100 KG - Nº2,"",,,,2018-12-04,
Physical Locations / Joya / Stock,Ubicaciones virtuales / Produccion,/ Joya / Stock,07,Combustible,105-0005-01,Unit(s),GAS PROPANO BALON GRANDE X 45 KG. (100 LB.),2018-12-04,2018-12-04,,Joya\OUT\08800,,,Joya\OUT\08800,CARLOS ABRAHAN HUAMAN MAMANI,0,4.000000,23.000000,127.1187096774193548,0,508.4748387096774192000000,2923.7303225806451616000000,127.1187096774193548,"",252101 - Combustibles,22.01.03 DESORCIÓN,"",,,,2018-12-04,
Partner Locations / Suppliers,Physical Locations / Joya / Stock,/ Joya / Stock,03,Combustible,105-0005-01,Unit(s),GAS PROPANO BALON GRANDE X 45 KG. (100 LB.),2018-12-10,2018-12-10,12/2018,Joya\IN\02896,01,0001,0003096,GRUPO S & G MANRIQUE REPRESENTACIONES E.I.R.L.,7.000000,0,30.000000,127.1185714285714286,889.83,0,3813.5603225806451616000000,127.1186774193548387200000,603221 - Combustibles,252101 - Combustibles,,"",,18PO06526,LM-001570,2018-12-10,
Physical Locations / Joya / Stock,Ubicaciones virtuales / Produccion,/ Joya / Stock,07,Combustible,105-0005-01,Unit(s),GAS PROPANO BALON GRANDE X 45 KG. (100 LB.),2018-12-10,2018-12-10,,Joya\OUT\08857,,,Joya\OUT\08857,JOSE SANTOS MATTA BORJAS,0,10.000000,20.000000,127.1186774193548387200000,0,1271.1867741935483872000000000000,2542.3735483870967744000000000000,127.1186774193548387200000,"",252101 - Combustibles,22.01.03 DESORCIÓN,"",,,,,
Physical Locations / Joya / Stock,Ubicaciones virtuales / Produccion,/ Joya / Stock,07,Combustible,105-0005-01,Unit(s),GAS PROPANO BALON GRANDE X 45 KG. (100 LB.),2018-12-19,2018-12-19,,Joya\OUT\08958,,,Joya\OUT\08958,Harold Zambrano,0,17.000000,3.000000,127.1186774193548387200000,0,2161.0175161290322582400000000000,381.3560322580645161600000000000,127.1186774193548387200000,"",252101 - Combustibles,22.01.03 DESORCIÓN,"",,,,,
Partner Locations / Suppliers,Physical Locations / Joya / Stock,/ Joya / Stock,03,Combustible,105-0005-01,Unit(s),GAS PROPANO BALON GRANDE X 45 KG. (100 LB.),2018-12-27,2018-12-27,12/2018,Joya\IN\02925,01,0001,0003113,GRUPO S & G MANRIQUE REPRESENTACIONES E.I.R.L.,7.000000,0,10.000000,127.1185714285714286,889.83,0,1271.1860322580645161600000000000,127.1186032258064516160000000000,603221 - Combustibles,252101 - Combustibles,,"",,18PO06935,LM-001664,2018-12-27,
Partner Locations / Suppliers,Physical Locations / Joya / Stock,/ Joya / Stock,03,Combustible,105-0005-01,Unit(s),GAS PROPANO BALON GRANDE X 45 KG. (100 LB.),2018-12-30,2018-12-30,12/2018,Joya\IN\02943,01,0001,0003134,GRUPO S & G MANRIQUE REPRESENTACIONES E.I.R.L.,6.000000,0,16.000000,127.1183333333333333,762.71,0,2033.8960322580645161600000000000,127.1185020161290322600000000000,603221 - Combustibles,252101 - Combustibles,,"",,18PO06970,LM-001668,2018-12-30,
Partner Locations / Suppliers,Physical Locations / Joya / Stock,/ Joya / Stock,03,Combustible,105-0004-01,Unit(s),GAS PROPANO BALON CHICO X 10 KG.,2018-12-01,2018-12-01,12/2018,Joya\IN\02897,01,0001,0003094,GRUPO S & G MANRIQUE REPRESENTACIONES E.I.R.L.,6.000000,0,6.000000,29.6616666666666667,177.97,0,177.97,29.6616666666666667,603221 - Combustibles,252101 - Combustibles,,"",,18PO06525,LM-001570,2018-12-01,
Partner Locations / Suppliers,Physical Locations / Joya / Stock,/ Joya / Stock,03,Combustible,105-0004-01,Unit(s),GAS PROPANO BALON CHICO X 10 KG.,2018-12-01,2018-12-01,12/2018,Joya\IN\02920,01,0001,0003104,GRUPO S & G MANRIQUE REPRESENTACIONES E.I.R.L.,6.000000,0,12.000000,29.6616666666666667,177.97,0,355.94,29.6616666666666667,603221 - Combustibles,252101 - Combustibles,,"",,18PO06768,LM-001636,2018-12-01,
Partner Locations / Suppliers,Physical Locations / Joya / Stock,/ Joya / Stock,03,Combustible,105-0004-01,Unit(s),GAS PROPANO BALON CHICO X 10 KG.,2018-12-01,2018-12-01,12/2018,Joya\IN\02921,01,0001,0003107,GRUPO S & G MANRIQUE REPRESENTACIONES E.I.R.L.,4.000000,0,16.000000,29.6600000000000000,118.64,0,474.58,29.6612500000000000,603221 - Combustibles,252101 - Combustibles,,"",,18PO06769,,2018-12-01,
Partner Locations / Suppliers,Physical Locations / Joya / Stock,/ Joya / Stock,03,Combustible,105-0004-01,Unit(s),GAS PROPANO BALON CHICO X 10 KG.,2018-12-04,2018-12-04,11/2018,Joya\IN\02890,01,0001,0003074,GRUPO S & G MANRIQUE REPRESENTACIONES E.I.R.L.,2.000000,0,18.000000,29.6600000000000000,59.32,0,533.90,29.6611111111111111,603221 - Combustibles,252101 - Combustibles,,"",,18PO06425,LM-001578,2018-12-04,
Physical Locations / Joya / Stock,Ubicaciones virtuales / Produccion,/ Joya / Stock,07,Combustible,105-0004-01,Unit(s),GAS PROPANO BALON CHICO X 10 KG.,2018-12-09,2018-12-09,,Joya\OUT\08848,,,Joya\OUT\08848,JOSE SANTOS MATTA BORJAS,0,2.000000,16.000000,29.6611111111111111,0,59.3222222222222222000000,474.5777777777777778000000,29.6611111111111111,"",252101 - Combustibles,20.03.03 CHANCADO,"",,,,,
Partner Locations / Suppliers,Physical Locations / Joya / Stock,/ Joya / Stock,03,Combustible,105-0004-01,Unit(s),GAS PROPANO BALON CHICO X 10 KG.,2018-12-30,2018-12-30,12/2018,Joya\IN\02943,01,0001,0003134,GRUPO S & G MANRIQUE REPRESENTACIONES E.I.R.L.,6.000000,0,22.000000,29.6616666666666667,177.97,0,652.5477777777777778000000,29.6612626262626262636364,603221 - Combustibles,252101 - Combustibles,,"",,18PO06970,LM-001668,2018-12-30,
Physical Locations / Joya / Stock,Ubicaciones virtuales / Produccion,/ Joya / Stock,07,Combustible,105-0004-01,Unit(s),GAS PROPANO BALON CHICO X 10 KG.,2018-12-31,2018-12-31,,Joya\OUT\09094,,,Joya\OUT\09094,JOSE SANTOS MATTA BORJAS,0,23.000000,-1.000000,29.6612626262626262636364,0,682.2090404040404040636372000000,-29.6612626262626262636372000000,0,"",252101 - Combustibles,21.01.09 MOLINO 6' X 8' DELTA,"",,,,,
Partner Locations / Suppliers,Physical Locations / Joya / Stock,/ Joya / Stock,03,Otros Suministros Diversos,119-0034-01,Caja,CRISOLES X 30 Gr CAJA (X 25 UND),2018-12-01,2018-12-01,12/2018,Joya\IN\02873,01,E001,0000056,REFRACTARIOS OMEGA S.R.L.,40.000000,0,40.000000,41.9875000000000000,1679.5,0,1679.5,41.9875000000000000,603210 - Otros Suministros Diversos,252410 - Otros Suministros Diversos,,"",,18PO06269,LM-001586,,
Partner Locations / Suppliers,Physical Locations / Joya / Stock,/ Joya / Stock,03,Otros Suministros Diversos,119-0034-01,Caja,CRISOLES X 30 Gr CAJA (X 25 UND),2018-12-01,2018-12-01,12/2018,Joya\IN\02928,01,E001,0000058,REFRACTARIOS OMEGA S.R.L.,120.000000,0,160.000000,41.9875000000000000,5038.5,0,6718.0,41.9875000000000000,603210 - Otros Suministros Diversos,252410 - Otros Suministros Diversos,,"",,18PO06544,LM-001623,2018-12-01,
Partner Locations / Suppliers,Physical Locations / Joya / Stock,/ Joya / Stock,03,Otros Suministros Diversos,119-0034-01,Caja,CRISOLES X 30 Gr CAJA (X 25 UND),2018-12-01,2018-12-01,12/2018,Joya\IN\02927,01,E001,0000063,REFRACTARIOS OMEGA S.R.L.,80.000000,0,240.000000,42.2000000000000000,3376,0,10094.0,42.0583333333333333,603210 - Otros Suministros Diversos,252410 - Otros Suministros Diversos,,"",,18PO06799,LM-001652,2018-12-01,
Physical Locations / Joya / Stock,Ubicaciones virtuales / Produccion,/ Joya / Stock,07,Otros Suministros Diversos,119-0034-01,Caja,CRISOLES X 30 Gr CAJA (X 25 UND),2018-12-03,2018-12-03,,Joya\OUT\08794,,,Joya\OUT\08794,VICTOR URIEL VILCA CENTI,0,12.000000,228.000000,42.0583333333333333,0,504.6999999999999996000000,9589.3000000000000004000000,42.0583333333333333,"",252410 - Otros Suministros Diversos,20.05.02 LABORATORIO QUIMICO,"",,,,2018-12-03,
Physical Locations / Joya / Stock,Ubicaciones virtuales / Produccion,/ Joya / Stock,07,Otros Suministros Diversos,119-0034-01,Caja,CRISOLES X 30 Gr CAJA (X 25 UND),2018-12-04,2018-12-04,,Joya\OUT\08801,,,Joya\OUT\08801,VICTOR URIEL VILCA CENTI,0,20.000000,208.000000,42.0583333333333333,0,841.1666666666666660000000,8748.1333333333333344000000,42.0583333333333333,"",252410 - Otros Suministros Diversos,20.05.02 LABORATORIO QUIMICO,"",,,,2018-12-04,
Physical Locations / Joya / Stock,Ubicaciones virtuales / Produccion,/ Joya / Stock,07,Otros Suministros Diversos,119-0034-01,Caja,CRISOLES X 30 Gr CAJA (X 25 UND),2018-12-07,2018-12-07,,Joya\OUT\08827,,,Joya\OUT\08827,VICTOR URIEL VILCA CENTI,0,20.000000,188.000000,42.0583333333333333,0,841.1666666666666660000000,7906.9666666666666684000000,42.0583333333333333,"",252410 - Otros Suministros Diversos,20.05.02 LABORATORIO QUIMICO,"",,,,2018-12-07,
Physical Locations / Joya / Stock,Ubicaciones virtuales / Produccion,/ Joya / Stock,07,Otros Suministros Diversos,119-0034-01,Caja,CRISOLES X 30 Gr CAJA (X 25 UND),2018-12-08,2018-12-08,,Joya\OUT\08842,,,Joya\OUT\08842,VICTOR URIEL VILCA CENTI,0,20.000000,168.000000,42.0583333333333333,0,841.1666666666666660000000,7065.8000000000000024000000,42.0583333333333333,"",252410 - Otros Suministros Diversos,20.05.02 LABORATORIO QUIMICO,"",,,,2018-12-08,
Physical Locations / Joya / Stock,Ubicaciones virtuales / Produccion,/ Joya / Stock,07,Otros Suministros Diversos,119-0034-01,Caja,CRISOLES X 30 Gr CAJA (X 25 UND),2018-12-11,2018-12-11,,Joya\OUT\08862,,,Joya\OUT\08862,VICTOR URIEL VILCA CENTI,0,12.000000,156.000000,42.0583333333333333,0,504.6999999999999996000000,6561.1000000000000028000000,42.0583333333333333,"",252410 - Otros Suministros Diversos,20.05.02 LABORATORIO QUIMICO,"",,,,2018-12-11,
Physical Locations / Joya / Stock,Ubicaciones virtuales / Produccion,/ Joya / Stock,07,Otros Suministros Diversos,119-0034-01,Caja,CRISOLES X 30 Gr CAJA (X 25 UND),2018-12-14,2018-12-14,,Joya\OUT\08914,,,Joya\OUT\08914,VICTOR URIEL VILCA CENTI,0,20.000000,136.000000,42.0583333333333333,0,841.1666666666666660000000,5719.9333333333333368000000,42.0583333333333333,"",252410 - Otros Suministros Diversos,20.05.02 LABORATORIO QUIMICO,"",,,,2018-12-14,
Physical Locations / Joya / Stock,Ubicaciones virtuales / Produccion,/ Joya / Stock,07,Otros Suministros Diversos,119-0034-01,Caja,CRISOLES X 30 Gr CAJA (X 25 UND),2018-12-16,2018-12-16,,Joya\OUT\08929,,,Joya\OUT\08929,VICTOR URIEL VILCA CENTI,0,20.000000,116.000000,42.0583333333333333,0,841.1666666666666660000000,4878.7666666666666708000000,42.0583333333333333,"",252410 - Otros Suministros Diversos,20.05.02 LABORATORIO QUIMICO,"",,,,2018-12-16,
Physical Locations / Joya / Stock,Ubicaciones virtuales / Produccion,/ Joya / Stock,07,Otros Suministros Diversos,119-0034-01,Caja,CRISOLES X 30 Gr CAJA (X 25 UND),2018-12-19,2018-12-19,,Joya\OUT\08971,,,Joya\OUT\08971,VICTOR URIEL VILCA CENTI,0,50.000000,66.000000,42.0583333333333333,0,2102.9166666666666650000000,2775.8500000000000058000000,42.0583333333333333,"",252410 - Otros Suministros Diversos,20.05.02 LABORATORIO QUIMICO,"",,,,2018-12-19,
Physical Locations / Joya / Stock,Ubicaciones virtuales / Produccion,/ Joya / Stock,07,Otros Suministros Diversos,119-0034-01,Caja,CRISOLES X 30 Gr CAJA (X 25 UND),2018-12-21,2018-12-21,,Joya\OUT\08989,,,Joya\OUT\08989,VICTOR URIEL VILCA CENTI,0,10.000000,56.000000,42.0583333333333333,0,420.5833333333333330000000,2355.2666666666666728000000,42.0583333333333333,"",252410 - Otros Suministros Diversos,20.05.02 LABORATORIO QUIMICO,"",,,,2018-12-21,
Physical Locations / Joya / Stock,Ubicaciones virtuales / Produccion,/ Joya / Stock,07,Otros Suministros Diversos,119-0034-01,Caja,CRISOLES X 30 Gr CAJA (X 25 UND),2018-12-24,2018-12-24,,Joya\OUT\09034,,,Joya\OUT\09034,VICTOR URIEL VILCA CENTI,0,20.000000,36.000000,42.0583333333333333,0,841.1666666666666660000000,1514.1000000000000068000000,42.0583333333333333,"",252410 - Otros Suministros Diversos,20.05.02 LABORATORIO QUIMICO,"",,,,2018-12-24,
Physical Locations / Joya / Stock,Ubicaciones virtuales / Produccion,/ Joya / Stock,07,Otros Suministros Diversos,119-0034-01,Caja,CRISOLES X 30 Gr CAJA (X 25 UND),2018-12-25,2018-12-25,,Joya\OUT\09036,,,Joya\OUT\09036,VICTOR URIEL VILCA CENTI,0,72.000000,-36.000000,42.0583333333333333,0,3028.1999999999999976000000,-1514.0999999999999908000000,0,"",252410 - Otros Suministros Diversos,20.05.02 LABORATORIO QUIMICO,"",,,,2018-12-25,
Partner Locations / Suppliers,Physical Locations / Joya / Stock,/ Joya / Stock,03,Otros Suministros Diversos,119-0034-01,Caja,CRISOLES X 30 Gr CAJA (X 25 UND),2018-12-27,2018-12-27,12/2018,Joya\IN\02942,01,E001,0000062,REFRACTARIOS OMEGA S.R.L.,40.000000,0,4.000000,42.2000000000000000,1688,0,173.9000000000000092000000,43.4750000000000023000000,603210 - Otros Suministros Diversos,252410 - Otros Suministros Diversos,,"",,18PO06545,LM-001623,2018-12-27,
Physical Locations / Joya / Stock,Ubicaciones virtuales / Produccion,/ Joya / Stock,07,Otros Suministros Diversos,119-0034-01,Caja,CRISOLES X 30 Gr CAJA (X 25 UND),2018-12-31,2018-12-31,,Joya\OUT\09154,,,Joya\OUT\09154,VICTOR URIEL VILCA CENTI,0,20.000000,-16.000000,43.4750000000000023000000,0,869.5000000000000460000000000000,-695.6000000000000368000000000000,0,"",252410 - Otros Suministros Diversos,20.05.02 LABORATORIO QUIMICO,"",,,,2018-12-31,
Physical Locations / Joya / Stock,Ubicaciones virtuales / Produccion,/ Joya / Stock,07,Reactivos(alcohol Industrial),109-0001-XX,Liter(s),ALCOHOL INDUSTRIAL DESNATURALIZADO,2018-12-02,2018-12-02,,Joya\OUT\08779,,,Joya\OUT\08779,CARLOS ABRAHAN HUAMAN MAMANI,0,1000.000000,-1000.000000,0,0,0.000000,0.000000,0,"",251104 - Alcohol Idustrial,22.01.03 DESORCIÓN,"",,,,2018-12-02,
Physical Locations / Joya / Stock,Ubicaciones virtuales / Produccion,/ Joya / Stock,07,Reactivos(alcohol Industrial),109-0001-XX,Liter(s),ALCOHOL INDUSTRIAL DESNATURALIZADO,2018-12-07,2018-12-07,,Joya\OUT\08829,,,Joya\OUT\08829,JOSE SANTOS MATTA BORJAS,0,1000.000000,-2000.000000,0,0,0.000000,0.000000,0,"",251104 - Alcohol Idustrial,22.01.03 DESORCIÓN,"",,,,,
Physical Locations / Joya / Stock,Ubicaciones virtuales / Produccion,/ Joya / Stock,07,Reactivos(alcohol Industrial),109-0001-XX,Liter(s),ALCOHOL INDUSTRIAL DESNATURALIZADO,2018-12-13,2018-12-13,,Joya\OUT\08906,,,Joya\OUT\08906,Harold Zambrano,0,1000.000000,-3000.000000,0,0,0.000000,0.000000,0,"",251104 - Alcohol Idustrial,"22.01.29	DEPRECIACION DESORCION, FUNDICION Y REFINACION","",,,,,
Partner Locations / Suppliers,Physical Locations / Joya / Stock,/ Joya / Stock,03,Reactivos(alcohol Industrial),109-0001-XX,Liter(s),ALCOHOL INDUSTRIAL DESNATURALIZADO,2018-12-15,2018-12-15,12/2018,Joya\IN\02902,01,F005,0003791,DISTRIBUIDORA DE PRODUCTOS QUIMICOS SRL,2000.000000,0,-1000.000000,3.6441,7288.2,0,7288.200000,0,603104 - Alcohol Industrial,251104 - Alcohol Idustrial,,"",,18PO06605,LM-001630,2018-12-15,
Partner Locations / Suppliers,Physical Locations / Joya / Stock,/ Joya / Stock,03,Reactivos(alcohol Industrial),109-0001-XX,Liter(s),ALCOHOL INDUSTRIAL DESNATURALIZADO,2018-12-15,2018-12-15,12/2018,Joya\IN\02901,01,F005,0003794,DISTRIBUIDORA DE PRODUCTOS QUIMICOS SRL,2000.000000,0,1000.000000,0.00000000000000000000,0,0,7288.200000,7.2882000000000000,,251104 - Alcohol Idustrial,,"",,18PO06601,LM-001630,2018-12-15,
Physical Locations / Joya / Stock,Ubicaciones virtuales / Produccion,/ Joya / Stock,07,Reactivos(alcohol Industrial),109-0001-XX,Liter(s),ALCOHOL INDUSTRIAL DESNATURALIZADO,2018-12-22,2018-12-22,,Joya\OUT\09011,,,Joya\OUT\09011,JOSE SANTOS MATTA BORJAS,0,1000.000000,0.000000,7.2882000000000000,0,7288.2000000000000000000000,0.0000000000000000000000,0,"",251104 - Alcohol Idustrial,22.01.03 DESORCIÓN,"",,,,,
Physical Locations / Joya / Stock,Ubicaciones virtuales / Produccion,/ Joya / Stock,07,Reactivos(alcohol Industrial),109-0001-XX,Liter(s),ALCOHOL INDUSTRIAL DESNATURALIZADO,2018-12-27,2018-12-27,,Joya\OUT\09054,,,Joya\OUT\09054,JOSE SANTOS MATTA BORJAS,0,1000.000000,-1000.000000,0,0,0.000000,0.0000000000000000000000,0,"",251104 - Alcohol Idustrial,22.01.03 DESORCIÓN,"",,,,,
Physical Locations / Joya / Stock,Ubicaciones virtuales / Produccion,/ Joya / Stock,07,Otros Reactivos,108-0002-XX,kg,FUNDENTE,2018-12-04,2018-12-04,,Joya\OUT\08801,,,Joya\OUT\08801,VICTOR URIEL VILCA CENTI,0,150.000000,-150.000000,0,0,0.000000,0.000000,0,"",252402 - Reactivos,20.05.02 LABORATORIO QUIMICO,"",,,,2018-12-04,
Partner Locations / Suppliers,Physical Locations / Joya / Stock,/ Joya / Stock,03,Otros Reactivos,108-0002-XX,kg,FUNDENTE,2018-12-06,2018-12-06,12/2018,Joya\IN\02883,01,E001,0000057,REFRACTARIOS OMEGA S.R.L.,600.000000,0,450.000000,17.8027000000000000,10681.62,0,10681.620000,23.7369333333333333,603202 - Reactivos,252402 - Reactivos,,"",,18PO06353,LM-001601,2018-12-06,
Physical Locations / Joya / Stock,Ubicaciones virtuales / Produccion,/ Joya / Stock,07,Otros Reactivos,108-0002-XX,kg,FUNDENTE,2018-12-08,2018-12-08,,Joya\OUT\08842,,,Joya\OUT\08842,VICTOR URIEL VILCA CENTI,0,100.000000,350.000000,23.7369333333333333,0,2373.6933333333333300000000,8307.9266666666666700000000,23.7369333333333333,"",252402 - Reactivos,20.05.02 LABORATORIO QUIMICO,"",,,,2018-12-08,
,,/ Joya / Stock,"",Otros Reactivos,"","",FUNDENTE,,2018-12-11,12/2018,,01,F040,0043188,AREQUIPA EXPRESS COMITE 4 S.C.R.L.,0,0,350.000000,24.4875333333333333428571,262.71,0,8570.6366666666666700000000,24.4875333333333333428571,603202,252402 - Reactivos,"",,,,,,
Physical Locations / Joya / Stock,Ubicaciones virtuales / Produccion,/ Joya / Stock,07,Otros Reactivos,108-0002-XX,kg,FUNDENTE,2018-12-11,2018-12-11,,Joya\OUT\08862,,,Joya\OUT\08862,VICTOR URIEL VILCA CENTI,0,50.000000,300.000000,24.4875333333333333428571,0,1224.3766666666666671428550000000,7346.2600000000000028571450000000,24.4875333333333333428571,"",252402 - Reactivos,20.05.02 LABORATORIO QUIMICO,"",,,,2018-12-11,
Physical Locations / Joya / Stock,Ubicaciones virtuales / Produccion,/ Joya / Stock,07,Otros Reactivos,108-0002-XX,kg,FUNDENTE,2018-12-14,2018-12-14,,Joya\OUT\08914,,,Joya\OUT\08914,VICTOR URIEL VILCA CENTI,0,150.000000,150.000000,24.4875333333333333428571,0,3673.1300000000000014285650000000,3673.1300000000000014285800000000,24.4875333333333333428571,"",252402 - Reactivos,20.05.02 LABORATORIO QUIMICO,"",,,,2018-12-14,
,,/ Joya / Stock,"",Otros Reactivos,"","",FUNDENTE,,2018-12-19,12/2018,,01,0003,0002027,WILMER ABEL CHOQUE VILCA,0,0,150.000000,25.5798000000000000095238666667,163.84,0,3836.9700000000000014285800000000,25.5798000000000000095238666667,603202,252402 - Reactivos,"",,,,,,
Physical Locations / Joya / Stock,Ubicaciones virtuales / Produccion,/ Joya / Stock,07,Otros Reactivos,108-0002-XX,kg,FUNDENTE,2018-12-19,2018-12-19,,Joya\OUT\08971,,,Joya\OUT\08971,VICTOR URIEL VILCA CENTI,0,150.000000,0.000000,25.5798000000000000095238666667,0,3836.9700000000000014285800000050000000,-0.0000000000000000000000000050000000,0,"",252402 - Reactivos,20.05.02 LABORATORIO QUIMICO,"",,,,2018-12-19,
Physical Locations / Joya / Stock,Ubicaciones virtuales / Produccion,/ Joya / Stock,07,Otros Reactivos,108-0002-XX,kg,FUNDENTE,2018-12-21,2018-12-21,,Joya\OUT\08989,,,Joya\OUT\08989,VICTOR URIEL VILCA CENTI,0,150.000000,-150.000000,0,0,0.000000,-0.0000000000000000000000000050000000,0,"",252402 - Reactivos,20.05.02 LABORATORIO QUIMICO,"",,,,2018-12-21,
Partner Locations / Suppliers,Physical Locations / Joya / Stock,/ Joya / Stock,03,Otros Reactivos,108-0002-XX,kg,FUNDENTE,2018-12-22,2018-12-22,12/2018,Joya\IN\02895,01,E001,0000379,APOYO LOGISTICO MINERO E.I.R.L.,600.000000,0,450.000000,18.1980000000000000,10918.8,0,10918.7999999999999999999999999950000000,24.2639999999999999999999999999888889,603202 - Reactivos,252402 - Reactivos,,"",,18PO06483,LM-001489,,
Physical Locations / Joya / Stock,Ubicaciones virtuales / Produccion,/ Joya / Stock,07,Otros Reactivos,108-0002-XX,kg,FUNDENTE,2018-12-25,2018-12-25,,Joya\OUT\09036,,,Joya\OUT\09036,VICTOR URIEL VILCA CENTI,0,150.000000,300.000000,24.2639999999999999999999999999888889,0,3639.5999999999999999999999999983333350000000,7279.1999999999999999999999999966666650000000,24.2639999999999999999999999999888889,"",252402 - Reactivos,20.05.02 LABORATORIO QUIMICO,"",,,,2018-12-25,
,,/ Joya / Stock,"",Otros Reactivos,"","",FUNDENTE,,2018-12-26,12/2018,,01,0003,0002039,WILMER ABEL CHOQUE VILCA,0,0,300.000000,24.8289666666666666666666666666555555500000,169.49,0,7448.6899999999999999999999999966666650000000,24.8289666666666666666666666666555555500000,603202,252402 - Reactivos,"",,,,,,
Partner Locations / Suppliers,Physical Locations / Joya / Stock,/ Joya / Stock,03,Otros Reactivos,108-0002-XX,kg,FUNDENTE,2018-12-27,2018-12-27,12/2018,Joya\IN\02942,01,E001,0000062,REFRACTARIOS OMEGA S.R.L.,400.000000,0,700.000000,17.8928000000000000,7157.12,0,14605.8099999999999999999999999966666650000000,20.8654428571428571428571428571380952357143,603202 - Reactivos,252402 - Reactivos,,"",,18PO06545,LM-001623,2018-12-27,
Physical Locations / Joya / Stock,Ubicaciones virtuales / Produccion,/ Joya / Stock,07,Otros Reactivos,108-0002-XX,kg,FUNDENTE,2018-12-31,2018-12-31,,Joya\OUT\09154,,,Joya\OUT\09154,VICTOR URIEL VILCA CENTI,0,120.000000,580.000000,20.8654428571428571428571428571380952357143,0,2503.8531428571428571428571428565714282857160000000,12101.9568571428571428571428571400952367142840000000,20.8654428571428571428571428571380952357143,"",252402 - Reactivos,20.05.02 LABORATORIO QUIMICO,"",,,,2018-12-31,
Physical Locations / Joya / Stock,Ubicaciones virtuales / Produccion,/ Joya / Stock,07,Otros Reactivos,108-0003-XX,kg,BORAX (TETRA-BORATO-SODIO),2018-12-01,2018-12-01,,Joya\OUT\08771,,,Joya\OUT\08771,VICTOR URIEL VILCA CENTI,0,25.000000,-25.000000,0,0,0.000000,0.000000,0,"",252402 - Reactivos,20.05.02 LABORATORIO QUIMICO,"",,,,2018-12-01,
Physical Locations / Joya / Stock,Ubicaciones virtuales / Produccion,/ Joya / Stock,07,Otros Reactivos,108-0003-XX,kg,BORAX (TETRA-BORATO-SODIO),2018-12-08,2018-12-08,,Joya\OUT\08842,,,Joya\OUT\08842,VICTOR URIEL VILCA CENTI,0,25.000000,-50.000000,0,0,0.000000,0.000000,0,"",252402 - Reactivos,20.05.02 LABORATORIO QUIMICO,"",,,,2018-12-08,
Physical Locations / Joya / Stock,Ubicaciones virtuales / Produccion,/ Joya / Stock,07,Otros Reactivos,108-0003-XX,kg,BORAX (TETRA-BORATO-SODIO),2018-12-16,2018-12-16,,Joya\OUT\08929,,,Joya\OUT\08929,VICTOR URIEL VILCA CENTI,0,25.000000,-75.000000,0,0,0.000000,0.000000,0,"",252402 - Reactivos,20.05.02 LABORATORIO QUIMICO,"",,,,2018-12-16,
Physical Locations / Joya / Stock,Ubicaciones virtuales / Produccion,/ Joya / Stock,07,Otros Reactivos,108-0003-XX,kg,BORAX (TETRA-BORATO-SODIO),2018-12-18,2018-12-18,,Joya\OUT\08941,,,Joya\OUT\08941,Harold Zambrano,0,100.000000,-175.000000,0,0,0.000000,0.000000,0,"",252402 - Reactivos,"22.01.29	DEPRECIACION DESORCION, FUNDICION Y REFINACION","",,,,,
Physical Locations / Joya / Stock,Ubicaciones virtuales / Produccion,/ Joya / Stock,07,Otros Reactivos,108-0003-XX,kg,BORAX (TETRA-BORATO-SODIO),2018-12-21,2018-12-21,,Joya\OUT\08989,,,Joya\OUT\08989,VICTOR URIEL VILCA CENTI,0,25.000000,-200.000000,0,0,0.000000,0.000000,0,"",252402 - Reactivos,20.05.02 LABORATORIO QUIMICO,"",,,,2018-12-21,
Physical Locations / Joya / Stock,Ubicaciones virtuales / Produccion,/ Joya / Stock,07,Otros Reactivos,108-0003-XX,kg,BORAX (TETRA-BORATO-SODIO),2018-12-28,2018-12-28,,Joya\OUT\09063,,,Joya\OUT\09063,VICTOR URIEL VILCA CENTI,0,25.000000,-225.000000,0,0,0.000000,0.000000,0,"",252402 - Reactivos,20.05.02 LABORATORIO QUIMICO,"",,,,2018-12-28,
Physical Locations / Joya / Stock,Ubicaciones virtuales / Produccion,/ Joya / Stock,07,Combustible,105-0002-01,Balon,ACETILENO,2018-12-31,2018-12-31,,Joya\OUT\09087,,,Joya\OUT\09087,ALEX ROGELIO (TRB) MEDINA ZABALAGA,0,1.000000,-1.000000,0,0,0.000000,0.000000,0,"",252101 - Combustibles,21.02.01 LIXIVIACIÓN Y ABSORCION,"",,,,2018-12-31,
Physical Locations / Joya / Stock,Ubicaciones virtuales / Produccion,/ Joya / Stock,07,Otros Suministros Diversos,119-0051-01,Unit(s),"ESCORIFICADORES 3.5""",2018-12-25,2018-12-25,,Joya\OUT\09036,,,Joya\OUT\09036,VICTOR URIEL VILCA CENTI,0,400.000000,-400.000000,0,0,0.000000,0.000000,0,"",252410 - Otros Suministros Diversos,20.05.02 LABORATORIO QUIMICO,"",,,,2018-12-25,
Physical Locations / Joya / Stock,Ubicaciones virtuales / Produccion,/ Joya / Stock,07,Materiales de Ferreteria y Construccion,107-0156-XX,Unit(s),SILICONA MEGA GREY GRIS 85G,2018-12-06,2018-12-06,,Joya\OUT\08822,,,Joya\OUT\08822,JOSE SANTOS MATTA BORJAS,0,1.000000,-1.000000,0,0,0.000000,0.000000,0,"",252401 - Materiales de Ferreteria y Construccion,21.02.03 TANQUE AGITADOR #1 (22'x22'),"",,,,,
Physical Locations / Joya / Stock,Ubicaciones virtuales / Produccion,/ Joya / Stock,07,Materiales de Ferreteria y Construccion,107-0156-XX,Unit(s),SILICONA MEGA GREY GRIS 85G,2018-12-20,2018-12-20,,Joya\OUT\08983,,,Joya\OUT\08983,ALEX ROGELIO (TRB) MEDINA ZABALAGA,0,1.000000,-2.000000,0,0,0.000000,0.000000,0,"",252401 - Materiales de Ferreteria y Construccion,21.02.03 TANQUE AGITADOR #1 (22'x22'),"",,,,2018-12-20,
Physical Locations / Joya / Stock,Ubicaciones virtuales / Produccion,/ Joya / Stock,07,Otros Suministros Diversos,107-0157-XX,Unit(s),WAYPE INDUSTRIAL COLOR (kg),2018-12-18,2018-12-18,,Joya\OUT\08945,,,Joya\OUT\08945,ALEX ROGELIO (TRB) MEDINA ZABALAGA,0,4.000000,-4.000000,0,0,0.000000,0.000000,0,"",252410 - Otros Suministros Diversos,21.01.01 MOLIENDA,"",,,,2018-12-18,
Physical Locations / Joya / Stock,Ubicaciones virtuales / Produccion,/ Joya / Stock,07,Otros Reactivos,108-0004-01,kg,ACIDO CLORHIDRICO AL 33% IND. (CIL x 250 KG.),2018-12-10,2018-12-10,,Joya\OUT\08857,,,Joya\OUT\08857,JOSE SANTOS MATTA BORJAS,0,41.160000,-41.160000,0,0,0.000000,0.000000,0,"",252402 - Reactivos,22.01.03 DESORCIÓN,"",,,,,
Physical Locations / Joya / Stock,Ubicaciones virtuales / Produccion,/ Joya / Stock,07,Otros Reactivos,108-0004-01,kg,ACIDO CLORHIDRICO AL 33% IND. (CIL x 250 KG.),2018-12-11,2018-12-11,,Joya\OUT\08864,,,Joya\OUT\08864,JOSE SANTOS MATTA BORJAS,0,19.900000,-61.060000,0,0,0.000000,0.000000,0,"",252402 - Reactivos,22.01.03 DESORCIÓN,"",,,,,
Partner Locations / Suppliers,Physical Locations / Joya / Stock,/ Joya / Stock,03,Otros Reactivos,108-0004-01,kg,ACIDO CLORHIDRICO AL 33% IND. (CIL x 250 KG.),2018-12-17,2018-12-17,12/2018,Joya\IN\02903,01,F005,0003793,DISTRIBUIDORA DE PRODUCTOS QUIMICOS SRL,250.000000,0,188.940000,2.0300000000000000,507.5,0,507.500000,2.6860378956282418,603202 - Reactivos,252402 - Reactivos,,"",,18PO06606,LM-001630,2018-12-17,
Physical Locations / Joya / Stock,Ubicaciones virtuales / Produccion,/ Joya / Stock,07,Otros Reactivos,108-0004-01,kg,ACIDO CLORHIDRICO AL 33% IND. (CIL x 250 KG.),2018-12-18,2018-12-18,,Joya\OUT\08939,,,Joya\OUT\08939,Harold Zambrano,0,45.780000,143.160000,2.6860378956282418,0,122.9668148618609096040000,384.5331851381390903960000,2.6860378956282418,"",252402 - Reactivos,22.01.03 DESORCIÓN,"",,,,,
Physical Locations / Joya / Stock,Ubicaciones virtuales / Produccion,/ Joya / Stock,07,Otros Reactivos,108-0004-01,kg,ACIDO CLORHIDRICO AL 33% IND. (CIL x 250 KG.),2018-12-27,2018-12-27,,Joya\OUT\09054,,,Joya\OUT\09054,JOSE SANTOS MATTA BORJAS,0,69.000000,74.160000,2.6860378956282418,0,185.3366147983486842000000,199.1965703397904061960000,2.6860378956282418,"",252402 - Reactivos,22.01.03 DESORCIÓN,"",,,,,
Physical Locations / Joya / Stock,Ubicaciones virtuales / Produccion,/ Joya / Stock,07,Otros Reactivos,108-0004-01,kg,ACIDO CLORHIDRICO AL 33% IND. (CIL x 250 KG.),2018-12-30,2018-12-30,,Joya\OUT\09083,,,Joya\OUT\09083,JOSE SANTOS MATTA BORJAS,0,40.660000,33.500000,2.6860378956282418,0,109.2143008362443115880000,89.9822695035460946080000,2.6860378956282418,"",252402 - Reactivos,22.01.03 DESORCIÓN,"",,,,,
Partner Locations / Suppliers,Physical Locations / Joya / Stock,/ Joya / Stock,03,Utiles de Oficina,113-0055-01,Paquete,HOJAS BOND A-4 X 500 HOJAS,2018-12-01,2018-12-01,11/2018,Joya\IN\02870,01,F532,0037181,TAI LOY S.A.,2.000000,0,12.000000,10.6483333333333500,21.2966666666667,0,127.7799999999997,10.6483333333333083,603206 - Utiles de Oficina,252406 - Utiles de Oficina,,"",,18PO06267,LM-001588,2018-12-01,
Partner Locations / Suppliers,Physical Locations / Joya / Stock,/ Joya / Stock,03,Utiles de Oficina,113-0055-01,Paquete,HOJAS BOND A-4 X 500 HOJAS,2018-12-01,2018-12-01,11/2018,Joya\IN\02870,01,F532,0037181,TAI LOY S.A.,10.000000,0,10.000000,10.6483333333333000,106.483333333333,0,106.483333333333,10.6483333333333000,603206 - Utiles de Oficina,252406 - Utiles de Oficina,,"",,18PO06267,LM-001588,2018-12-01,
Physical Locations / Joya / Stock,Ubicaciones virtuales / Produccion,/ Joya / Stock,07,Utiles de Oficina,113-0055-01,Paquete,HOJAS BOND A-4 X 500 HOJAS,2018-12-04,2018-12-04,,Joya\OUT\08803,,,Joya\OUT\08803,LUZ ESTHER CHAÑI CUTIRE,0,1.000000,11.000000,10.6483333333333083,0,10.6483333333333083000000,117.1316666666663917000000,10.6483333333333083,"",252406 - Utiles de Oficina,23.05.01 SEGURIDAD Y MEDIO AMBIENTE,"",,,,,
,,/ Joya / Stock,"",Utiles de Oficina,"","",HOJAS BOND A-4 X 500 HOJAS,,2018-12-05,12/2018,,01,0003,0002024,WILMER ABEL CHOQUE VILCA,0,0,11.000000,13.4219696969696719727273,30.51,0,147.6416666666663917000000,13.4219696969696719727273,603206,252406 - Utiles de Oficina,"",,,,,,
Physical Locations / Joya / Stock,Ubicaciones virtuales / Produccion,/ Joya / Stock,07,Utiles de Oficina,113-0055-01,Paquete,HOJAS BOND A-4 X 500 HOJAS,2018-12-14,2018-12-14,,Joya\OUT\08917,,,Joya\OUT\08917,ALEX ROGELIO (TRB) MEDINA ZABALAGA,0,2.000000,9.000000,13.4219696969696719727273,0,26.8439393939393439454546000000,120.7977272727270477545454000000,13.4219696969696719727273,"",252406 - Utiles de Oficina,25.01.03 TALLER DE MANTENIMIENTO,"",,,,2018-12-14,
Physical Locations / Joya / Stock,Ubicaciones virtuales / Produccion,/ Joya / Stock,07,Utiles de Oficina,113-0055-01,Paquete,HOJAS BOND A-4 X 500 HOJAS,2018-12-26,2018-12-26,,Joya\OUT\09046,,,Joya\OUT\09046,JOSE SANTOS MATTA BORJAS,0,1.000000,8.000000,13.4219696969696719727273,0,13.4219696969696719727273000000,107.3757575757573757818181000000,13.4219696969696719727273,"",252406 - Utiles de Oficina,20.03.03 CHANCADO,"",,,,,
Physical Locations / Joya / Stock,Ubicaciones virtuales / Produccion,/ Joya / Stock,07,Repuestos de Maquinaria y Equipo,118-0160-XX,Unit(s),FAJA TRAPEZOIDAL B- 99,2018-12-14,2018-12-14,,Joya\OUT\08917,,,Joya\OUT\08917,ALEX ROGELIO (TRB) MEDINA ZABALAGA,0,2.000000,-2.000000,0,0,0.000000,0.000000,0,"",253102 - Repuestos Maquinaria y Eq,20.03.19 MOLINO MUESTREADOR N° 1,"",,,,2018-12-14,
Physical Locations / Joya / Stock,Ubicaciones virtuales / Produccion,/ Joya / Stock,08,Otros Suministros Diversos,107-0108-01,kg,"SOLDADURA SUPERCITO 3,25X350MM",2018-12-06,2018-12-06,,Joya\OUT\08818,,,Joya\OUT\08818,,0,5.000000,-5.000000,0,0,0.000000,0.000000,0,"",252410 - Otros Suministros Diversos,29.01.82 TANQUE NUEVO DE 22X22',"",,,,2018-12-06,
Physical Locations / Joya / Stock,Ubicaciones virtuales / Produccion,/ Joya / Stock,07,Otros Suministros Diversos,107-0108-01,kg,"SOLDADURA SUPERCITO 3,25X350MM",2018-12-14,2018-12-14,,Joya\OUT\08917,,,Joya\OUT\08917,ALEX ROGELIO (TRB) MEDINA ZABALAGA,0,5.000000,-10.000000,0,0,0.000000,0.000000,0,"",252410 - Otros Suministros Diversos,25.01.03 TALLER DE MANTENIMIENTO,"",,,,2018-12-14,
Physical Locations / Joya / Stock,Ubicaciones virtuales / Produccion,/ Joya / Stock,07,Otros Suministros Diversos,107-0108-01,kg,"SOLDADURA SUPERCITO 3,25X350MM",2018-12-17,2018-12-17,,Joya\OUT\08933,,,Joya\OUT\08933,ALEX ROGELIO (TRB) MEDINA ZABALAGA,0,5.000000,-15.000000,0,0,0.000000,0.000000,0,"",252410 - Otros Suministros Diversos,21.02.03 TANQUE AGITADOR #1 (22'x22'),"",,,,2018-12-17,
Partner Locations / Suppliers,Physical Locations / Joya / Stock,/ Joya / Stock,03,Otros Suministros Diversos,119-0080-XX,Unit(s),COPELAS # 7 (CJ X 200 UNIDADES),2018-12-01,2018-12-01,12/2018,Joya\IN\02873,01,E001,0000056,REFRACTARIOS OMEGA S.R.L.,1000.000000,0,1000.000000,0.83975000000000000000,839.75,0,839.75,0.83975000000000000000,603210 - Otros Suministros Diversos,252410 - Otros Suministros Diversos,,"",,18PO06269,LM-001586,,
Partner Locations / Suppliers,Physical Locations / Joya / Stock,/ Joya / Stock,03,Otros Suministros Diversos,119-0080-XX,Unit(s),COPELAS # 7 (CJ X 200 UNIDADES),2018-12-01,2018-12-01,12/2018,Joya\IN\02928,01,E001,0000058,REFRACTARIOS OMEGA S.R.L.,3000.000000,0,4000.000000,0.83975000000000000000,2519.25,0,3359.00,0.83975000000000000000,603210 - Otros Suministros Diversos,252410 - Otros Suministros Diversos,,"",,18PO06544,LM-001623,2018-12-01,
Partner Locations / Suppliers,Physical Locations / Joya / Stock,/ Joya / Stock,03,Otros Suministros Diversos,119-0080-XX,Unit(s),COPELAS # 7 (CJ X 200 UNIDADES),2018-12-01,2018-12-01,12/2018,Joya\IN\02927,01,E001,0000063,REFRACTARIOS OMEGA S.R.L.,3000.000000,0,7000.000000,0.84400000000000000000,2532,0,5891.00,0.84157142857142857143,603210 - Otros Suministros Diversos,252410 - Otros Suministros Diversos,,"",,18PO06799,LM-001652,2018-12-01,
Physical Locations / Joya / Stock,Ubicaciones virtuales / Produccion,/ Joya / Stock,07,Otros Suministros Diversos,119-0080-XX,Unit(s),COPELAS # 7 (CJ X 200 UNIDADES),2018-12-04,2018-12-04,,Joya\OUT\08801,,,Joya\OUT\08801,VICTOR URIEL VILCA CENTI,0,1200.000000,5800.000000,0.84157142857142857143,0,1009.88571428571428571600000000,4881.11428571428571428400000000,0.84157142857142857143,"",252410 - Otros Suministros Diversos,20.05.02 LABORATORIO QUIMICO,"",,,,2018-12-04,
Physical Locations / Joya / Stock,Ubicaciones virtuales / Produccion,/ Joya / Stock,07,Otros Suministros Diversos,119-0080-XX,Unit(s),COPELAS # 7 (CJ X 200 UNIDADES),2018-12-08,2018-12-08,,Joya\OUT\08842,,,Joya\OUT\08842,VICTOR URIEL VILCA CENTI,0,1000.000000,4800.000000,0.84157142857142857143,0,841.57142857142857143000000000,4039.54285714285714285400000000,0.84157142857142857143,"",252410 - Otros Suministros Diversos,20.05.02 LABORATORIO QUIMICO,"",,,,2018-12-08,
Physical Locations / Joya / Stock,Ubicaciones virtuales / Produccion,/ Joya / Stock,07,Otros Suministros Diversos,119-0080-XX,Unit(s),COPELAS # 7 (CJ X 200 UNIDADES),2018-12-11,2018-12-11,,Joya\OUT\08862,,,Joya\OUT\08862,VICTOR URIEL VILCA CENTI,0,600.000000,4200.000000,0.84157142857142857143,0,504.94285714285714285800000000,3534.59999999999999999600000000,0.84157142857142857143,"",252410 - Otros Suministros Diversos,20.05.02 LABORATORIO QUIMICO,"",,,,2018-12-11,
Physical Locations / Joya / Stock,Ubicaciones virtuales / Produccion,/ Joya / Stock,07,Otros Suministros Diversos,119-0080-XX,Unit(s),COPELAS # 7 (CJ X 200 UNIDADES),2018-12-16,2018-12-16,,Joya\OUT\08929,,,Joya\OUT\08929,VICTOR URIEL VILCA CENTI,0,1000.000000,3200.000000,0.84157142857142857143,0,841.57142857142857143000000000,2693.02857142857142856600000000,0.84157142857142857143,"",252410 - Otros Suministros Diversos,20.05.02 LABORATORIO QUIMICO,"",,,,2018-12-16,
Physical Locations / Joya / Stock,Ubicaciones virtuales / Produccion,/ Joya / Stock,07,Otros Suministros Diversos,119-0080-XX,Unit(s),COPELAS # 7 (CJ X 200 UNIDADES),2018-12-19,2018-12-19,,Joya\OUT\08971,,,Joya\OUT\08971,VICTOR URIEL VILCA CENTI,0,800.000000,2400.000000,0.84157142857142857143,0,673.25714285714285714400000000,2019.77142857142857142200000000,0.84157142857142857143,"",252410 - Otros Suministros Diversos,20.05.02 LABORATORIO QUIMICO,"",,,,2018-12-19,
Physical Locations / Joya / Stock,Ubicaciones virtuales / Produccion,/ Joya / Stock,07,Otros Suministros Diversos,119-0080-XX,Unit(s),COPELAS # 7 (CJ X 200 UNIDADES),2018-12-21,2018-12-21,,Joya\OUT\08989,,,Joya\OUT\08989,VICTOR URIEL VILCA CENTI,0,200.000000,2200.000000,0.84157142857142857143,0,168.31428571428571428600000000,1851.45714285714285713600000000,0.84157142857142857143,"",252410 - Otros Suministros Diversos,20.05.02 LABORATORIO QUIMICO,"",,,,2018-12-21,
Physical Locations / Joya / Stock,Ubicaciones virtuales / Produccion,/ Joya / Stock,07,Otros Suministros Diversos,119-0080-XX,Unit(s),COPELAS # 7 (CJ X 200 UNIDADES),2018-12-24,2018-12-24,,Joya\OUT\09034,,,Joya\OUT\09034,VICTOR URIEL VILCA CENTI,0,1000.000000,1200.000000,0.84157142857142857143,0,841.57142857142857143000000000,1009.88571428571428570600000000,0.84157142857142857143,"",252410 - Otros Suministros Diversos,20.05.02 LABORATORIO QUIMICO,"",,,,2018-12-24,
Physical Locations / Joya / Stock,Ubicaciones virtuales / Produccion,/ Joya / Stock,07,Otros Suministros Diversos,119-0080-XX,Unit(s),COPELAS # 7 (CJ X 200 UNIDADES),2018-12-25,2018-12-25,,Joya\OUT\09036,,,Joya\OUT\09036,VICTOR URIEL VILCA CENTI,0,2000.000000,-800.000000,0.84157142857142857143,0,1683.14285714285714286000000000,-673.25714285714285715400000000,0,"",252410 - Otros Suministros Diversos,20.05.02 LABORATORIO QUIMICO,"",,,,2018-12-25,
Partner Locations / Suppliers,Physical Locations / Joya / Stock,/ Joya / Stock,03,Otros Suministros Diversos,119-0080-XX,Unit(s),COPELAS # 7 (CJ X 200 UNIDADES),2018-12-27,2018-12-27,12/2018,Joya\IN\02942,01,E001,0000062,REFRACTARIOS OMEGA S.R.L.,1000.000000,0,200.000000,0.84400000000000000000,844,0,170.74285714285714284600000000,0.85371428571428571423000000,603210 - Otros Suministros Diversos,252410 - Otros Suministros Diversos,,"",,18PO06545,LM-001623,2018-12-27,
Physical Locations / Joya / Stock,Ubicaciones virtuales / Produccion,/ Joya / Stock,07,Suministros Electricos,111-0214-XX,Paquete,CINTILLO PLASTICO 250 X 4.8 MM X 100 UND,2018-12-22,2018-12-22,,Joya\OUT\09002,,,Joya\OUT\09002,ALEX ROGELIO (TRB) MEDINA ZABALAGA,0,1.000000,-1.000000,0,0,0.000000,0.000000,0,"",252404 - Suministros Electricos,20.03.03 CHANCADO,"",,,,2018-12-22,
Physical Locations / Joya / Stock,Ubicaciones virtuales / Produccion,/ Joya / Stock,07,Otros Reactivos,108-0008-XX,kg,PLOMO LAMINADO AL 99%,2018-12-03,2018-12-03,,Joya\OUT\08789,,,Joya\OUT\08789,VICTOR URIEL VILCA CENTI,0,1.000000,-1.000000,0,0,0.000000,0.000000,0,"",252402 - Reactivos,20.05.02 LABORATORIO QUIMICO,"",,,,2018-12-03,
Physical Locations / Joya / Stock,Ubicaciones virtuales / Produccion,/ Joya / Stock,07,Otros Reactivos,108-0008-XX,kg,PLOMO LAMINADO AL 99%,2018-12-14,2018-12-14,,Joya\OUT\08914,,,Joya\OUT\08914,VICTOR URIEL VILCA CENTI,0,3.000000,-4.000000,0,0,0.000000,0.000000,0,"",252402 - Reactivos,20.05.02 LABORATORIO QUIMICO,"",,,,2018-12-14,
Physical Locations / Joya / Stock,Ubicaciones virtuales / Produccion,/ Joya / Stock,07,Otros Reactivos,108-0008-XX,kg,PLOMO LAMINADO AL 99%,2018-12-28,2018-12-28,,Joya\OUT\09063,,,Joya\OUT\09063,VICTOR URIEL VILCA CENTI,0,2.000000,-6.000000,0,0,0.000000,0.000000,0,"",252402 - Reactivos,20.05.02 LABORATORIO QUIMICO,"",,,,2018-12-28,
Physical Locations / Joya / Stock,Ubicaciones virtuales / Produccion,/ Joya / Stock,07,Herramientas e Instrumentos,112-0025-XX,Caja,PAPEL INDICADOR PANPEHA - CAJA (X 200 TIRAS),2018-12-11,2018-12-11,,Joya\OUT\08863,,,Joya\OUT\08863,JOSE SANTOS MATTA BORJAS,0,1.000000,-1.000000,0,0,0.000000,0.000000,0,"",252405 - Herramientas e Instrumentos,21.02.03 TANQUE AGITADOR #1 (22'x22'),"",,,,,
Physical Locations / Joya / Stock,Ubicaciones virtuales / Produccion,/ Joya / Stock,07,Herramientas e Instrumentos,112-0025-XX,Caja,PAPEL INDICADOR PANPEHA - CAJA (X 200 TIRAS),2018-12-18,2018-12-18,,Joya\OUT\08946,,,Joya\OUT\08946,Harold Zambrano,0,3.000000,-4.000000,0,0,0.000000,0.000000,0,"",252405 - Herramientas e Instrumentos,21.02.01 LIXIVIACIÓN Y ABSORCION,"",,,,,
Physical Locations / Joya / Stock,Ubicaciones virtuales / Produccion,/ Joya / Stock,07,Herramientas e Instrumentos,112-0025-XX,Caja,PAPEL INDICADOR PANPEHA - CAJA (X 200 TIRAS),2018-12-21,2018-12-21,,Joya\OUT\08989,,,Joya\OUT\08989,VICTOR URIEL VILCA CENTI,0,1.000000,-5.000000,0,0,0.000000,0.000000,0,"",252405 - Herramientas e Instrumentos,20.05.03 LABORATORIO METALURGICO,"",,,,2018-12-21,
Physical Locations / Joya / Stock,Ubicaciones virtuales / Produccion,/ Joya / Stock,07,Herramientas e Instrumentos,112-0025-XX,Caja,PAPEL INDICADOR PANPEHA - CAJA (X 200 TIRAS),2018-12-24,2018-12-24,,Joya\OUT\09034,,,Joya\OUT\09034,VICTOR URIEL VILCA CENTI,0,1.000000,-6.000000,0,0,0.000000,0.000000,0,"",252405 - Herramientas e Instrumentos,20.05.02 LABORATORIO QUIMICO,"",,,,2018-12-24,
Physical Locations / Joya / Stock,Ubicaciones virtuales / Produccion,/ Joya / Stock,07,Materiales de Ferreteria y Construccion,107-0199-XX,Unit(s),LIJA 80,2018-12-30,2018-12-30,,Joya\OUT\09079,,,Joya\OUT\09079,ALEX ROGELIO (TRB) MEDINA ZABALAGA,0,1.000000,-1.000000,0,0,0.000000,0.000000,0,"",252401 - Materiales de Ferreteria y Construccion,20.03.32	COLECTOR DE POLVO,"",,,,2018-12-30,
Physical Locations / Joya / Stock,Ubicaciones virtuales / Produccion,/ Joya / Stock,07,Repuestos de Maquinaria y Equipo,118-0203-XX,Unit(s),IMPULSORES PARA BOMBA 3x3 SRL.,2018-12-02,2018-12-02,,Joya\OUT\08751,,,Joya\OUT\08751,ALEX ROGELIO (TRB) MEDINA ZABALAGA,0,1.000000,-1.000000,0,0,0.000000,0.000000,0,"",253102 - Repuestos Maquinaria y Eq,"21.01.13 BOMBA DE PULPA 3"" X 3"" MOLIENDA (4 UND)","",,,,2018-12-02,
Physical Locations / Joya / Stock,Ubicaciones virtuales / Produccion,/ Joya / Stock,07,Repuestos de Maquinaria y Equipo,118-0203-XX,Unit(s),IMPULSORES PARA BOMBA 3x3 SRL.,2018-12-19,2018-12-19,,Joya\OUT\08957,,,Joya\OUT\08957,ALEX ROGELIO (TRB) MEDINA ZABALAGA,0,2.000000,-3.000000,0,0,0.000000,0.000000,0,"",253102 - Repuestos Maquinaria y Eq,21.01.01 MOLIENDA,"",,,,2018-12-19,
Physical Locations / Joya / Stock,Ubicaciones virtuales / Produccion,/ Joya / Stock,07,Otros Suministros Diversos,114-0014-01,kg,HARINA,2018-12-28,2018-12-28,,Joya\OUT\09063,,,Joya\OUT\09063,VICTOR URIEL VILCA CENTI,0,50.000000,-50.000000,0,0,0.000000,0.000000,0,"",252410 - Otros Suministros Diversos,20.05.02 LABORATORIO QUIMICO,"",,,,2018-12-28,
Partner Locations / Suppliers,Physical Locations / Joya / Stock,/ Joya / Stock,03,Uniformes e Implementos de Seguridad,112-0032-XX,Unit(s),LUNA TRANSPARENTE P/MASCARA DE SOLDAR,2018-12-01,2018-12-01,12/2018,Joya\IN\02930,01,0002,0003194,ESTHER SANDRA PINEDA LOAYZA,24.000000,0,24.000000,3.3050000000000000,79.32,0,79.32,3.3050000000000000,603203 - Uniforme e Implemento de Seguridad,252403 - Uniforme e Implemento de Seguridad,,"",,18PO06647,LM-001642,,
Physical Locations / Joya / Stock,Ubicaciones virtuales / Produccion,/ Joya / Stock,07,Uniformes e Implementos de Seguridad,112-0032-XX,Unit(s),LUNA TRANSPARENTE P/MASCARA DE SOLDAR,2018-12-14,2018-12-14,,Joya\OUT\08917,,,Joya\OUT\08917,ALEX ROGELIO (TRB) MEDINA ZABALAGA,0,6.000000,18.000000,3.3050000000000000,0,19.8300000000000000000000,59.4900000000000000000000,3.3050000000000000,"",252403 - Uniforme e Implemento de Seguridad,25.01.03 TALLER DE MANTENIMIENTO,"",,,,2018-12-14,
Physical Locations / Joya / Stock,Ubicaciones virtuales / Produccion,/ Joya / Stock,07,Uniformes e Implementos de Seguridad,112-0032-XX,Unit(s),LUNA TRANSPARENTE P/MASCARA DE SOLDAR,2018-12-17,2018-12-17,,Joya\OUT\08933,,,Joya\OUT\08933,ALEX ROGELIO (TRB) MEDINA ZABALAGA,0,6.000000,12.000000,3.3050000000000000,0,19.8300000000000000000000,39.6600000000000000000000,3.3050000000000000,"",252403 - Uniforme e Implemento de Seguridad,21.02.03 TANQUE AGITADOR #1 (22'x22'),"",,,,2018-12-17,
Partner Locations / Suppliers,Physical Locations / Joya / Stock,/ Joya / Stock,03,Otros Suministros Diversos,119-0092-XX,Unit(s),FRAZADA 1.5 plaza,2018-12-12,2018-12-12,12/2018,Joya\IN\02936,01,F002,0001077,DISTRIBUCIONES SAN JUAN MASIAS S.A.C.,10.000000,0,10.000000,19.6000000000000000,196,0,196,19.6000000000000000,603210 - Otros Suministros Diversos,252410 - Otros Suministros Diversos,,"",,18PO06456,LM-001613,2018-12-12,
Partner Locations / Suppliers,Physical Locations / Joya / Stock,/ Joya / Stock,03,Otros Suministros Diversos,119-0094-XX,Unit(s),SABANA 1/2 plaza (juego),2018-12-12,2018-12-12,12/2018,Joya\IN\02936,01,F002,0001077,DISTRIBUCIONES SAN JUAN MASIAS S.A.C.,7.000000,0,7.000000,37.2900000000000000,261.03,0,261.03,37.2900000000000000,603210 - Otros Suministros Diversos,252410 - Otros Suministros Diversos,,"",,18PO06456,LM-001613,2018-12-12,
Partner Locations / Suppliers,Physical Locations / Joya / Stock,/ Joya / Stock,03,Herramientas e Instrumentos,112-0040-XX,Unit(s),VASO DE PRECIPITADO DE 4LTS,2018-12-24,2018-12-24,12/2018,Joya\IN\02913,01,F001,0000137,QUIMICOS Y LABORATORIOS VALENCIA LLERENA SOCIEDAD COMERCIAL DE RESPONSABILIDAD LIMITADA,2.000000,0,2.000000,188.1350000000000000,376.27,0,376.27,188.1350000000000000,603205 - Herramientas e Instrumentos,252405 - Herramientas e Instrumentos,,"",,18PO06753,LM-001645,,
Physical Locations / Joya / Stock,Ubicaciones virtuales / Produccion,/ Joya / Stock,07,Viveres,114-0055-01,kg,CLORURO DE SODIO,2018-12-18,2018-12-18,,Joya\OUT\08941,,,Joya\OUT\08941,Harold Zambrano,0,200.000000,-200.000000,0,0,0.000000,0.000000,0,"",252407 - Cloruro de Sodio,"22.01.29	DEPRECIACION DESORCION, FUNDICION Y REFINACION","",,,,,
Physical Locations / Joya / Stock,Ubicaciones virtuales / Produccion,/ Joya / Stock,07,Herramientas e Instrumentos,112-0048-XX,Unit(s),"PAPEL FILTRO 500 x 530 mm, PAQUETE X 250 UNID",2018-12-18,2018-12-18,,Joya\OUT\08946,,,Joya\OUT\08946,Harold Zambrano,0,2.000000,-2.000000,0,0,0.000000,0.000000,0,"",252405 - Herramientas e Instrumentos,21.02.01 LIXIVIACIÓN Y ABSORCION,"",,,,,
Partner Locations / Suppliers,Physical Locations / Joya / Stock,/ Joya / Stock,03,Utiles de Oficina,113-0067-XX,Millar,PAPEL AUTOCOPIATIVO,2018-12-01,2018-12-01,12/2018,Joya\IN\02934,01,F532,0037893,TAI LOY S.A.,5.000000,0,5.000000,101.5260000000000000,507.63,0,507.63,101.5260000000000000,603206 - Utiles de Oficina,252406 - Utiles de Oficina,,"",,18PO06755,LM-001541,2018-12-01,
Physical Locations / Joya / Stock,Ubicaciones virtuales / Produccion,/ Joya / Stock,07,Utiles de Oficina,113-0067-XX,Millar,PAPEL AUTOCOPIATIVO,2018-12-31,2018-12-31,,Joya\OUT\09151,,,Joya\OUT\09151,GAVINO FELICIANO (TRB) CALISAYA RODRIGUEZ,0,2.000000,3.000000,101.5260000000000000,0,203.0520000000000000000000,304.5780000000000000000000,101.5260000000000000,"",252406 - Utiles de Oficina,20.02.04 BALANZA 80 TN,"",,,,2018-12-31,
Physical Locations / Joya / Stock,Ubicaciones virtuales / Produccion,/ Joya / Stock,07,Utiles de Oficina,113-0068-XX,Caja,PLUMON INDELEBLE DOS PUNTAS 1 A 0.3 MILIMETROS(CAJA 12 UND),2018-12-31,2018-12-31,,Joya\OUT\09151,,,Joya\OUT\09151,GAVINO FELICIANO (TRB) CALISAYA RODRIGUEZ,0,1.000000,-1.000000,0,0,0.000000,0.000000,0,"",252406 - Utiles de Oficina,23.02.01 ALMACENES,"",,,,2018-12-31,
Partner Locations / Suppliers,Physical Locations / Joya / Stock,/ Joya / Stock,03,Herramientas e Instrumentos,112-0053-XX,Unit(s),CRISOL CARBURO DE SILICIO  DE 100 Kgr,2018-12-08,2018-12-08,12/2018,Joya\IN\02884,01,E001,0000354,APOYO LOGISTICO MINERO E.I.R.L.,2.000000,0,2.000000,1640.2700000000000000,3280.54,0,3280.54,1640.2700000000000000,603205 - Herramientas e Instrumentos,252405 - Herramientas e Instrumentos,,"",,18PO06354,LM-001546,2018-12-08,
Physical Locations / Joya / Stock,Ubicaciones virtuales / Produccion,/ Joya / Stock,07,Herramientas e Instrumentos,112-0053-XX,Unit(s),CRISOL CARBURO DE SILICIO  DE 100 Kgr,2018-12-19,2018-12-19,,Joya\OUT\08958,,,Joya\OUT\08958,Harold Zambrano,0,2.000000,0.000000,1640.2700000000000000,0,3280.5400000000000000000000,0.0000000000000000000000,0,"",252405 - Herramientas e Instrumentos,22.01.03 DESORCIÓN,"",,,,,
Physical Locations / Joya / Stock,Ubicaciones virtuales / Produccion,/ Joya / Stock,07,Suministros Electricos,111-0247-XX,Unit(s),EQUIPOS HERMETICOS 2X36 W GEBLER KIT+ TBRECE+G,2018-12-18,2018-12-18,,Joya\OUT\08944,,,Joya\OUT\08944,ALEX ROGELIO (TRB) MEDINA ZABALAGA,0,2.000000,-2.000000,0,0,0.000000,0.000000,0,"",252404 - Suministros Electricos,20.03.03 CHANCADO,"",,,,2018-12-18,
Physical Locations / Joya / Stock,Ubicaciones virtuales / Produccion,/ Joya / Stock,07,Utiles de Oficina,113-0076-XX,Unit(s),ENGRAPADOR DE MANO,2018-12-14,2018-12-14,,Joya\OUT\08917,,,Joya\OUT\08917,ALEX ROGELIO (TRB) MEDINA ZABALAGA,0,1.000000,-1.000000,0,0,0.000000,0.000000,0,"",252406 - Utiles de Oficina,25.01.03 TALLER DE MANTENIMIENTO,"",,,,2018-12-14,
Partner Locations / Suppliers,Physical Locations / Joya / Stock,/ Joya / Stock,03,Herramientas e Instrumentos,119-0108-XX,Unit(s),JARRA DE 1/2 LITRO PVC TRANSPARENTE,2018-12-08,2018-12-08,12/2018,Joya\IN\02885,01,F002,0001078,DISTRIBUCIONES SAN JUAN MASIAS S.A.C.,10.000000,0,10.000000,2.3000000000000000,23,0,23,2.3000000000000000,603205 - Herramientas e Instrumentos,252405 - Herramientas e Instrumentos,,"",,18PO06356,LM-001573,2018-12-08,
Physical Locations / Joya / Stock,Ubicaciones virtuales / Produccion,/ Joya / Stock,07,Herramientas e Instrumentos,119-0108-XX,Unit(s),JARRA DE 1/2 LITRO PVC TRANSPARENTE,2018-12-10,2018-12-10,,Joya\OUT\08861,,,Joya\OUT\08861,JOSE SANTOS MATTA BORJAS,0,7.000000,3.000000,2.3000000000000000,0,16.1000000000000000000000,6.9000000000000000000000,2.3000000000000000,"",252405 - Herramientas e Instrumentos,21.02.03 TANQUE AGITADOR #1 (22'x22'),"",,,,,
Partner Locations / Suppliers,Physical Locations / Joya / Stock,/ Joya / Stock,03,Reactivo Soda,119-0109-XX,kg,LANA DE ACERO # 01 PRESENTACION 20 KG,2018-12-01,2018-12-01,11/2018,Joya\IN\02898,01,0001,0000237,FIZARO SOCIEDAD ANONIMA CERRADA - FIZARO S.A.C,40.000000,0,40.000000,19.9152500000000000,796.61,0,796.61,19.9152500000000000,603105 - Lana de Acero,251105 - Lana de Acero,,"",,18PO05934,LM-001546,,
,,/ Joya / Stock,"",Reactivo Soda,"","",LANA DE ACERO # 01 PRESENTACION 20 KG,,2018-12-05,12/2018,,01,0003,0002024,WILMER ABEL CHOQUE VILCA,0,0,40.000000,20.6780000000000000,30.51,0,827.12,20.6780000000000000,603105,251105 - Lana de Acero,"",,,,,,
Physical Locations / Joya / Stock,Ubicaciones virtuales / Produccion,/ Joya / Stock,07,Reactivo Soda,119-0109-XX,kg,LANA DE ACERO # 01 PRESENTACION 20 KG,2018-12-27,2018-12-27,,Joya\OUT\09054,,,Joya\OUT\09054,JOSE SANTOS MATTA BORJAS,0,20.000000,20.000000,20.6780000000000000,0,413.5600000000000000000000,413.5600000000000000000000,20.6780000000000000,"",251105 - Lana de Acero,22.01.03 DESORCIÓN,"",,,,,
,,/ Joya / Stock,"",Materiales de Ferreteria y Construccion,"","","PLANCHA ESTRUCTURAL 1200MM X  2400MM X 1/4""  ASTM A-36 ",,2018-12-19,12/2018,,01,0003,0002032,WILMER ABEL CHOQUE VILCA,0,0,0,0,65.91,0,65.91,0,603201,252401 - Materiales de Ferreteria y Construccion,"",,,,,,
Partner Locations / Suppliers,Physical Locations / Joya / Stock,/ Joya / Stock,03,Materiales de Ferreteria y Construccion,107-0270-XX,Unit(s),"PLANCHA ESTRUCTURAL 1200MM X  2400MM X 1/4""  ASTM A-36 ",2018-12-19,2018-12-19,12/2018,Joya\IN\02941,01,F016,0025589,ACEROS COMERCIALES S C R L,4.000000,0,4.000000,347.7200000000000000,1390.88,0,1456.79,364.1975000000000000,603201 - Materiales de Ferreteria y Construcc,252401 - Materiales de Ferreteria y Construccion,,"",,18PO06646,LM-001637,2018-12-19,
,,/ Joya / Stock,"",Materiales de Ferreteria y Construccion,"","","PLANCHA ESTRUCTURAL  DE 1200MM X 2400MM X 1/8"" ASTM  A-36",,2018-12-05,12/2018,,01,0003,0002023,WILMER ABEL CHOQUE VILCA,0,0,0,0,37.08,0,37.08,0,603201,252401 - Materiales de Ferreteria y Construccion,"",,,,,,
,,/ Joya / Stock,"",Materiales de Ferreteria y Construccion,"","","PLANCHA ESTRUCTURAL  DE 1200MM X 2400MM X 1/8"" ASTM  A-36",,2018-12-19,12/2018,,01,0003,0002032,WILMER ABEL CHOQUE VILCA,0,0,0,0,65.91,0,102.99,0,603201,252401 - Materiales de Ferreteria y Construccion,"",,,,,,
Partner Locations / Suppliers,Physical Locations / Joya / Stock,/ Joya / Stock,03,Materiales de Ferreteria y Construccion,107-0271-XX,Unit(s),"PLANCHA ESTRUCTURAL  DE 1200MM X 2400MM X 1/8"" ASTM  A-36",2018-12-19,2018-12-19,12/2018,Joya\IN\02941,01,F016,0025589,ACEROS COMERCIALES S C R L,4.000000,0,4.000000,173.5675000000000000,694.27,0,797.26,199.3150000000000000,603201 - Materiales de Ferreteria y Construcc,252401 - Materiales de Ferreteria y Construccion,,"",,18PO06646,LM-001637,2018-12-19,
Partner Locations / Suppliers,Physical Locations / Joya / Stock,/ Joya / Stock,03,Uniformes e Implementos de Seguridad,110-0151-01,Par,ZAPATO DE SEGURIDAD TALLA 36,2018-12-08,2018-12-08,12/2018,Joya\IN\02893,01,0002,0003157,ESTHER SANDRA PINEDA LOAYZA,2.000000,0,2.000000,91.5250000000000000,183.05,0,183.05,91.5250000000000000,603203 - Uniforme e Implemento de Seguridad,252403 - Uniforme e Implemento de Seguridad,,"",,18PO06446,LM-001560,2018-12-08,
Physical Locations / Joya / Stock,Ubicaciones virtuales / Produccion,/ Joya / Stock,07,Herramientas e Instrumentos,112-0103-XX,Unit(s),PIPETA VOLUMETRICA DE 2 ML	 (CLASE A),2018-12-21,2018-12-21,,Joya\OUT\08989,,,Joya\OUT\08989,VICTOR URIEL VILCA CENTI,0,3.000000,-3.000000,0,0,0.000000,0.000000,0,"",252405 - Herramientas e Instrumentos,20.05.02 LABORATORIO QUIMICO,"",,,,2018-12-21,
Physical Locations / Joya / Stock,Ubicaciones virtuales / Produccion,/ Joya / Stock,07,Herramientas e Instrumentos,112-0110-XX,Unit(s),"CUARZO GRANULADO ½""",2018-12-08,2018-12-08,,Joya\OUT\08842,,,Joya\OUT\08842,VICTOR URIEL VILCA CENTI,0,50.000000,-50.000000,0,0,0.000000,0.000000,0,"",252405 - Herramientas e Instrumentos,20.05.02 LABORATORIO QUIMICO,"",,,,2018-12-08,
Physical Locations / Joya / Stock,Ubicaciones virtuales / Produccion,/ Joya / Stock,07,Herramientas e Instrumentos,112-0110-XX,Unit(s),"CUARZO GRANULADO ½""",2018-12-14,2018-12-14,,Joya\OUT\08914,,,Joya\OUT\08914,VICTOR URIEL VILCA CENTI,0,50.000000,-100.000000,0,0,0.000000,0.000000,0,"",252405 - Herramientas e Instrumentos,20.02.01 PLANILLA ADMINISTRATIVA,"",,,,2018-12-14,
Partner Locations / Suppliers,Physical Locations / Joya / Stock,/ Joya / Stock,03,Herramientas e Instrumentos,112-0110-XX,Unit(s),"CUARZO GRANULADO ½""",2018-12-15,2018-12-15,12/2018,Joya\IN\02904,01,F002,0000142,QUIMICOS Y LABORATORIOS VALENCIA LLERENA SOCIEDAD COMERCIAL DE RESPONSABILIDAD LIMITADA,150.000000,0,50.000000,1.4000000000000000,210,0,210.000000,4.2000000000000000,603205 - Herramientas e Instrumentos,252405 - Herramientas e Instrumentos,,"",,18PO06608,LM-001630,2018-12-15,
Physical Locations / Joya / Stock,Ubicaciones virtuales / Produccion,/ Joya / Stock,07,Herramientas e Instrumentos,112-0110-XX,Unit(s),"CUARZO GRANULADO ½""",2018-12-25,2018-12-25,,Joya\OUT\09036,,,Joya\OUT\09036,VICTOR URIEL VILCA CENTI,0,100.000000,-50.000000,4.2000000000000000,0,420.0000000000000000000000,-210.0000000000000000000000,0,"",252405 - Herramientas e Instrumentos,20.05.02 LABORATORIO QUIMICO,"",,,,2018-12-25,
Physical Locations / Joya / Stock,Ubicaciones virtuales / Produccion,/ Joya / Stock,07,Otros Reactivos,108-0016-XX,Liter(s),AGUA DESIONIZADA ULTRA PURA,2018-12-01,2018-12-01,,Joya\OUT\08771,,,Joya\OUT\08771,VICTOR URIEL VILCA CENTI,0,140.000000,-140.000000,0,0,0.000000,0.000000,0,"",252402 - Reactivos,20.05.02 LABORATORIO QUIMICO,"",,,,2018-12-01,
Physical Locations / Joya / Stock,Ubicaciones virtuales / Produccion,/ Joya / Stock,07,Otros Reactivos,108-0016-XX,Liter(s),AGUA DESIONIZADA ULTRA PURA,2018-12-08,2018-12-08,,Joya\OUT\08842,,,Joya\OUT\08842,VICTOR URIEL VILCA CENTI,0,60.000000,-200.000000,0,0,0.000000,0.000000,0,"",252402 - Reactivos,20.05.02 LABORATORIO QUIMICO,"",,,,2018-12-08,
Partner Locations / Suppliers,Physical Locations / Joya / Stock,/ Joya / Stock,03,Otros Reactivos,108-0016-XX,Liter(s),AGUA DESIONIZADA ULTRA PURA,2018-12-18,2018-12-18,12/2018,Joya\IN\02919,01,E001,0000462,PROGRESIONES QUIMICAS E.I.R.L.,300.000000,0,100.000000,3.1787000000000000,953.61,0,953.610000,9.5361000000000000,603202 - Reactivos,252402 - Reactivos,,"",,18PO06658,LM-001364,,
Physical Locations / Joya / Stock,Ubicaciones virtuales / Produccion,/ Joya / Stock,07,Otros Reactivos,108-0016-XX,Liter(s),AGUA DESIONIZADA ULTRA PURA,2018-12-21,2018-12-21,,Joya\OUT\08989,,,Joya\OUT\08989,VICTOR URIEL VILCA CENTI,0,20.000000,80.000000,9.5361000000000000,0,190.7220000000000000000000,762.8880000000000000000000,9.5361000000000000,"",252402 - Reactivos,20.05.02 LABORATORIO QUIMICO,"",,,,2018-12-21,
Physical Locations / Joya / Stock,Ubicaciones virtuales / Produccion,/ Joya / Stock,07,Otros Reactivos,108-0016-XX,Liter(s),AGUA DESIONIZADA ULTRA PURA,2018-12-24,2018-12-24,,Joya\OUT\09034,,,Joya\OUT\09034,VICTOR URIEL VILCA CENTI,0,20.000000,60.000000,9.5361000000000000,0,190.7220000000000000000000,572.1660000000000000000000,9.5361000000000000,"",252402 - Reactivos,20.05.02 LABORATORIO QUIMICO,"",,,,2018-12-24,
,,/ Joya / Stock,"",Otros Reactivos,"","",AGUA DESIONIZADA ULTRA PURA,,2018-12-26,12/2018,,01,0003,0002035,WILMER ABEL CHOQUE VILCA,0,0,60.000000,11.1251000000000000000000,95.34,0,667.5060000000000000000000,11.1251000000000000000000,603202,252402 - Reactivos,"",,,,,,
Physical Locations / Joya / Stock,Ubicaciones virtuales / Produccion,/ Joya / Stock,07,Otros Reactivos,108-0016-XX,Liter(s),AGUA DESIONIZADA ULTRA PURA,2018-12-28,2018-12-28,,Joya\OUT\09063,,,Joya\OUT\09063,VICTOR URIEL VILCA CENTI,0,20.000000,40.000000,11.1251000000000000000000,0,222.5020000000000000000000000000,445.0040000000000000000000000000,11.1251000000000000000000,"",252402 - Reactivos,20.05.02 LABORATORIO QUIMICO,"",,,,2018-12-28,
Physical Locations / Joya / Stock,Ubicaciones virtuales / Produccion,/ Joya / Stock,07,Otros Reactivos,108-0016-XX,Liter(s),AGUA DESIONIZADA ULTRA PURA,2018-12-31,2018-12-31,,Joya\OUT\09097,,,Joya\OUT\09097,VICTOR URIEL VILCA CENTI,0,40.000000,0.000000,11.1251000000000000000000,0,445.0040000000000000000000000000,0.0000000000000000000000000000,0,"",252402 - Reactivos,20.05.02 LABORATORIO QUIMICO,"",,,,2018-12-31,
Physical Locations / Joya / Stock,Ubicaciones virtuales / Produccion,/ Joya / Stock,07,Otros Reactivos,108-0017-XX,kg,GAS ACETILENO ESPECIAL -(CIL×7.5 KG),2018-12-06,2018-12-06,,Joya\OUT\08820,,,Joya\OUT\08820,VICTOR URIEL VILCA CENTI,0,20.000000,-20.000000,0,0,0.000000,0.000000,0,"",252402 - Reactivos,20.05.19 EQUIPO DE ABSORCION ATOMICA,"",,,,2018-12-06,
Physical Locations / Joya / Stock,Ubicaciones virtuales / Produccion,/ Joya / Stock,07,Otros Reactivos,108-0017-XX,kg,GAS ACETILENO ESPECIAL -(CIL×7.5 KG),2018-12-19,2018-12-19,,Joya\OUT\08971,,,Joya\OUT\08971,VICTOR URIEL VILCA CENTI,0,20.000000,-40.000000,0,0,0.000000,0.000000,0,"",252402 - Reactivos,20.05.19 EQUIPO DE ABSORCION ATOMICA,"",,,,2018-12-19,
Partner Locations / Suppliers,Physical Locations / Joya / Stock,/ Joya / Stock,03,Otros Reactivos,108-0017-XX,kg,GAS ACETILENO ESPECIAL -(CIL×7.5 KG),2018-12-20,2018-12-20,12/2018,Joya\IN\02916,01,F001,0000226,OXYTEX  S.A.C.,50.000000,0,10.000000,49.1526000000000000,2457.63,0,2457.630000,245.7630000000000000,603202 - Reactivos,252402 - Reactivos,,"",,18PO06763,LM-001557,2018-12-20,
Physical Locations / Joya / Stock,Ubicaciones virtuales / Produccion,/ Joya / Stock,07,Otros Reactivos,108-0017-XX,kg,GAS ACETILENO ESPECIAL -(CIL×7.5 KG),2018-12-25,2018-12-25,,Joya\OUT\09036,,,Joya\OUT\09036,VICTOR URIEL VILCA CENTI,0,10.000000,0.000000,245.7630000000000000,0,2457.6300000000000000000000,0.0000000000000000000000,0,"",252402 - Reactivos,20.05.02 LABORATORIO QUIMICO,"",,,,2018-12-25,
Physical Locations / Joya / Stock,Ubicaciones virtuales / Produccion,/ Joya / Stock,07,Otros Reactivos,108-0019-01,kg,ACIDO NITRICO AL 68.5% INDS. (CIL x 34KG),2018-12-03,2018-12-03,,Joya\OUT\08789,,,Joya\OUT\08789,VICTOR URIEL VILCA CENTI,0,2.929000,-2.929000,0,0,0.000000,0.000000,0,"",252402 - Reactivos,20.05.02 LABORATORIO QUIMICO,"",,,,2018-12-03,
Physical Locations / Joya / Stock,Ubicaciones virtuales / Produccion,/ Joya / Stock,07,Otros Reactivos,108-0019-01,kg,ACIDO NITRICO AL 68.5% INDS. (CIL x 34KG),2018-12-06,2018-12-06,,Joya\OUT\08823,,,Joya\OUT\08823,VICTOR URIEL VILCA CENTI,0,3.073000,-6.002000,0,0,0.000000,0.000000,0,"",252402 - Reactivos,20.05.02 LABORATORIO QUIMICO,"",,,,2018-12-06,
Physical Locations / Joya / Stock,Ubicaciones virtuales / Produccion,/ Joya / Stock,07,Otros Reactivos,108-0019-01,kg,ACIDO NITRICO AL 68.5% INDS. (CIL x 34KG),2018-12-09,2018-12-09,,Joya\OUT\08847,,,Joya\OUT\08847,VICTOR URIEL VILCA CENTI,0,3.079000,-9.081000,0,0,0.000000,0.000000,0,"",252402 - Reactivos,20.05.02 LABORATORIO QUIMICO,"",,,,2018-12-09,
Physical Locations / Joya / Stock,Ubicaciones virtuales / Produccion,/ Joya / Stock,07,Otros Reactivos,108-0019-01,kg,ACIDO NITRICO AL 68.5% INDS. (CIL x 34KG),2018-12-14,2018-12-14,,Joya\OUT\08915,,,Joya\OUT\08915,VICTOR URIEL VILCA CENTI,0,3.086300,-12.167300,0,0,0.000000,0.000000,0,"",252402 - Reactivos,20.05.02 LABORATORIO QUIMICO,"",,,,2018-12-14,
Physical Locations / Joya / Stock,Ubicaciones virtuales / Produccion,/ Joya / Stock,07,Otros Reactivos,108-0019-01,kg,ACIDO NITRICO AL 68.5% INDS. (CIL x 34KG),2018-12-17,2018-12-17,,Joya\OUT\09090,,,Joya\OUT\09090,VICTOR URIEL VILCA CENTI,0,3.099500,-15.266800,0,0,0.000000,0.000000,0,"",252402 - Reactivos,20.05.02 LABORATORIO QUIMICO,"",,,,2018-12-17,
Physical Locations / Joya / Stock,Ubicaciones virtuales / Produccion,/ Joya / Stock,07,Otros Reactivos,108-0019-01,kg,ACIDO NITRICO AL 68.5% INDS. (CIL x 34KG),2018-12-20,2018-12-20,,Joya\OUT\09091,,,Joya\OUT\09091,VICTOR URIEL VILCA CENTI,0,3.131800,-18.398600,0,0,0.000000,0.000000,0,"",252402 - Reactivos,20.05.02 LABORATORIO QUIMICO,"",,,,2018-12-20,
Physical Locations / Joya / Stock,Ubicaciones virtuales / Produccion,/ Joya / Stock,07,Otros Reactivos,108-0019-01,kg,ACIDO NITRICO AL 68.5% INDS. (CIL x 34KG),2018-12-22,2018-12-22,,Joya\OUT\09092,,,Joya\OUT\09092,VICTOR URIEL VILCA CENTI,0,3.101900,-21.500500,0,0,0.000000,0.000000,0,"",252402 - Reactivos,20.05.02 LABORATORIO QUIMICO,"",,,,2018-12-22,
Physical Locations / Joya / Stock,Ubicaciones virtuales / Produccion,/ Joya / Stock,07,Otros Reactivos,108-0019-01,kg,ACIDO NITRICO AL 68.5% INDS. (CIL x 34KG),2018-12-26,2018-12-26,,Joya\OUT\09093,,,Joya\OUT\09093,VICTOR URIEL VILCA CENTI,0,3.102600,-24.603100,0,0,0.000000,0.000000,0,"",252402 - Reactivos,20.05.02 LABORATORIO QUIMICO,"",,,,2018-12-26,
Physical Locations / Joya / Stock,Ubicaciones virtuales / Produccion,/ Joya / Stock,07,Otros Reactivos,108-0019-01,kg,ACIDO NITRICO AL 68.5% INDS. (CIL x 34KG),2018-12-28,2018-12-28,,Joya\OUT\09062,,,Joya\OUT\09062,VICTOR URIEL VILCA CENTI,0,2.898000,-27.501100,0,0,0.000000,0.000000,0,"",252402 - Reactivos,20.05.02 LABORATORIO QUIMICO,"",,,,2018-12-28,
Partner Locations / Suppliers,Physical Locations / Joya / Stock,/ Joya / Stock,03,Uniformes e Implementos de Seguridad,110-0155-01,Par,ZAPATOS DE SEGURIDAD TALLA 37,2018-12-01,2018-12-01,12/2018,Joya\IN\02933,01,0002,0003203,ESTHER SANDRA PINEDA LOAYZA,2.000000,0,2.000000,91.5300000000000000,183.06,0,183.06,91.5300000000000000,603203 - Uniforme e Implemento de Seguridad,252403 - Uniforme e Implemento de Seguridad,,"",,18PO06654,LM-001642,2018-12-01,
Partner Locations / Suppliers,Physical Locations / Joya / Stock,/ Joya / Stock,03,Uniformes e Implementos de Seguridad,110-0155-01,Par,ZAPATOS DE SEGURIDAD TALLA 37,2018-12-08,2018-12-08,12/2018,Joya\IN\02893,01,0002,0003157,ESTHER SANDRA PINEDA LOAYZA,2.000000,0,4.000000,91.5250000000000000,183.05,0,366.11,91.5275000000000000,603203 - Uniforme e Implemento de Seguridad,252403 - Uniforme e Implemento de Seguridad,,"",,18PO06446,LM-001560,2018-12-08,
Physical Locations / Joya / Stock,Ubicaciones virtuales / Produccion,/ Joya / Stock,07,Uniformes e Implementos de Seguridad,110-0155-01,Par,ZAPATOS DE SEGURIDAD TALLA 37,2018-12-27,2018-12-27,,Joya\OUT\09052,,,Joya\OUT\09052,LUZ ESTHER CHAÑI CUTIRE,0,1.000000,3.000000,91.5275000000000000,0,91.5275000000000000000000,274.5825000000000000000000,91.5275000000000000,"",252403 - Uniforme e Implemento de Seguridad,20.05.02 LABORATORIO QUIMICO,"",,,,,
Physical Locations / Joya / Stock,Ubicaciones virtuales / Produccion,/ Joya / Stock,07,Uniformes e Implementos de Seguridad,111-0333-XX,Unit(s),CARETA DE SOLDAR ESTANDAR,2018-12-14,2018-12-14,,Joya\OUT\08917,,,Joya\OUT\08917,ALEX ROGELIO (TRB) MEDINA ZABALAGA,0,1.000000,-1.000000,0,0,0.000000,0.000000,0,"",252403 - Uniforme e Implemento de Seguridad,25.01.03 TALLER DE MANTENIMIENTO,"",,,,2018-12-14,
Physical Locations / Joya / Stock,Ubicaciones virtuales / Produccion,/ Joya / Stock,07,Otros Reactivos,108-0024-XX,Liter(s),SOLUCION STD ORO 1000 PPM APROX,2018-12-24,2018-12-24,,Joya\OUT\09034,,,Joya\OUT\09034,VICTOR URIEL VILCA CENTI,0,0.500000,-0.500000,0,0,0.000000,0.000000,0,"",252402 - Reactivos,20.05.02 LABORATORIO QUIMICO,"",,,,2018-12-24,
Physical Locations / Joya / Stock,Ubicaciones virtuales / Produccion,/ Joya / Stock,07,Suministros Electricos,111-0351-XX,Unit(s),RIEL UNISTRUT P1000,2018-12-18,2018-12-18,,Joya\OUT\08944,,,Joya\OUT\08944,ALEX ROGELIO (TRB) MEDINA ZABALAGA,0,5.000000,-5.000000,0,0,0.000000,0.000000,0,"",252404 - Suministros Electricos,21.02.03 TANQUE AGITADOR #1 (22'x22'),"",,,,2018-12-18,
Physical Locations / Joya / Stock,Ubicaciones virtuales / Produccion,/ Joya / Stock,07,Otros Suministros Diversos,112-0154-XX,Unit(s),CRISOL DE GRAFITO 15 KG,2018-12-01,2018-12-01,,Joya\OUT\08768,,,Joya\OUT\08768,MIGUEL ANGEL (TRB) RAMOS CHOQUE,0,2.000000,-2.000000,0,0,0.000000,0.000000,0,"",252410 - Otros Suministros Diversos,22.01.03 DESORCIÓN,"",,,,2018-12-01,
Partner Locations / Suppliers,Physical Locations / Joya / Stock,/ Joya / Stock,03,Otros Suministros Diversos,112-0154-XX,Unit(s),CRISOL DE GRAFITO 15 KG,2018-12-03,2018-12-03,11/2018,Joya\IN\02877,01,E001,0000351,APOYO LOGISTICO MINERO E.I.R.L.,2.000000,0,0.000000,185.505,371.01,0,371.010000,0,603210 - Otros Suministros Diversos,252410 - Otros Suministros Diversos,,"",,18PO06345,LM-001546,2018-12-03,
Physical Locations / Joya / Stock,Ubicaciones virtuales / Produccion,/ Joya / Stock,07,Otros Suministros Diversos,112-0154-XX,Unit(s),CRISOL DE GRAFITO 15 KG,2018-12-04,2018-12-04,,Joya\OUT\08800,,,Joya\OUT\08800,CARLOS ABRAHAN HUAMAN MAMANI,0,2.000000,-2.000000,0,0,0.000000,371.010000,0,"",252410 - Otros Suministros Diversos,22.01.03 DESORCIÓN,"",,,,2018-12-04,
Physical Locations / Joya / Stock,Ubicaciones virtuales / Produccion,/ Joya / Stock,07,Otros Reactivos,108-0029-XX,kg,POLVO DE ZINC,2018-12-18,2018-12-18,,Joya\OUT\08941,,,Joya\OUT\08941,Harold Zambrano,0,100.000000,-100.000000,0,0,0.000000,0.000000,0,"",252402 - Reactivos,"22.01.29	DEPRECIACION DESORCION, FUNDICION Y REFINACION","",,,,,
Physical Locations / Joya / Stock,Ubicaciones virtuales / Produccion,/ Joya / Stock,07,Otros Reactivos,108-0031-XX,Liter(s),AGUA DESTILADA,2018-12-01,2018-12-01,,Joya\OUT\08771,,,Joya\OUT\08771,VICTOR URIEL VILCA CENTI,0,200.000000,-200.000000,0,0,0.000000,0.000000,0,"",252402 - Reactivos,20.05.02 LABORATORIO QUIMICO,"",,,,2018-12-01,
Physical Locations / Joya / Stock,Ubicaciones virtuales / Produccion,/ Joya / Stock,07,Otros Reactivos,108-0031-XX,Liter(s),AGUA DESTILADA,2018-12-25,2018-12-25,,Joya\OUT\09036,,,Joya\OUT\09036,VICTOR URIEL VILCA CENTI,0,200.000000,-400.000000,0,0,0.000000,0.000000,0,"",252402 - Reactivos,20.05.02 LABORATORIO QUIMICO,"",,,,2018-12-25,
Partner Locations / Suppliers,Physical Locations / Joya / Stock,/ Joya / Stock,03,Materiales de Ferreteria y Construccion,107-0330-XX,Unit(s),"TUBO DE PVC 4"" PESADO",2018-12-03,2018-12-03,12/2018,Joya\IN\02886,01,E001,0001233,RIEGOS Y CONEXIONES S.A.C.,12.000000,0,12.000000,114.4066666666666667,1372.88,0,1372.88,114.4066666666666667,603201 - Materiales de Ferreteria y Construcc,252401 - Materiales de Ferreteria y Construccion,,"",,18PO06362,LM-001604,2018-12-03,
,,/ Joya / Stock,"",Materiales de Ferreteria y Construccion,"","","TUBO DE PVC 4"" PESADO",,2018-12-05,12/2018,,01,0003,0002025,WILMER ABEL CHOQUE VILCA,0,0,12.000000,135.5933333333333333,254.24,0,1627.12,135.5933333333333333,603201,252401 - Materiales de Ferreteria y Construccion,"",,,,,,
Partner Locations / Suppliers,Physical Locations / Joya / Stock,/ Joya / Stock,03,Materiales de Ferreteria y Construccion,107-0331-XX,Unit(s),"CODO PVC 4"" X 90' P/AGUA",2018-12-03,2018-12-03,12/2018,Joya\IN\02886,01,E001,0001233,RIEGOS Y CONEXIONES S.A.C.,12.000000,0,12.000000,16.9491666666666667,203.39,0,203.39,16.9491666666666667,603201 - Materiales de Ferreteria y Construcc,252401 - Materiales de Ferreteria y Construccion,,"",,18PO06362,LM-001604,2018-12-03,
,,/ Joya / Stock,"",Materiales de Ferreteria y Construccion,"","","CODO PVC 4"" X 90' P/AGUA",,2018-12-05,12/2018,,01,0003,0002025,WILMER ABEL CHOQUE VILCA,0,0,12.000000,18.7150000000000000,21.19,0,224.58,18.7150000000000000,603201,252401 - Materiales de Ferreteria y Construccion,"",,,,,,
Physical Locations / Joya / Stock,Ubicaciones virtuales / Produccion,/ Joya / Stock,07,Materiales de Ferreteria y Construccion,107-0336-XX,Unit(s),BOQUILLA DE OXICORTE NRO. 1.,2018-12-22,2018-12-22,,Joya\OUT\09002,,,Joya\OUT\09002,ALEX ROGELIO (TRB) MEDINA ZABALAGA,0,1.000000,-1.000000,0,0,0.000000,0.000000,0,"",252401 - Materiales de Ferreteria y Construccion,20.03.03 CHANCADO,"",,,,2018-12-22,
Physical Locations / Joya / Stock,Ubicaciones virtuales / Produccion,/ Joya / Stock,07,Repuestos de Maquinaria y Equipo,118-0371-XX,Unit(s),FAJA TRAPEZOIDAL B- 39,2018-12-30,2018-12-30,,Joya\OUT\09082,,,Joya\OUT\09082,ALEX ROGELIO (TRB) MEDINA ZABALAGA,0,2.000000,-2.000000,0,0,0.000000,0.000000,0,"",253102 - Repuestos Maquinaria y Eq,"21.02.17 BOMBA DE PULPA INGESH 2.1/2""X2""  (2 UND)","",,,,2018-12-30,
Physical Locations / Joya / Stock,Ubicaciones virtuales / Produccion,/ Joya / Stock,07,Suministros Electricos,111-0370-XX,Unit(s),LLAVE TRIFASICA 25 A,2018-12-17,2018-12-17,,Joya\OUT\08932,,,Joya\OUT\08932,ALEX ROGELIO (TRB) MEDINA ZABALAGA,0,1.000000,-1.000000,0,0,0.000000,0.000000,0,"",252404 - Suministros Electricos,20.03.03 CHANCADO,"",,,,2018-12-17,
Physical Locations / Joya / Stock,Ubicaciones virtuales / Produccion,/ Joya / Stock,07,Herramientas e Instrumentos,112-0163-XX,Unit(s),MATRACES DE 100 ML,2018-12-10,2018-12-10,,Joya\OUT\08861,,,Joya\OUT\08861,JOSE SANTOS MATTA BORJAS,0,2.000000,-2.000000,0,0,0.000000,0.000000,0,"",252405 - Herramientas e Instrumentos,21.02.03 TANQUE AGITADOR #1 (22'x22'),"",,,,,
Physical Locations / Joya / Stock,Ubicaciones virtuales / Produccion,/ Joya / Stock,07,Materiales de Ferreteria y Construccion,107-0378-XX,m,"BARRA DE ACERO REDONDO SAE 1045 1 1/2"" ",2018-12-02,2018-12-02,,Joya\OUT\09153,,,Joya\OUT\09153,ALEX ROGELIO (TRB) MEDINA ZABALAGA,0,5.000000,-5.000000,0,0,0.000000,0.000000,0,"",252401 - Materiales de Ferreteria y Construccion,21.02.01 LIXIVIACIÓN Y ABSORCION,"",,,,2018-12-02,
Physical Locations / Joya / Stock,Ubicaciones virtuales / Produccion,/ Joya / Stock,07,Uniformes e Implementos de Seguridad,110-0181-XX,Caja,GUANTES DE NITRILO TOUCH N TUFF T-M,2018-12-01,2018-12-01,,Joya\OUT\08771,,,Joya\OUT\08771,VICTOR URIEL VILCA CENTI,0,2.000000,-2.000000,0,0,0.000000,0.000000,0,"",252403 - Uniforme e Implemento de Seguridad,20.05.02 LABORATORIO QUIMICO,"",,,,2018-12-01,
Physical Locations / Joya / Stock,Ubicaciones virtuales / Produccion,/ Joya / Stock,07,Uniformes e Implementos de Seguridad,110-0181-XX,Caja,GUANTES DE NITRILO TOUCH N TUFF T-M,2018-12-02,2018-12-02,,Joya\OUT\08778,,,Joya\OUT\08778,JOSE SANTOS MATTA BORJAS,0,1.000000,-3.000000,0,0,0.000000,0.000000,0,"",252403 - Uniforme e Implemento de Seguridad,21.01.01 MOLIENDA,"",,,,,
Physical Locations / Joya / Stock,Ubicaciones virtuales / Produccion,/ Joya / Stock,07,Uniformes e Implementos de Seguridad,110-0181-XX,Caja,GUANTES DE NITRILO TOUCH N TUFF T-M,2018-12-04,2018-12-04,,Joya\OUT\08801,,,Joya\OUT\08801,VICTOR URIEL VILCA CENTI,0,2.000000,-5.000000,0,0,0.000000,0.000000,0,"",252403 - Uniforme e Implemento de Seguridad,20.05.03 LABORATORIO METALURGICO,"",,,,2018-12-04,
Physical Locations / Joya / Stock,Ubicaciones virtuales / Produccion,/ Joya / Stock,07,Uniformes e Implementos de Seguridad,110-0181-XX,Caja,GUANTES DE NITRILO TOUCH N TUFF T-M,2018-12-11,2018-12-11,,Joya\OUT\08862,,,Joya\OUT\08862,VICTOR URIEL VILCA CENTI,0,2.000000,-7.000000,0,0,0.000000,0.000000,0,"",252403 - Uniforme e Implemento de Seguridad,20.05.02 LABORATORIO QUIMICO,"",,,,2018-12-11,
Physical Locations / Joya / Stock,Ubicaciones virtuales / Produccion,/ Joya / Stock,07,Uniformes e Implementos de Seguridad,110-0181-XX,Caja,GUANTES DE NITRILO TOUCH N TUFF T-M,2018-12-12,2018-12-12,,Joya\OUT\08892,,,Joya\OUT\08892,Harold Zambrano,0,1.000000,-8.000000,0,0,0.000000,0.000000,0,"",252403 - Uniforme e Implemento de Seguridad,20.03.03 CHANCADO,"",,,,,
Physical Locations / Joya / Stock,Ubicaciones virtuales / Produccion,/ Joya / Stock,07,Uniformes e Implementos de Seguridad,110-0181-XX,Caja,GUANTES DE NITRILO TOUCH N TUFF T-M,2018-12-14,2018-12-14,,Joya\OUT\08917,,,Joya\OUT\08917,ALEX ROGELIO (TRB) MEDINA ZABALAGA,0,1.000000,-9.000000,0,0,0.000000,0.000000,0,"",252403 - Uniforme e Implemento de Seguridad,25.01.03 TALLER DE MANTENIMIENTO,"",,,,2018-12-14,
Physical Locations / Joya / Stock,Ubicaciones virtuales / Produccion,/ Joya / Stock,07,Uniformes e Implementos de Seguridad,110-0181-XX,Caja,GUANTES DE NITRILO TOUCH N TUFF T-M,2018-12-19,2018-12-19,,Joya\OUT\08956,,,Joya\OUT\08956,JOSE SANTOS MATTA BORJAS,0,1.000000,-10.000000,0,0,0.000000,0.000000,0,"",252403 - Uniforme e Implemento de Seguridad,21.02.03 TANQUE AGITADOR #1 (22'x22'),"",,,,,
Physical Locations / Joya / Stock,Ubicaciones virtuales / Produccion,/ Joya / Stock,07,Uniformes e Implementos de Seguridad,110-0181-XX,Caja,GUANTES DE NITRILO TOUCH N TUFF T-M,2018-12-19,2018-12-19,,Joya\OUT\08971,,,Joya\OUT\08971,VICTOR URIEL VILCA CENTI,0,1.000000,-11.000000,0,0,0.000000,0.000000,0,"",252403 - Uniforme e Implemento de Seguridad,20.05.02 LABORATORIO QUIMICO,"",,,,2018-12-19,
Physical Locations / Joya / Stock,Ubicaciones virtuales / Produccion,/ Joya / Stock,07,Uniformes e Implementos de Seguridad,110-0181-XX,Caja,GUANTES DE NITRILO TOUCH N TUFF T-M,2018-12-20,2018-12-20,,Joya\OUT\08983,,,Joya\OUT\08983,ALEX ROGELIO (TRB) MEDINA ZABALAGA,0,1.000000,-12.000000,0,0,0.000000,0.000000,0,"",252403 - Uniforme e Implemento de Seguridad,21.02.03 TANQUE AGITADOR #1 (22'x22'),"",,,,2018-12-20,
Physical Locations / Joya / Stock,Ubicaciones virtuales / Produccion,/ Joya / Stock,07,Uniformes e Implementos de Seguridad,110-0181-XX,Caja,GUANTES DE NITRILO TOUCH N TUFF T-M,2018-12-21,2018-12-21,,Joya\OUT\08989,,,Joya\OUT\08989,VICTOR URIEL VILCA CENTI,0,1.000000,-13.000000,0,0,0.000000,0.000000,0,"",252403 - Uniforme e Implemento de Seguridad,20.05.03 LABORATORIO METALURGICO,"",,,,2018-12-21,
Partner Locations / Suppliers,Physical Locations / Joya / Stock,/ Joya / Stock,03,Uniformes e Implementos de Seguridad,110-0181-XX,Caja,GUANTES DE NITRILO TOUCH N TUFF T-M,2018-12-24,2018-12-24,12/2018,Joya\IN\02912,01,F001,0000136,QUIMICOS Y LABORATORIOS VALENCIA LLERENA SOCIEDAD COMERCIAL DE RESPONSABILIDAD LIMITADA,18.000000,0,5.000000,29.6611111111111111,533.9,0,533.900000,106.7800000000000000,603203 - Uniforme e Implemento de Seguridad,252403 - Uniforme e Implemento de Seguridad,,"",,18PO06754,LM-001642,,
Physical Locations / Joya / Stock,Ubicaciones virtuales / Produccion,/ Joya / Stock,07,Uniformes e Implementos de Seguridad,110-0181-XX,Caja,GUANTES DE NITRILO TOUCH N TUFF T-M,2018-12-24,2018-12-24,,Joya\OUT\09027,,,Joya\OUT\09027,LUIS FELIPE CARCAMO PALACO,0,1.000000,4.000000,106.7800000000000000,0,106.7800000000000000000000,427.1200000000000000000000,106.7800000000000000,"",252403 - Uniforme e Implemento de Seguridad,21.02.01 LIXIVIACIÓN Y ABSORCION,"",,,,,
Physical Locations / Joya / Stock,Ubicaciones virtuales / Produccion,/ Joya / Stock,07,Uniformes e Implementos de Seguridad,110-0181-XX,Caja,GUANTES DE NITRILO TOUCH N TUFF T-M,2018-12-30,2018-12-30,,Joya\OUT\09081,,,Joya\OUT\09081,VICTOR URIEL VILCA CENTI,0,2.000000,2.000000,106.7800000000000000,0,213.5600000000000000000000,213.5600000000000000000000,106.7800000000000000,"",252403 - Uniforme e Implemento de Seguridad,20.05.02 LABORATORIO QUIMICO,"",,,,2018-12-30,
Physical Locations / Joya / Stock,Ubicaciones virtuales / Produccion,/ Joya / Stock,07,Uniformes e Implementos de Seguridad,110-0182-XX,Caja,GUANTES DE NITRILO TOUCH N TUFF T-L,2018-12-04,2018-12-04,,Joya\OUT\08795,,,Joya\OUT\08795,EDWIN LUIS TEBES VASCONCELOS,0,2.000000,-2.000000,0,0,0.000000,0.000000,0,"",252403 - Uniforme e Implemento de Seguridad,22.01.03 DESORCIÓN,"",,,,2018-12-04,
Physical Locations / Joya / Stock,Ubicaciones virtuales / Produccion,/ Joya / Stock,07,Uniformes e Implementos de Seguridad,110-0182-XX,Caja,GUANTES DE NITRILO TOUCH N TUFF T-L,2018-12-04,2018-12-04,,Joya\OUT\08801,,,Joya\OUT\08801,VICTOR URIEL VILCA CENTI,0,2.000000,-4.000000,0,0,0.000000,0.000000,0,"",252403 - Uniforme e Implemento de Seguridad,20.05.03 LABORATORIO METALURGICO,"",,,,2018-12-04,
Physical Locations / Joya / Stock,Ubicaciones virtuales / Produccion,/ Joya / Stock,07,Uniformes e Implementos de Seguridad,110-0182-XX,Caja,GUANTES DE NITRILO TOUCH N TUFF T-L,2018-12-10,2018-12-10,,Joya\OUT\08861,,,Joya\OUT\08861,JOSE SANTOS MATTA BORJAS,0,1.000000,-5.000000,0,0,0.000000,0.000000,0,"",252403 - Uniforme e Implemento de Seguridad,20.03.03 CHANCADO,"",,,,,
Physical Locations / Joya / Stock,Ubicaciones virtuales / Produccion,/ Joya / Stock,07,Uniformes e Implementos de Seguridad,110-0182-XX,Caja,GUANTES DE NITRILO TOUCH N TUFF T-L,2018-12-11,2018-12-11,,Joya\OUT\08862,,,Joya\OUT\08862,VICTOR URIEL VILCA CENTI,0,2.000000,-7.000000,0,0,0.000000,0.000000,0,"",252403 - Uniforme e Implemento de Seguridad,20.05.02 LABORATORIO QUIMICO,"",,,,2018-12-11,
Physical Locations / Joya / Stock,Ubicaciones virtuales / Produccion,/ Joya / Stock,07,Uniformes e Implementos de Seguridad,110-0182-XX,Caja,GUANTES DE NITRILO TOUCH N TUFF T-L,2018-12-18,2018-12-18,,Joya\OUT\08943,,,Joya\OUT\08943,Harold Zambrano,0,2.000000,-9.000000,0,0,0.000000,0.000000,0,"",252403 - Uniforme e Implemento de Seguridad,22.01.03 DESORCIÓN,"",,,,,
Physical Locations / Joya / Stock,Ubicaciones virtuales / Produccion,/ Joya / Stock,07,Uniformes e Implementos de Seguridad,110-0182-XX,Caja,GUANTES DE NITRILO TOUCH N TUFF T-L,2018-12-21,2018-12-21,,Joya\OUT\08989,,,Joya\OUT\08989,VICTOR URIEL VILCA CENTI,0,1.000000,-10.000000,0,0,0.000000,0.000000,0,"",252403 - Uniforme e Implemento de Seguridad,20.05.03 LABORATORIO METALURGICO,"",,,,2018-12-21,
Partner Locations / Suppliers,Physical Locations / Joya / Stock,/ Joya / Stock,03,Uniformes e Implementos de Seguridad,110-0182-XX,Caja,GUANTES DE NITRILO TOUCH N TUFF T-L,2018-12-24,2018-12-24,12/2018,Joya\IN\02912,01,F001,0000136,QUIMICOS Y LABORATORIOS VALENCIA LLERENA SOCIEDAD COMERCIAL DE RESPONSABILIDAD LIMITADA,12.000000,0,2.000000,29.6608333333333333,355.93,0,355.930000,177.9650000000000000,603203 - Uniforme e Implemento de Seguridad,252403 - Uniforme e Implemento de Seguridad,,"",,18PO06754,LM-001642,,
Physical Locations / Joya / Stock,Ubicaciones virtuales / Produccion,/ Joya / Stock,07,Uniformes e Implementos de Seguridad,110-0182-XX,Caja,GUANTES DE NITRILO TOUCH N TUFF T-L,2018-12-25,2018-12-25,,Joya\OUT\09036,,,Joya\OUT\09036,VICTOR URIEL VILCA CENTI,0,2.000000,0.000000,177.9650000000000000,0,355.9300000000000000000000,0.0000000000000000000000,0,"",252403 - Uniforme e Implemento de Seguridad,20.05.02 LABORATORIO QUIMICO,"",,,,2018-12-25,
Physical Locations / Joya / Stock,Ubicaciones virtuales / Produccion,/ Joya / Stock,07,Uniformes e Implementos de Seguridad,110-0182-XX,Caja,GUANTES DE NITRILO TOUCH N TUFF T-L,2018-12-30,2018-12-30,,Joya\OUT\09080,,,Joya\OUT\09080,JOSE SANTOS MATTA BORJAS,0,2.000000,-2.000000,0,0,0.000000,0.0000000000000000000000,0,"",252403 - Uniforme e Implemento de Seguridad,22.01.03 DESORCIÓN,"",,,,,
Physical Locations / Joya / Stock,Ubicaciones virtuales / Produccion,/ Joya / Stock,07,Otros Suministros Diversos,107-0443-XX,kg,"SOLDADURA CHANFERNORD 5/32""",2018-12-02,2018-12-02,,Joya\OUT\08751,,,Joya\OUT\08751,ALEX ROGELIO (TRB) MEDINA ZABALAGA,0,2.000000,-2.000000,0,0,0.000000,0.000000,0,"",252410 - Otros Suministros Diversos,21.01.01 MOLIENDA,"",,,,2018-12-02,
Physical Locations / Joya / Stock,Ubicaciones virtuales / Produccion,/ Joya / Stock,07,Uniformes e Implementos de Seguridad,110-0183-XX,Par,FILTRO 7093C VAPORES ORGANICOS,2018-12-12,2018-12-12,,Joya\OUT\08898,,,Joya\OUT\08898,LUZ ESTHER CHAÑI CUTIRE,0,1.000000,-1.000000,0,0,0.000000,0.000000,0,"",252403 - Uniforme e Implemento de Seguridad,20.05.02 LABORATORIO QUIMICO,"",,,,,
Physical Locations / Joya / Stock,Ubicaciones virtuales / Produccion,/ Joya / Stock,07,Uniformes e Implementos de Seguridad,110-0183-XX,Par,FILTRO 7093C VAPORES ORGANICOS,2018-12-12,2018-12-12,,Joya\OUT\08901,,,Joya\OUT\08901,LUZ ESTHER CHAÑI CUTIRE,0,1.000000,-2.000000,0,0,0.000000,0.000000,0,"",252403 - Uniforme e Implemento de Seguridad,20.05.02 LABORATORIO QUIMICO,"",,,,,
Physical Locations / Joya / Stock,Ubicaciones virtuales / Produccion,/ Joya / Stock,07,Uniformes e Implementos de Seguridad,110-0183-XX,Par,FILTRO 7093C VAPORES ORGANICOS,2018-12-12,2018-12-12,,Joya\OUT\08902,,,Joya\OUT\08902,LUZ ESTHER CHAÑI CUTIRE,0,1.000000,-3.000000,0,0,0.000000,0.000000,0,"",252403 - Uniforme e Implemento de Seguridad,20.05.02 LABORATORIO QUIMICO,"",,,,,
Physical Locations / Joya / Stock,Ubicaciones virtuales / Produccion,/ Joya / Stock,07,Uniformes e Implementos de Seguridad,110-0183-XX,Par,FILTRO 7093C VAPORES ORGANICOS,2018-12-12,2018-12-12,,Joya\OUT\08903,,,Joya\OUT\08903,LUZ ESTHER CHAÑI CUTIRE,0,1.000000,-4.000000,0,0,0.000000,0.000000,0,"",252403 - Uniforme e Implemento de Seguridad,21.02.01 LIXIVIACIÓN Y ABSORCION,"",,,,,
Physical Locations / Joya / Stock,Ubicaciones virtuales / Produccion,/ Joya / Stock,08,Uniformes e Implementos de Seguridad,110-0183-XX,Par,FILTRO 7093C VAPORES ORGANICOS,2018-12-22,2018-12-22,,Joya\OUT\08999,,,Joya\OUT\08999,LUCIANO RUBEN VIZA CHOQUE,0,1.000000,-5.000000,0,0,0.000000,0.000000,0,"",252403 - Uniforme e Implemento de Seguridad,20.05.02 LABORATORIO QUIMICO,"",,,,,
Physical Locations / Joya / Stock,Ubicaciones virtuales / Produccion,/ Joya / Stock,08,Uniformes e Implementos de Seguridad,110-0183-XX,Par,FILTRO 7093C VAPORES ORGANICOS,2018-12-26,2018-12-26,,Joya\OUT\09049,,,Joya\OUT\09049,LUCIANO RUBEN VIZA CHOQUE,0,1.000000,-6.000000,0,0,0.000000,0.000000,0,"",252403 - Uniforme e Implemento de Seguridad,20.05.02 LABORATORIO QUIMICO,"",,,,,
Partner Locations / Suppliers,Physical Locations / Joya / Stock,/ Joya / Stock,03,Otros Reactivos,102-0003-XX,kg,GEOSTATS G916-5,2018-12-21,2018-12-21,10/2018,Joya\IN\02760,01,0000,0025042,GEOSTATS PTY LTD,7.000000,0,7.000000,294.3942857142857143,2060.76,0,2060.76,294.3942857142857143,603202 - Reactivos,252402 - Reactivos,,"",,18PO05677,LM-001461,,
Physical Locations / Joya / Stock,Ubicaciones virtuales / Produccion,/ Joya / Stock,07,Otros Reactivos,102-0003-XX,kg,GEOSTATS G916-5,2018-12-21,2018-12-21,,Joya\OUT\08989,,,Joya\OUT\08989,VICTOR URIEL VILCA CENTI,0,1.000000,6.000000,294.3942857142857143,0,294.3942857142857143000000,1766.3657142857142857000000,294.3942857142857143,"",252402 - Reactivos,20.05.02 LABORATORIO QUIMICO,"",,,,2018-12-21,
Physical Locations / Joya / Stock,Ubicaciones virtuales / Produccion,/ Joya / Stock,07,Otros Reactivos,102-0003-XX,kg,GEOSTATS G916-5,2018-12-25,2018-12-25,,Joya\OUT\09036,,,Joya\OUT\09036,VICTOR URIEL VILCA CENTI,0,2.000000,4.000000,294.3942857142857143,0,588.7885714285714286000000,1177.5771428571428571000000,294.3942857142857143,"",252402 - Reactivos,20.05.02 LABORATORIO QUIMICO,"",,,,2018-12-25,
Physical Locations / Joya / Stock,Ubicaciones virtuales / Produccion,/ Joya / Stock,07,Otros Reactivos,102-0005-XX,kg,GEOSTATS G917-1,2018-12-14,2018-12-14,,Joya\OUT\08914,,,Joya\OUT\08914,VICTOR URIEL VILCA CENTI,0,1.000000,-1.000000,0,0,0.000000,0.000000,0,"",252402 - Reactivos,20.05.02 LABORATORIO QUIMICO,"",,,,2018-12-14,
Partner Locations / Suppliers,Physical Locations / Joya / Stock,/ Joya / Stock,03,Otros Reactivos,102-0005-XX,kg,GEOSTATS G917-1,2018-12-21,2018-12-21,10/2018,Joya\IN\02760,01,0000,0025042,GEOSTATS PTY LTD,10.000000,0,9.000000,294.3960000000000000,2943.96,0,2943.960000,327.1066666666666667,603202 - Reactivos,252402 - Reactivos,,"",,18PO05677,LM-001461,,
Physical Locations / Joya / Stock,Ubicaciones virtuales / Produccion,/ Joya / Stock,07,Otros Reactivos,102-0005-XX,kg,GEOSTATS G917-1,2018-12-21,2018-12-21,,Joya\OUT\08989,,,Joya\OUT\08989,VICTOR URIEL VILCA CENTI,0,1.000000,8.000000,327.1066666666666667,0,327.1066666666666667000000,2616.8533333333333333000000,327.1066666666666667,"",252402 - Reactivos,20.05.02 LABORATORIO QUIMICO,"",,,,2018-12-21,
Partner Locations / Suppliers,Physical Locations / Joya / Stock,/ Joya / Stock,03,Reactivo Cianuro,108-0036-01,kg,CIANURO DE SODIO,2018-12-01,2018-12-01,12/2018,Joya\IN\02864,01,F001,0036822,QUIMICOS GOICOCHEA S.A.C.,14300.000000,0,14300.000000,8.6502398601398601,123698.43,0,123698.43,8.6502398601398601,603101 - Cianuro de Sodio,251101 - Cianuro,,"",,18PO06242,LM-001581,2018-12-01,
Physical Locations / Joya / Stock,Ubicaciones virtuales / Produccion,/ Joya / Stock,07,Reactivo Cianuro,108-0036-01,kg,CIANURO DE SODIO,2018-12-03,2018-12-03,,Joya\OUT\08782,,,Joya\OUT\08782,JOSE SANTOS MATTA BORJAS,0,1100.000000,13200.000000,8.6502398601398601,0,9515.2638461538461100000000,114183.1661538461538900000000,8.6502398601398601,"",251101 - Cianuro,21.02.03 TANQUE AGITADOR #1 (22'x22'),"",,,,,
Physical Locations / Joya / Stock,Ubicaciones virtuales / Produccion,/ Joya / Stock,07,Reactivo Cianuro,108-0036-01,kg,CIANURO DE SODIO,2018-12-05,2018-12-05,,Joya\OUT\08836,,,Joya\OUT\08836,ERNESTO ALVAREZ OSORIO,0,1100.000000,12100.000000,8.6502398601398601,0,9515.2638461538461100000000,104667.9023076923077800000000,8.6502398601398601,"",251101 - Cianuro,21.02.01 LIXIVIACIÓN Y ABSORCION,"",,,,2018-12-05,
Physical Locations / Joya / Stock,Ubicaciones virtuales / Produccion,/ Joya / Stock,07,Reactivo Cianuro,108-0036-01,kg,CIANURO DE SODIO,2018-12-07,2018-12-07,,Joya\OUT\08833,,,Joya\OUT\08833,JOSE SANTOS MATTA BORJAS,0,1100.000000,11000.000000,8.6502398601398601,0,9515.2638461538461100000000,95152.6384615384616700000000,8.6502398601398601,"",251101 - Cianuro,21.02.03 TANQUE AGITADOR #1 (22'x22'),"",,,,,
Physical Locations / Joya / Stock,Ubicaciones virtuales / Produccion,/ Joya / Stock,07,Reactivo Cianuro,108-0036-01,kg,CIANURO DE SODIO,2018-12-08,2018-12-08,,Joya\OUT\08845,,,Joya\OUT\08845,JOSE SANTOS MATTA BORJAS,0,1100.000000,9900.000000,8.6502398601398601,0,9515.2638461538461100000000,85637.3746153846155600000000,8.6502398601398601,"",251101 - Cianuro,21.02.03 TANQUE AGITADOR #1 (22'x22'),"",,,,,
Physical Locations / Joya / Stock,Ubicaciones virtuales / Produccion,/ Joya / Stock,07,Reactivo Cianuro,108-0036-01,kg,CIANURO DE SODIO,2018-12-10,2018-12-10,,Joya\OUT\08861,,,Joya\OUT\08861,JOSE SANTOS MATTA BORJAS,0,1100.000000,8800.000000,8.6502398601398601,0,9515.2638461538461100000000,76122.1107692307694500000000,8.6502398601398601,"",251101 - Cianuro,21.02.03 TANQUE AGITADOR #1 (22'x22'),"",,,,,
Physical Locations / Joya / Stock,Ubicaciones virtuales / Produccion,/ Joya / Stock,07,Reactivo Cianuro,108-0036-01,kg,CIANURO DE SODIO,2018-12-16,2018-12-16,,Joya\OUT\08926,,,Joya\OUT\08926,Harold Zambrano,0,1100.000000,7700.000000,8.6502398601398601,0,9515.2638461538461100000000,66606.8469230769233400000000,8.6502398601398601,"",251101 - Cianuro,21.02.01 LIXIVIACIÓN Y ABSORCION,"",,,,,
Physical Locations / Joya / Stock,Ubicaciones virtuales / Produccion,/ Joya / Stock,07,Reactivo Cianuro,108-0036-01,kg,CIANURO DE SODIO,2018-12-17,2018-12-17,,Joya\OUT\08937,,,Joya\OUT\08937,Harold Zambrano,0,1100.000000,6600.000000,8.6502398601398601,0,9515.2638461538461100000000,57091.5830769230772300000000,8.6502398601398601,"",251101 - Cianuro,21.02.01 LIXIVIACIÓN Y ABSORCION,"",,,,,
Physical Locations / Joya / Stock,Ubicaciones virtuales / Produccion,/ Joya / Stock,07,Reactivo Cianuro,108-0036-01,kg,CIANURO DE SODIO,2018-12-19,2018-12-19,,Joya\OUT\08956,,,Joya\OUT\08956,JOSE SANTOS MATTA BORJAS,0,1100.000000,5500.000000,8.6502398601398601,0,9515.2638461538461100000000,47576.3192307692311200000000,8.6502398601398601,"",251101 - Cianuro,21.02.03 TANQUE AGITADOR #1 (22'x22'),"",,,,,
Physical Locations / Joya / Stock,Ubicaciones virtuales / Produccion,/ Joya / Stock,07,Reactivo Cianuro,108-0036-01,kg,CIANURO DE SODIO,2018-12-21,2018-12-21,,Joya\OUT\09008,,,Joya\OUT\09008,ERNESTO ALVAREZ OSORIO,0,1100.000000,4400.000000,8.6502398601398601,0,9515.2638461538461100000000,38061.0553846153850100000000,8.6502398601398601,"",251101 - Cianuro,"21.02.18 BOMBA DE PULPA VERTICAL 1.1/2""X24""  LIXIVIACION","",,,,2018-12-21,
Physical Locations / Joya / Stock,Ubicaciones virtuales / Produccion,/ Joya / Stock,07,Reactivo Cianuro,108-0036-01,kg,CIANURO DE SODIO,2018-12-23,2018-12-23,,Joya\OUT\09012,,,Joya\OUT\09012,JOSE SANTOS MATTA BORJAS,0,1100.000000,3300.000000,8.6502398601398601,0,9515.2638461538461100000000,28545.7915384615389000000000,8.6502398601398601,"",251101 - Cianuro,21.02.03 TANQUE AGITADOR #1 (22'x22'),"",,,,,
Physical Locations / Joya / Stock,Ubicaciones virtuales / Produccion,/ Joya / Stock,07,Reactivo Cianuro,108-0036-01,kg,CIANURO DE SODIO,2018-12-25,2018-12-25,,Joya\OUT\09035,,,Joya\OUT\09035,LUIS FELIPE CARCAMO PALACO,0,1100.000000,2200.000000,8.6502398601398601,0,9515.2638461538461100000000,19030.5276923076927900000000,8.6502398601398601,"",251101 - Cianuro,21.02.01 LIXIVIACIÓN Y ABSORCION,"",,,,,
Partner Locations / Suppliers,Physical Locations / Joya / Stock,/ Joya / Stock,03,Reactivo Cianuro,108-0036-01,kg,CIANURO DE SODIO,2018-12-26,2018-12-26,12/2018,Joya\IN\02905,01,F001,0037326,QUIMICOS GOICOCHEA S.A.C.,7700.000000,0,9900.000000,8.8589506493506494,68213.92,0,87244.4476923076927900000000,8.8125704739704740191919,603101 - Cianuro de Sodio,251101 - Cianuro,,"",,18PO06610,LM-001630,2018-12-26,
Physical Locations / Joya / Stock,Ubicaciones virtuales / Produccion,/ Joya / Stock,07,Reactivo Cianuro,108-0036-01,kg,CIANURO DE SODIO,2018-12-26,2018-12-26,,Joya\OUT\09046,,,Joya\OUT\09046,JOSE SANTOS MATTA BORJAS,0,1100.000000,8800.000000,8.8125704739704740191919,0,9693.8275213675214211110900000000,77550.6201709401713688889100000000,8.8125704739704740191919,"",251101 - Cianuro,21.02.03 TANQUE AGITADOR #1 (22'x22'),"",,,,,
Physical Locations / Joya / Stock,Ubicaciones virtuales / Produccion,/ Joya / Stock,07,Reactivo Cianuro,108-0036-01,kg,CIANURO DE SODIO,2018-12-28,2018-12-28,,Joya\OUT\09058,,,Joya\OUT\09058,JOSE SANTOS MATTA BORJAS,0,1100.000000,7700.000000,8.8125704739704740191919,0,9693.8275213675214211110900000000,67856.7926495726499477778200000000,8.8125704739704740191919,"",251101 - Cianuro,21.02.03 TANQUE AGITADOR #1 (22'x22'),"",,,,,
Physical Locations / Joya / Stock,Ubicaciones virtuales / Produccion,/ Joya / Stock,07,Reactivo Cianuro,108-0036-01,kg,CIANURO DE SODIO,2018-12-30,2018-12-30,,Joya\OUT\09085,,,Joya\OUT\09085,JOSE SANTOS MATTA BORJAS,0,1100.000000,6600.000000,8.8125704739704740191919,0,9693.8275213675214211110900000000,58162.9651282051285266667300000000,8.8125704739704740191919,"",251101 - Cianuro,22.01.03 DESORCIÓN,"",,,,,
Physical Locations / Joya / Stock,Ubicaciones virtuales / Produccion,/ Joya / Stock,07,Reactivo Cianuro,108-0036-01,kg,CIANURO DE SODIO,2018-12-31,2018-12-31,,Joya\OUT\09094,,,Joya\OUT\09094,JOSE SANTOS MATTA BORJAS,0,1100.000000,5500.000000,8.8125704739704740191919,0,9693.8275213675214211110900000000,48469.1376068376071055556400000000,8.8125704739704740191919,"",251101 - Cianuro,21.02.03 TANQUE AGITADOR #1 (22'x22'),"",,,,,
Physical Locations / Joya / Stock,Ubicaciones virtuales / Produccion,/ Joya / Stock,07,Otros Reactivos,108-0037-01,kg,ACIDO NITRICO AL 53% INDS. (CIL x 250KG),2018-12-10,2018-12-10,,Joya\OUT\08857,,,Joya\OUT\08857,JOSE SANTOS MATTA BORJAS,0,169.500000,-169.500000,0,0,0.000000,0.000000,0,"",252402 - Reactivos,22.01.03 DESORCIÓN,"",,,,,
Physical Locations / Joya / Stock,Ubicaciones virtuales / Produccion,/ Joya / Stock,07,Otros Reactivos,108-0037-01,kg,ACIDO NITRICO AL 53% INDS. (CIL x 250KG),2018-12-11,2018-12-11,,Joya\OUT\08864,,,Joya\OUT\08864,JOSE SANTOS MATTA BORJAS,0,88.860000,-258.360000,0,0,0.000000,0.000000,0,"",252402 - Reactivos,22.01.03 DESORCIÓN,"",,,,,
Physical Locations / Joya / Stock,Ubicaciones virtuales / Produccion,/ Joya / Stock,07,Otros Reactivos,108-0037-01,kg,ACIDO NITRICO AL 53% INDS. (CIL x 250KG),2018-12-13,2018-12-13,,Joya\OUT\08906,,,Joya\OUT\08906,Harold Zambrano,0,105.000000,-363.360000,0,0,0.000000,0.000000,0,"",252402 - Reactivos,"22.01.29	DEPRECIACION DESORCION, FUNDICION Y REFINACION","",,,,,
Partner Locations / Suppliers,Physical Locations / Joya / Stock,/ Joya / Stock,03,Otros Reactivos,108-0037-01,kg,ACIDO NITRICO AL 53% INDS. (CIL x 250KG),2018-12-17,2018-12-17,12/2018,Joya\IN\02903,01,F005,0003793,DISTRIBUIDORA DE PRODUCTOS QUIMICOS SRL,500.000000,0,136.640000,2.9300000000000000,1465,0,1465.000000,10.7216042154566745,603202 - Reactivos,252402 - Reactivos,,"",,18PO06606,LM-001630,2018-12-17,
Physical Locations / Joya / Stock,Ubicaciones virtuales / Produccion,/ Joya / Stock,07,Otros Reactivos,108-0037-01,kg,ACIDO NITRICO AL 53% INDS. (CIL x 250KG),2018-12-18,2018-12-18,,Joya\OUT\08939,,,Joya\OUT\08939,Harold Zambrano,0,142.580000,-5.940000,10.7216042154566745,0,1528.6863290398126502100000,-63.6863290398126502100000,0,"",252402 - Reactivos,"22.01.29	DEPRECIACION DESORCION, FUNDICION Y REFINACION","",,,,,
Physical Locations / Joya / Stock,Ubicaciones virtuales / Produccion,/ Joya / Stock,07,Otros Reactivos,108-0037-01,kg,ACIDO NITRICO AL 53% INDS. (CIL x 250KG),2018-12-27,2018-12-27,,Joya\OUT\09054,,,Joya\OUT\09054,JOSE SANTOS MATTA BORJAS,0,191.980000,-197.920000,0,0,0.000000,-63.6863290398126502100000,0,"",252402 - Reactivos,22.01.03 DESORCIÓN,"",,,,,
Physical Locations / Joya / Stock,Ubicaciones virtuales / Produccion,/ Joya / Stock,07,Otros Reactivos,108-0037-01,kg,ACIDO NITRICO AL 53% INDS. (CIL x 250KG),2018-12-30,2018-12-30,,Joya\OUT\09083,,,Joya\OUT\09083,JOSE SANTOS MATTA BORJAS,0,113.540000,-311.460000,0,0,0.000000,-63.6863290398126502100000,0,"",252402 - Reactivos,22.01.01 PLANILLA ADMINISTRATIVA,"",,,,,
Physical Locations / Joya / Stock,Ubicaciones virtuales / Produccion,/ Joya / Stock,07,Otros Reactivos,108-0037-01,kg,ACIDO NITRICO AL 53% INDS. (CIL x 250KG),2018-12-31,2018-12-31,,Joya\OUT\09098,,,Joya\OUT\09098,JOSE SANTOS MATTA BORJAS,0,45.060000,-356.520000,0,0,0.000000,-63.6863290398126502100000,0,"",252402 - Reactivos,22.01.03 DESORCIÓN,"",,,,,
Physical Locations / Joya / Stock,Ubicaciones virtuales / Produccion,/ Joya / Stock,07,Uniformes e Implementos de Seguridad,110-0183-01,Par,FILTRO 7093 P100 PARA PARTICULAS,2018-12-12,2018-12-12,,Joya\OUT\08881,,,Joya\OUT\08881,LUZ ESTHER CHAÑI CUTIRE,0,1.000000,-1.000000,0,0,0.000000,0.000000,0,"",252403 - Uniforme e Implemento de Seguridad,20.03.03 CHANCADO,"",,,,,
Physical Locations / Joya / Stock,Ubicaciones virtuales / Produccion,/ Joya / Stock,07,Uniformes e Implementos de Seguridad,110-0183-01,Par,FILTRO 7093 P100 PARA PARTICULAS,2018-12-28,2018-12-28,,Joya\OUT\09057,,,Joya\OUT\09057,LUZ ESTHER CHAÑI CUTIRE,0,1.000000,-2.000000,0,0,0.000000,0.000000,0,"",252403 - Uniforme e Implemento de Seguridad,25.01.03 TALLER DE MANTENIMIENTO,"",,,,,
Physical Locations / Joya / Stock,Ubicaciones virtuales / Produccion,/ Joya / Stock,07,Lubricantes y Grasas,106-0028-XX,gal(s),Aceite Hidraulico Tellus 46,2018-12-17,2018-12-17,,Joya\OUT\08933,,,Joya\OUT\08933,ALEX ROGELIO (TRB) MEDINA ZABALAGA,0,55.000000,-55.000000,0,0,0.000000,0.000000,0,"",252201 - Lubricantes,20.03.04 CARGADOR FRONTAL (CAT 950),"",,,,2018-12-17,
,,/ Joya / Stock,"",Materiales de Ferreteria y Construccion,"","","ANGULO FE. NEGRO L1""X1""X1/4""X6M",,2018-12-05,12/2018,,01,0003,0002023,WILMER ABEL CHOQUE VILCA,0,0,0,0,37.07,0,37.07,0,603201,252401 - Materiales de Ferreteria y Construccion,"",,,,,,
Partner Locations / Suppliers,Physical Locations / Joya / Stock,/ Joya / Stock,03,Materiales de Ferreteria y Construccion,107-0464-XX,Unit(s),"PLANCHA ESTRUCTURAL 1/2"" ASTM A36 (1.2MX2.4M",2018-12-19,2018-12-19,12/2018,Joya\IN\02941,01,F016,0025589,ACEROS COMERCIALES S C R L,2.000000,0,2.000000,750.6700000000000000,1501.34,0,1501.34,750.6700000000000000,603201 - Materiales de Ferreteria y Construcc,252401 - Materiales de Ferreteria y Construccion,,"",,18PO06646,LM-001637,2018-12-19,
,,/ Joya / Stock,"",Materiales de Ferreteria y Construccion,"","","PLANCHA ESTRUCTURAL 3/4"" ASTM A36 (1.2MX2.4M)",,2018-12-19,12/2018,,01,0003,0002032,WILMER ABEL CHOQUE VILCA,0,0,0,0,16.48,0,16.48,0,603201,252401 - Materiales de Ferreteria y Construccion,"",,,,,,
Partner Locations / Suppliers,Physical Locations / Joya / Stock,/ Joya / Stock,03,Materiales de Ferreteria y Construccion,107-0465-XX,Unit(s),"PLANCHA ESTRUCTURAL 3/4"" ASTM A36 (1.2MX2.4M)",2018-12-19,2018-12-19,12/2018,Joya\IN\02941,01,F016,0025589,ACEROS COMERCIALES S C R L,1.000000,0,1.000000,1179.2500000000000000,1179.25,0,1195.73,1195.7300000000000000,603201 - Materiales de Ferreteria y Construcc,252401 - Materiales de Ferreteria y Construccion,,"",,18PO06646,LM-001637,2018-12-19,
,,/ Joya / Stock,"",Materiales de Ferreteria y Construccion,"","","PLANCHA ESTRUCTURAL 3/8"" ASTM A36 (1.2MX2.4M)",,2018-12-19,12/2018,,01,0003,0002032,WILMER ABEL CHOQUE VILCA,0,0,0,0,65.91,0,197.74,0,603201,252401 - Materiales de Ferreteria y Construccion,"",,,,,,
,,/ Joya / Stock,"",Materiales de Ferreteria y Construccion,"","","PLANCHA ESTRUCTURAL 3/8"" ASTM A36 (1.2MX2.4M)",,2018-12-19,12/2018,,01,0003,0002032,WILMER ABEL CHOQUE VILCA,0,0,0,0,32.96,0,32.96,0,603201,252401 - Materiales de Ferreteria y Construccion,"",,,,,,
,,/ Joya / Stock,"",Materiales de Ferreteria y Construccion,"","","PLANCHA ESTRUCTURAL 3/8"" ASTM A36 (1.2MX2.4M)",,2018-12-19,12/2018,,01,0003,0002032,WILMER ABEL CHOQUE VILCA,0,0,0,0,65.91,0,98.87,0,603201,252401 - Materiales de Ferreteria y Construccion,"",,,,,,
,,/ Joya / Stock,"",Materiales de Ferreteria y Construccion,"","","PLANCHA ESTRUCTURAL 3/8"" ASTM A36 (1.2MX2.4M)",,2018-12-19,12/2018,,01,0003,0002032,WILMER ABEL CHOQUE VILCA,0,0,0,0,32.96,0,131.83,0,603201,252401 - Materiales de Ferreteria y Construccion,"",,,,,,
Partner Locations / Suppliers,Physical Locations / Joya / Stock,/ Joya / Stock,03,Materiales de Ferreteria y Construccion,107-0466-XX,Unit(s),"PLANCHA ESTRUCTURAL 3/8"" ASTM A36 (1.2MX2.4M)",2018-12-19,2018-12-19,12/2018,Joya\IN\02941,01,F016,0025589,ACEROS COMERCIALES S C R L,4.000000,0,4.000000,535.3550000000000000,2141.42,0,2339.16,584.7900000000000000,603201 - Materiales de Ferreteria y Construcc,252401 - Materiales de Ferreteria y Construccion,,"",,18PO06646,LM-001637,2018-12-19,
,,/ Joya / Stock,"",Materiales de Ferreteria y Construccion,"","","PLANCHA ESTRUCTURAL 3/16"" ASTM A36 (1.2MX2.4M)",,2018-12-05,12/2018,,01,0003,0002023,WILMER ABEL CHOQUE VILCA,0,0,0,0,74.15,0,222.46,0,603201,252401 - Materiales de Ferreteria y Construccion,"",,,,,,
,,/ Joya / Stock,"",Materiales de Ferreteria y Construccion,"","","PLANCHA ESTRUCTURAL 3/16"" ASTM A36 (1.2MX2.4M)",,2018-12-05,12/2018,,01,0003,0002023,WILMER ABEL CHOQUE VILCA,0,0,0,0,74.15,0,74.15,0,603201,252401 - Materiales de Ferreteria y Construccion,"",,,,,,
,,/ Joya / Stock,"",Materiales de Ferreteria y Construccion,"","","PLANCHA ESTRUCTURAL 3/16"" ASTM A36 (1.2MX2.4M)",,2018-12-05,12/2018,,01,0003,0002023,WILMER ABEL CHOQUE VILCA,0,0,0,0,37.08,0,111.23,0,603201,252401 - Materiales de Ferreteria y Construccion,"",,,,,,
,,/ Joya / Stock,"",Materiales de Ferreteria y Construccion,"","","PLANCHA ESTRUCTURAL 3/16"" ASTM A36 (1.2MX2.4M)",,2018-12-05,12/2018,,01,0003,0002023,WILMER ABEL CHOQUE VILCA,0,0,0,0,37.08,0,148.31,0,603201,252401 - Materiales de Ferreteria y Construccion,"",,,,,,
,,/ Joya / Stock,"",Materiales de Ferreteria y Construccion,"","","PLANCHA ESTRUCTURAL 1/16"" ASTM A36 (1.2MX2.4M)",,2018-12-05,12/2018,,01,0003,0002023,WILMER ABEL CHOQUE VILCA,0,0,0,0,111.23,0,111.23,0,603201,252401 - Materiales de Ferreteria y Construccion,"",,,,,,
,,/ Joya / Stock,"",Materiales de Ferreteria y Construccion,"","","PLANCHA ESTRUCTURAL 1/16"" ASTM A36 (1.2MX2.4M)",,2018-12-19,12/2018,,01,0003,0002032,WILMER ABEL CHOQUE VILCA,0,0,0,0,49.44,0,160.67,0,603201,252401 - Materiales de Ferreteria y Construccion,"",,,,,,
Partner Locations / Suppliers,Physical Locations / Joya / Stock,/ Joya / Stock,03,Materiales de Ferreteria y Construccion,107-0468-XX,Unit(s),"PLANCHA ESTRUCTURAL 1/16"" ASTM A36 (1.2MX2.4M)",2018-12-19,2018-12-19,12/2018,Joya\IN\02941,01,F016,0025589,ACEROS COMERCIALES S C R L,2.000000,0,2.000000,90.5000000000000000,181,0,341.67,170.8350000000000000,603201 - Materiales de Ferreteria y Construcc,252401 - Materiales de Ferreteria y Construccion,,"",,18PO06646,LM-001637,2018-12-19,
